,sentence1,sentence2,similarity_score,TFIDF_cosine_score,rank_by_TFIDF_cosine_score,rank_by_similarity_score,d,d^2
0,plane take,air plane take,5.0,0.7214719402113192,4305,5749,-1444,2085136
1,man play large flute,man play flute,3.799999952316284,0.8698673472898946,5268,4143,1125,1265625
2,man spread screwed cheese penza,man spread shrouded cheese unhooked penza,3.799999952316284,0.5963396593231797,3384,4145,-761,579121
3,man play chess,man play chess,2.5999999046325684,0.9999999999999998,5585,2508,3077,9467929
4,man play cell,man seat play cell,4.25,0.8017223171035162,4876,4917,-41,1681
5,man fight,man fight,4.25,1.0,5597,4916,681,463761
6,man smoke,man state,0.5,0.23601429547302996,1108,604,504,254016
7,man play piano,man play guitar,1.600000023841858,0.4118965147063531,2081,1489,592,350464
8,man play guitar singing,woman play caustic guitar singing,2.200000047683716,0.7306703417406177,4374,2019,2355,5546025
9,person throw cat ceiling,person throw cat ceiling,5.0,1.0,5604,5504,100,10000
10,man hit man stick,man span man stick,4.199999809265137,0.6265324476472254,3606,4728,-1122,1258884
11,woman pick hold baby kangaroo,woman pick hold baby kangaroo arm,4.599999904632568,0.9196127747209413,5481,5168,313,97969
12,man play flute,man play bamboo flute,3.867000102996826,0.7565188940968381,4567,4335,232,53824
13,person fold piece paper,fold piece paper,4.666999816894531,0.9228836498945192,5492,5317,175,30625
14,man run road,dog run road,1.6670000553131104,0.8097986599958859,4926,1597,3329,11082241
15,dog try bacon,dog try eat bacon,3.75,0.8850796433113919,5345,4003,1342,1800964
16,polar bear slide snow,polar bear slide snow,5.0,1.0,5593,5541,52,2704
17,woman write,woman swim,0.5,0.23420705199828218,1105,601,504,254016
18,cat rub baby face,cat rub baby,3.799999952316284,0.9060355787116398,5432,4154,1278,1633284
19,man ride horse,man ride horse,5.0,1.0000000000000002,5715,5547,168,28224
20,man hour oil pot,man hour wine pot,3.200000047683716,0.6717917659266166,3932,3083,849,720801
21,man play guitar,girl play guitar,2.799999952316284,0.7774566146796076,4707,2657,2050,4202500
22,slide slide,side slide,4.599999904632568,1.0,5638,5153,485,235225
23,woman eat,woman eat meat,3.0,0.7269121717501458,4334,3006,1328,1763584
24,woman feel potato,woman peel potato,5.0,0.5550346601259089,3073,5551,-2478,6140484
25,boy fall bike,boy fall bike,4.800000190734863,1.0,5637,5354,283,80089
26,woman play flute,woman play flute,5.0,1.0,5634,5552,82,6724
27,rabbit run eagle,hare run eagle,4.199999809265137,0.5302186080978742,2862,4772,-1910,3648100
28,woman try dreaded pork chop,woman cook dreaded pork chop,4.199999809265137,0.8221311740223861,4996,4774,222,49284
29,girl fly kite,girl run fly kite,4.0,0.9230086811221763,5493,4606,887,786769
30,man ride mechanical bull,man ride mechanical bull,4.0,1.0,5629,4575,1054,1110916
31,man play guitar,man play guitar,4.908999919891357,0.9999999999999998,5589,5482,107,11449
32,woman dance singe woman,woman dance singe rain,3.0,0.7621396467430328,4614,2985,1629,2653641
33,man slide,man slide onion,2.400000095367432,0.7018426863397846,4147,2271,1876,3519376
34,man pour oil pan,man pour oil skilled,4.199999809265137,0.6365461995146945,3687,4777,-1090,1188100
35,lion play people,lion play man,3.400000095367432,0.8311381220231143,5055,3520,1535,2356225
36,dog ride skateboard,dog ride skateboard,5.0,1.0,5623,5508,115,13225
37,carve statue,man carve statue,3.75,0.958111129837918,5567,3998,1569,2461761
38,woman slide onion,man cut onion,2.75,0.5073712990814749,2710,2542,168,28224
39,woman feel shrimp,woman peel shrimp,5.0,0.5912435652409789,3339,5512,-2173,4721929
40,woman try fish,woman cook fish,4.0,0.5633166724595595,3128,4539,-1411,1990921
41,woman play electric guitar,woman play guitar,3.5999999046325684,0.7389819774717699,4445,3948,497,247009
42,baby tiger play ball,baby play doll,1.600000023841858,0.4065364367229445,2043,1488,555,308025
43,person slide tomato,person slide meat,1.75,0.528140513916569,2846,1622,1224,1498176
44,person cut onion,person cut onion,5.0,0.9999999999999999,5590,5522,68,4624
45,man play piano,woman play violin,1.0,0.22774738976892941,1079,993,86,7396
46,woman play flute,man play guitar,1.0,0.24651510829677986,1154,995,159,25281
47,man cut potato,man cut carrot,2.375,0.4468911325200539,2292,2172,120,14400
48,kid play guitar,boy play guitar,3.799999952316284,0.6091708816132378,3477,4164,-687,471969
49,boy play guitar,man play guitar,3.200000047683716,0.7737663050518497,4679,3208,1471,2163841
50,man play guitar,boy play guitar,3.200000047683716,0.7737663050518497,4678,3204,1474,2172676
51,little boy play keyboard,boy play key board,4.400000095367432,0.34134545620568335,1663,5022,-3359,11282881
52,man play guitar,man play electric guitar,3.75,0.7335578147789306,4408,4025,383,146689
53,dog lick baby,dog lick baby,4.75,1.0,5616,5338,278,77284
54,woman slide onion,man cut onion,3.200000047683716,0.5073712990814749,2711,3137,-426,181476
55,man play guitar,man play drum,1.555999994277954,0.37638370949130484,1858,1455,403,162409
56,woman slide pepper,woman cut red pepper,3.937999963760376,0.609892783457472,3486,4342,-856,732736
57,man play drum,man play drum,5.0,1.0,5613,5528,85,7225
58,woman ride horse,woman ride horse,5.0,1.0000000000000002,5736,5529,207,42849
59,man eat banana tree,man eat banana,4.0,0.8636368088293156,5240,4659,581,337561
60,cat play key board,man play keyboard,1.600000023841858,0.18935766786225194,944,1485,-541,292681
61,man crop tree axe,man cut tree axe,4.75,0.7298672057311493,4363,5332,-969,938961
62,kid play toy phone,little boy play toy phone,3.5,0.6554777496503675,3824,3736,88,7744
63,man ride motorcycle,man ride horse,1.399999976158142,0.5163726245454154,2768,1343,1425,2030625
64,man ride motorcycle,man ride horse,1.399999976158142,0.5163726245454154,2767,1342,1425,2030625
65,squirrel spin circle,squirrel run circle,4.0,0.7602703336838017,4607,4406,201,40401
66,man woman kiss,man woman kiss,5.0,1.0,5610,5514,96,9216
67,man get car,man get car garage,3.8329999446868896,0.6336810799504885,3660,4331,-671,450241
68,man dance,man talk,0.6000000238418579,0.2838458347902844,1347,635,712,506944
69,man play guitar singing,man play guitar,2.9170000553131104,0.7335578147789306,4409,2755,1654,2735716
70,person cut mushroom,person cut mushroom knife,4.199999809265137,0.8533320479541702,5182,4766,416,173056
71,tiger cub make sound,tiger walk,2.0,0.38312900106133985,1900,1844,56,3136
72,person slide onion,person peel onion,2.5999999046325684,0.6355473403861672,3679,2451,1228,1507984
73,man play piano,man play trumpet,1.600000023841858,0.3533479204421621,1726,1483,243,59049
74,woman peel potato,woman peel apple,2.0,0.5718088064221803,3193,1822,1371,1879641
75,canada eat bamboo,bear eat bamboo,4.199999809265137,0.6835381785964192,4013,4740,-727,528529
76,person peel onion,person peel eggplant,2.0,0.5614793606706925,3109,1827,1282,1643524
77,monkey push monkey,monkey push monkey,4.800000190734863,1.0000000000000002,5741,5356,385,148225
78,squirrel run circle,squirrel move circle,4.400000095367432,0.9303186197989152,5513,5083,430,184900
79,man tie shoe,man tie shoe,5.0,1.0,5626,5688,-62,3844
80,boy singe play piano,boy play piano,3.0,0.8262464576977402,5019,3000,2019,4076361
81,dog eat water melon,dog eat piece watermelon,4.25,0.3148695177766041,1508,4938,-3430,11764900
82,woman chop broccoli,woman chop broccoli knife,4.25,0.8600404626425364,5221,4941,280,78400
83,man peel potato,man peel potato,3.799999952316284,1.0,5628,4187,1441,2076481
84,woman play guitar,man play guitar,2.400000095367432,0.8250188422281313,5014,2215,2799,7834401
85,woman slide tomato,man slide onion,1.600000023841858,0.331285030176284,1605,1482,123,15129
86,man swim underwater,woman swim underwater,2.0,0.900356697351607,5413,1919,3494,12208036
87,man woman talk,man woman eat,1.600000023841858,0.46175085327400767,2382,1480,902,813604
88,small dog chase ball,dog chase ball,4.0,0.8846485629672008,5344,4398,946,894916
89,man play cricket,man play basketball,2.200000047683716,0.33460827050777064,1624,2042,-418,174724
90,man ride motorcycle,man ride motorcycle,4.400000095367432,1.0000000000000002,5728,5106,622,386884
91,man play guitar,man singe play guitar,3.5999999046325684,0.7885309020416359,4786,3888,898,806404
92,man talk telephone,man talk phone,3.5999999046325684,0.42010868013215275,2125,3901,-1776,3154176
93,man fish,man exercise,0.5,0.19317779176833474,960,594,366,133956
94,man hesitate,man talk,0.800000011920929,0.20437820466675663,997,777,220,48400
95,boy drive,day dance,0.6000000238418579,0.0,396,627,-231,53361
96,man ride horse,girl ride horse,2.5999999046325684,0.7694283041275687,4652,2413,2239,5013121
97,man ride bicycle,monkey ride bike,2.0,0.28529389808923905,1353,1897,-544,295936
98,man slide potato,woman peel potato,2.200000047683716,0.46470513553185483,2400,2110,290,84100
99,woman peel potato,man slide potato,2.400000095367432,0.46470513553185483,2402,2183,219,47961
100,man play guitar,play guitar,3.5999999046325684,0.915641816349068,5467,3896,1571,2468041
101,woman slide week,woman slide ginger,2.200000047683716,0.46624982032857953,2416,1997,419,175561
102,man cut paper plate,man cut paper plate,4.800000190734863,1.0,5605,5385,220,48400
103,man play guitar,man play flute,1.6430000066757202,0.39540143452390986,1971,1594,377,142129
104,man play piano,man play violin,1.75,0.36514572252001776,1780,1607,173,29929
105,woman slide meat,woman read meat,2.25,0.5858914345214024,3291,2154,1137,1292769
106,man play keyboard,man play keyboard piano,4.0,0.7935120546128404,4822,4685,137,18769
107,lady chop green onion,lady cut green onion,4.800000190734863,0.7682301172993715,4646,5379,-733,537289
108,sit nodule water,woman boil nodule water,3.200000047683716,0.6490509880608477,3774,3259,515,265225
109,iogel fichte dance ceiling,iogel ritchie dance stand ceiling,4.0,0.6312162979552884,3644,4562,-918,842724
110,man play piano,person play piano,4.400000095367432,0.7952921212904781,4831,4999,-168,28224
111,woman play flute,woman play flute,4.599999904632568,1.0,5643,5152,491,241081
112,boy check callender,boy look calendar,3.799999952316284,0.15215639780229856,792,4066,-3274,10719076
113,woman cut onion,woman chop onion,4.800000190734863,0.6079049399039181,3467,5373,-1906,3632836
114,man play guitar,man play guitar,4.85699987411499,0.9999999999999998,5588,5480,108,11664
115,woman sewing machine,woman sewing machine,5.0,1.0,5688,5673,15,225
116,woman slip pancake,cartoon chef slip pancake,2.532999992370605,0.663261451965101,3876,2366,1510,2280100
117,man run road,car drive road,1.0,0.43018251993298745,2184,1068,1116,1245456
118,man ride horse,man talk phone,1.0,0.157414312691758,808,1074,-266,70756
119,man ride bike,man ride horse,2.0,0.5277539550230118,2843,1802,1041,1083681
120,woman dance,man eat,0.1430000066757202,0.0,331,370,-39,1521
121,man play piano,man play flute,2.0,0.3712017048179364,1815,1798,17,289
122,man play flute,man play piano,1.600000023841858,0.3712017048179364,1816,1474,342,116964
123,man spin,man dance,1.600000023841858,0.190338755341476,948,1481,-533,284089
124,monkey swinge limb limb,monkey swinge tree tree,3.400000095367432,0.35503825422183416,1733,3539,-1806,3261636
125,people get train,people get train station,4.0,0.7580438991609824,4583,4550,33,1089
126,dog jump trampling,dog ounce trampling,4.800000190734863,0.6210537749172809,3569,5392,-1823,3323329
127,boy play instrument,man play trumpet,2.5,0.2018211599238834,992,2353,-1361,1852321
128,woman play guitar,man sing play guitar,1.75,0.6129002179279245,3514,1609,1905,3629025
129,woman pick,woman slide tomato,1.0,0.18669425000604664,935,983,-48,2304
130,man climb rope,man limb rope,5.0,0.5412251178195635,2963,5730,-2767,7656289
131,man lift car,man climb wall,1.399999976158142,0.11802712956536304,637,1333,-696,484416
132,man woman drive street deep,man woman drive road open air vehicle,4.0,0.33848091941844116,1648,4345,-2697,7273809
133,shortness man sit chair,shortness man sit chair,3.799999952316284,1.0,5686,4267,1419,2013561
134,woman wrest,woman wrest floor,4.0,0.8169582472743965,4968,4465,503,253009
135,puppy play blue tennis ball,puppy play tennis ball,4.0,0.9177173919559896,5475,4426,1049,1100401
136,kangroo eat,kangaroo eat,4.800000190734863,0.3288677196493854,1589,5365,-3776,14258176
137,cat play piano,man play guitar,0.6000000238418579,0.2360486553335915,1109,725,384,147456
138,man cut carpet knife,man cut carpet knife,4.75,1.0,5682,5341,341,116281
139,woman ride motorize soon road,man ride motor soon,2.200000047683716,0.4432898084121011,2269,2009,260,67600
140,slide vegetable,slide tomato,3.0,0.3586444232099306,1746,3067,-1321,1745041
141,woman dance,man talk,0.0,0.0,323,318,5,25
142,dog lick baby droop,dog lick baby,2.200000047683716,0.751984295676263,4541,2048,2493,6215049
143,man row boat,man slide tomato,0.4000000059604645,0.11409935855207204,616,478,138,19044
144,man cut potato,man slice potato,4.800000190734863,0.59460751910208,3370,5407,-2037,4149369
145,woman chop garlic,woman dine garlic,4.800000190734863,0.5634157994274208,3130,5422,-2292,5253264
146,animal run circle,squirrel run circle,3.799999952316284,0.6009374793856692,3410,4300,-890,792100
147,man walk slowly rope bridge,boy walk bridge,3.0,0.5522639934754083,3050,2929,121,14641
148,man play guitar,man seat room play guitar,4.0,0.6876946716523136,4049,4361,-312,97344
149,man play flute,man play flute,5.0,1.0,5677,5727,-50,2500
150,woman crack egg glass bowl,woman crack egg bowl,3.799999952316284,0.8685162308235267,5257,4240,1017,1034289
151,man cut fish,man gun fish,3.0,0.5908480266337671,3333,2950,383,146689
152,man pack suitcase trunk car,man put suitcase car trunk,4.400000095367432,0.8567016963414134,5201,4991,210,44100
153,man hour oil tomato,man pour oil cut potato,3.799999952316284,0.3059385275109881,1460,4324,-2864,8202496
154,man slide,man slide,3.0,1.0000000000000002,5724,3015,2709,7338681
155,man waddle canoe,man play harp,0.6669999957084656,0.09072106684999481,487,729,-242,58564
156,man woman walk wood,man woman walk arm arm wooded area,4.0,0.3095290920121826,1479,4581,-3102,9622404
157,woman pick kangaroo,woman pick baby kangaroo,3.75,0.8755810977134757,5306,4050,1256,1577536
158,wish swim,fish swim,4.132999897003174,0.43971376595007045,2246,4703,-2457,6036849
159,woman mix food processor,woman slender,4.0,0.10852826775386007,580,4663,-4083,16670889
160,person surge large wave,person surge,3.5999999046325684,0.7340751703135624,4413,3784,629,395641
161,man play guitar,man stab target,1.2000000476837158,0.11950017708302403,645,1209,-564,318096
162,man play flute band,man play guitar,1.600000023841858,0.30694251508041265,1465,1498,-33,1089
163,man spread butter loaf bread,man spread butter bread,4.0,0.8302802449292813,5051,4383,668,446224
164,person boil nodule,woman boil nodule water,4.0,0.7999947644794074,4864,4379,485,235225
165,group people dance hill,group people dance,3.200000047683716,0.7984131723331278,4855,3178,1677,2812329
166,man dance outside,man play flute,1.0,0.13474974615848614,720,1029,-309,95481
167,woman feed man,woman mix meat,1.0,0.14889943880309417,777,1030,-253,64009
168,man put pan oven,woman cut onion,0.6000000238418579,0.0,339,706,-367,134689
169,woman sit desk,woman ride donkey,0.4000000059604645,0.13133856362428298,705,467,238,56644
170,relics transport patient stretcher,doctor rush patient stretcher,3.400000095367432,0.549752200218343,3030,3560,-530,280900
171,woman play flute stage,woman play flute,3.5999999046325684,0.8300661818056854,5049,3761,1288,1658944
172,baby hand play,hand lay,3.0,0.43934877520087195,2242,2861,-619,383161
173,baby laugh,baby laugh tingling,4.0,0.7232770517966178,4314,4626,-312,97344
174,man play guitar,boy play piano,1.2000000476837158,0.24226884800815313,1135,1208,-73,5329
175,man fold paper,woman slide pepper,0.6000000238418579,0.0,365,704,-339,114921
176,woman dance,man dance,1.600000023841858,0.730125145259356,4367,1497,2870,8236900
177,cat play,cat fight,2.5999999046325684,0.4967933238567932,2640,2471,169,28561
178,person write,person write pencil,3.5999999046325684,0.7317798450536008,4387,3777,610,372100
179,man run,man run road,3.5,0.688519477518611,4056,3705,351,123201
180,woman roll dough,woman floor rolling dough,3.765000104904175,0.4621718156286587,2384,4058,-1674,2802276
181,woman add space meat,woman add sugar meat,2.75,0.6172794036724024,3548,2564,984,968256
182,woman add oil fish,woman pour water fish,2.25,0.4307410732419895,2186,2145,41,1681
183,young boy hold guitar,little boy play guitar,2.75,0.5407994132852345,2959,2545,414,171396
184,cheetah run,cheetah run field,3.799999952316284,0.8688689448845074,5261,4086,1175,1380625
185,man eat penza,man eat slice penza,4.800000190734863,0.8236380534286465,5004,5436,-432,186624
186,orangutan ride bus,monkey ride bus,3.5999999046325684,0.4918630407360627,2597,3807,-1210,1464100
187,man woman talk dinner,man woman ride bicycle,1.2000000476837158,0.26127420992241407,1233,1207,26,676
188,man play guitar,man clean glass door,0.4000000059604645,0.1084879380202292,579,570,9,81
189,girl singe play guitar,young man singe play guitar,2.400000095367432,0.7697664976945233,4654,2173,2481,6155361
190,girl communicate sign language,young girl sign language,3.940999984741211,0.7127645790431784,4240,4343,-103,10609
191,woman weight exercise,woman hair,0.5,0.1567118218940382,802,615,187,34969
192,man get inside car,elderly man get red car,3.75,0.4002228184367259,2007,4005,-1998,3992004
193,big green ball knock potato,large green ball hit potato,4.0,0.5817829155050742,3257,4653,-1396,1948816
194,cat play keyboard,cat play piano,3.0,0.4867124344784941,2554,3005,-451,203401
195,dog swim pool,dog swim pool,4.199999809265137,1.0000000000000002,5740,4864,876,767376
196,man copper chop onion,man machine chop potato,2.0,0.3514795836496388,1721,1932,-211,44521
197,woman slice,woman cut,5.0,0.2677495276735819,1272,5605,-4333,18774889
198,herd deer cross street,herd carbon cross road,3.0,0.5285323231356029,2847,3054,-207,42849
199,person ride horse,man ride horse,3.799999952316284,0.7620945771138466,4613,4190,423,178929
200,feed animal,play piano,0.0,0.0,356,277,79,6241
201,slide tortila,ride horse,0.0,0.0,354,276,78,6084
202,mix ingredient,sew thing,0.25,0.0,353,442,-89,7921
203,monster neck dead mouse,chicken pack dead mouse,4.0,0.4276506671394814,2166,4397,-2231,4977361
204,woman hold kangaroo,woman pick kangaroo,3.25,0.6916169488651371,4080,3373,707,499849
205,man play frog,cat play camera,0.75,0.22179534135053647,1054,734,320,102400
206,man talk,man play guitar,1.5,0.22751668979342674,1073,1448,-375,140625
207,man spread butter big piece bread,man smear butter slice garlic bread,3.5,0.43703436359328746,2228,3731,-1503,2259009
208,man run high wire,man run rope,3.0,0.3409824197129895,1661,3053,-1392,1937664
209,man mow lawn,woman cut lemon,0.2000000029802322,0.0,349,399,-50,2500
210,man open door,man play guitar,0.800000011920929,0.1490672308759759,778,830,-52,2704
211,man slide potato piece,man cut potato,4.199999809265137,0.5410854512718314,2961,4823,-1862,3467044
212,woman cut cook octopus,woman chop octopus,3.799999952316284,0.5602093622208312,3098,4189,-1091,1190281
213,man munch board,dog run water,0.4000000059604645,0.0,347,527,-180,32400
214,man dance,man eat bread,0.800000011920929,0.16949222237968503,867,799,68,4624
215,play piano,man play guitar,1.2000000476837158,0.2809630326210814,1333,1204,129,16641
216,fox eat plate brick ratio,box eat plate,2.799999952316284,0.4396096004405097,2244,2700,-456,207936
217,boy play key board,boy play piano,3.200000047683716,0.40600788166089574,2042,3230,-1188,1411344
218,person play keyboard,play keyboard,5.0,0.8642018925104142,5244,5575,-331,109561
219,man shoot gun,man spit,0.0,0.12688931762447142,687,304,383,146689
220,slide onion,peel potato,1.0,0.0,344,902,-558,311364
221,man swim,woman slide meat,0.0,0.0,343,303,40,1600
222,man play guitar,man play caustic guitar,3.75,0.705214501733342,4175,4055,120,14400
223,woman slide pushkin,woman ride elephant,0.4000000059604645,0.11877713169387154,640,540,100,10000
224,woman dance,woman knead dough,0.4000000059604645,0.1574109195101718,807,541,266,70756
225,woman crack egg bowl,woman place skewer rack,0.6000000238418579,0.07668986460378609,442,681,-239,57121
226,car move road,car drive road,4.0,0.7978098259007933,4852,4686,166,27556
227,dress pan,lay,0.4000000059604645,0.0,341,564,-223,49729
228,man play guitar,man drain past,0.4000000059604645,0.12139544600272399,653,563,90,8100
229,woman drink vodka,woman exercise,0.4000000059604645,0.13731155291734096,728,559,169,28561
230,woman cut meat piece,woman cut meat,4.800000190734863,0.8228183521976562,5000,5415,-415,172225
231,man rinse speak,man play guitar,0.6000000238418579,0.12263343894909103,666,663,3,9
232,man sell item,man clean house,0.800000011920929,0.10632760815038501,563,823,-260,67600
233,man jump wall,man jump short wall,3.200000047683716,0.7990000938239603,4857,3260,1597,2550409
234,runner race track,runner compete race,3.200000047683716,0.7001485206072291,4129,3263,866,749956
235,man kick soccer ball,man mix bowl,0.6000000238418579,0.09597827311076192,509,676,-167,27889
236,woman try,woman ride horse,0.6000000238418579,0.23571561341183953,1107,672,435,189225
237,cat lick suck,woman slide cucumber,0.0,0.0,327,292,35,1225
238,woman dance fire,woman take bath,1.399999976158142,0.20966712730864145,1014,1346,-332,110224
239,man slide fish open,man slide potato,2.200000047683716,0.42461558941200533,2153,1985,168,28224
240,utter melt pan,man melt butter pan,3.5999999046325684,0.6289356738583152,3621,3806,-185,34225
241,boy dance,lid dance,3.111000061035156,0.4357370123036714,2220,3076,-856,732736
242,woman play game man,man play piano,0.6000000238418579,0.3668196461760551,1794,697,1097,1203409
243,man drive white car,man give interview,0.4000000059604645,0.1378626679244756,731,557,174,30276
244,man drive car,man drive car,4.25,1.0,5664,4909,755,570025
245,car back space,car back blocked lane,3.0,0.26015427093914006,1230,2854,-1624,2637376
246,man put cheese penza,man sprinkle cheese penza,5.0,0.7765263700702937,4699,5654,-955,912025
247,boy play piano,boy play piano,5.0,1.0,5665,5647,18,324
248,man play guitar,man play guitar,3.75,0.9999999999999998,5587,4038,1549,2399401
249,man ride horse,man play keyboard,0.2000000029802322,0.15146529599822048,790,379,411,168921
250,man walk rope,man ride mo pad,0.4000000059604645,0.08890529529590845,478,534,-56,3136
251,girl play flute,band play stage,1.2860000133514404,0.18219964197537653,920,1260,-340,115600
252,people step train,group people train,4.599999904632568,0.5888475312181833,3313,5161,-1848,3415104
253,woman sewing machine,woman read meat,0.6000000238418579,0.10894544100533922,583,722,-139,19321
254,dog look swimming pool,dog walk pool,2.0,0.5191142139783153,2789,1874,915,837225
255,man mutter piece bread,man apply butter bread,5.0,0.3662847637363691,1790,5630,-3840,14745600
256,man cut potato piece,woman cut vegetable,1.7999999523162842,0.2575234210828953,1213,1670,-457,208849
257,teenage girl dance room,teenage girl dance camera,2.400000095367432,0.774963979037466,4685,2265,2420,5856400
258,lion walk,lion pace pen,2.400000095367432,0.46005297732732575,2370,2293,77,5929
259,man shoot car,man cut potato,0.4000000059604645,0.14320704369268805,751,460,291,84681
260,black horse run,horse run,4.199999809265137,0.8461729527074313,5140,4771,369,136161
261,woman evening shrimp,man dance rain,0.0,0.0,314,355,-41,1681
262,man ride horse,woman wash freeze,0.0,0.0,315,352,-37,1369
263,man walk path,man walk tight rope,0.800000011920929,0.3305458823242938,1598,751,847,717409
264,man slide potato,woman cut jalepeno,1.399999976158142,0.0,316,1371,-1055,1113025
265,dog bark ball,dog swim tennis ball,1.5,0.381419689470173,1890,1432,458,209764
266,kid run away fish swinge fishing pole,little kid run fishing pole,2.5,0.6933317907093202,4089,2356,1733,3003289
267,man walk path wilderness,man walk road,2.5,0.33768502630586894,1643,2331,-688,473344
268,elderly man speak sodium,man make speech sodium,3.5,0.4716744992847046,2457,3735,-1278,1633284
269,man ride horse slow motion,man ride horse,3.400000095367432,0.6035354329557243,3431,3511,-80,6400
270,person cut bursata cheese,person slide cheese,3.799999952316284,0.5563166720160834,3078,4166,-1088,1183744
271,man shoot automatic rifle,man shoot gun,3.799999952316284,0.3755203947613888,1852,4163,-2311,5340721
272,man crush garlic knife,woman slide meat knife,1.5,0.2755289047639459,1310,1441,-131,17161
273,woman file fingernail board,woman feed baby bottle,0.5,0.08280443082627524,454,610,-156,24336
274,man ride skateboard,woman cut potato,0.0,0.0,326,269,57,3249
275,woman take shower,man ride white horse,0.0,0.0,368,134,234,54756
276,man dance,man ride horse,0.800000011920929,0.2055444287847605,1006,770,236,55696
277,man row boat,man shoot gun,0.8500000238418579,0.116544294949056,629,887,-258,66564
278,man swinge rope attach ceiling,man swinge rope,3.400000095367432,0.6882340022321702,4052,3538,514,264196
279,woman ride horse beach,man carry man,0.4000000059604645,0.0,334,477,-143,20449
280,man hold small animal hand,man show small monkey,1.75,0.3652474741954493,1781,1621,160,25600
281,person fold square paper piece,man fold paper,3.25,0.6368509768288775,3691,3346,345,119025
282,person try meat pan,person hold sunk,0.75,0.17486116723227194,893,743,150,22500
283,chimpanzee hurt woman,man drive car,0.0,0.0,369,97,272,73984
284,woman peel shrimp,man hold femur,0.0,0.0,406,96,310,96100
285,debris play,debris socialize,4.25,0.5949392270277511,3374,4915,-1541,2374681
286,woman slide butter,woman slice,1.7999999523162842,0.17416080111543647,888,1724,-836,698896
287,man play guitar,man play guitar singe,3.200000047683716,0.7885309020416359,4785,3179,1606,2579236
288,elephant spray water,elephant spray water,3.5999999046325684,1.0000000000000002,5717,3757,1960,3841600
289,dog sit counter store,dog stand counter,2.5999999046325684,0.6365466910114776,3688,2423,1265,1600225
290,drill hole strip wood power drill,man drill hole piece wood,3.200000047683716,0.729227036067075,4359,3094,1265,1600225
291,woman slide vegetable,woman dine garlic,2.799999952316284,0.12224611553433641,659,2725,-2066,4268356
292,badge burrow hole,badge dig earth,4.599999904632568,0.34508941981094926,1686,5273,-3587,12866569
293,woman water skin lake,man play flute,0.0,0.0,395,91,304,92416
294,girl play violin,baby laugh tingling,0.25,0.0,377,447,-70,4900
295,helicopter land helped,helicopter land,3.92300009727478,0.7177140629416223,4279,4338,-59,3481
296,woman cut chicken,woman slide meat,2.75,0.14019395151296535,737,2541,-1804,3254416
297,woman cut cucumber,man play guitar,0.0,0.0,378,90,288,82944
298,woman ride elephant adoring crowd,woman ride elephant,3.0,0.6607327791495636,3857,3024,833,693889
299,puppy slide backwards floor,puppy push backwards,3.799999952316284,0.6949560323529704,4099,4150,-51,2601
300,woman splint garlic glove,woman break head garlic glove,4.599999904632568,0.637109419808537,3693,5304,-1611,2595321
301,dog look swimming pool,dog walk edge pool,2.5999999046325684,0.4089585745326655,2058,2512,-454,206116
302,woman mile beauty treatment glass,woman mix cream glass spoon,3.5999999046325684,0.24552825570424963,1149,3747,-2598,6749604
303,man draw picture,person draw,3.5999999046325684,0.5748619250960577,3211,3750,-539,290521
304,woman pick potato,woman pour matter bowl,1.0,0.11248469294226286,613,943,-330,108900
305,man look computer monitor,man lawton,2.75,0.1158596077397169,626,2554,-1928,3717184
306,boy ride trickle,woman ride water soon,1.25,0.21174043142085677,1019,1251,-232,53824
307,man compete tire roll race,people slip traitor tire race,2.75,0.41801179142797873,2115,2558,-443,196249
308,person cut meat,person ride mechanical bull,0.0,0.18233999536799325,922,89,833,693889
309,man play violin,woman sewing machine,0.0,0.0,309,88,221,48841
310,baby crawl doorway,baby crawl floor,2.400000095367432,0.6164777850057652,3538,2266,1272,1617984
311,man play keyboard,person play piano,2.200000047683716,0.2218280159874754,1055,2041,-986,972196
312,man smell pizza,woman feed man,0.2000000029802322,0.09848559721158169,523,425,98,9604
313,monkey pull tail dog,monkey tease dog,2.799999952316284,0.39334230152046434,1957,2660,-703,494209
314,dog lie wooden floor,dog lay floor,4.0,0.4953234159106958,2630,4610,-1980,3920400
315,woman try pan,man play guitar,0.0,0.0,98,87,11,121
316,man put reasoning bowl water,man add reasoning water bowl,5.0,0.8880125901117095,5356,5626,-270,72900
317,elderly woman pour oil try pan,tied man put water,0.0,0.0,99,86,13,169
318,woman chop onion,woman slide partially half onion,3.200000047683716,0.39320900308728357,1955,3086,-1131,1279161
319,woman pick kangaroo,woman carry kangaroo,3.5,0.6604550006039354,3854,3690,164,26896
320,dog bite,dog open food,1.75,0.20421786165514288,996,1610,-614,376996
321,woman define fish,man catch fish,1.25,0.3755185634207531,1851,1246,605,366025
322,man mow grass,man burst concrete,0.8330000042915344,0.09154144302125948,492,886,-394,155236
323,cat watch,man slide leave,0.0,0.0,101,82,19,361
324,boy stick door hothouse,child stick dog house,3.75,0.26756512765038176,1270,3999,-2729,7447441
325,people lip swimming pool,man fall pool,2.75,0.3227213732625294,1554,2546,-992,984064
326,woman swim underwater,woman swim,3.799999952316284,0.6625384773868661,3870,4159,-289,83521
327,man play guitar,woman dance,0.2000000029802322,0.0,103,378,-275,75625
328,airplane fly air,south african airways plane fly blue sky,3.400000095367432,0.19288698971798615,958,3517,-2559,6548481
329,bear run dog,bear fight wolf,1.399999976158142,0.4299237013677035,2182,1357,825,680625
330,woman rest float raft,woman relax inner tube,3.799999952316284,0.06761680345600629,423,4160,-3737,13965169
331,man dine operating room,man kiss woman stage,0.4000000059604645,0.08578129998259908,469,522,-53,2809
332,man hold leaf,woman watch television,0.0,0.0,104,78,26,676
333,person ride horse,woman slide potato,0.0,0.0,106,77,29,841
334,woman slide octopus,man play guitar,0.0,0.0,114,76,38,1444
335,man break water jug,woman peel garlic,0.2000000029802322,0.0,107,424,-317,100489
336,man play guitar,woman cut vegetable,0.0,0.0,108,75,33,1089
337,girl eat cupcake,man slide cucumber,0.0,0.0,109,74,35,1225
338,little girl play grass dog ball,baby play dog ball,3.799999952316284,0.5298731999539197,2858,4161,-1303,1697809
339,people ride paddle raft,people float raft,2.25,0.5493653684713317,3027,2151,876,767376
340,lady cut potato,man cut potato,2.400000095367432,0.730364597340674,4372,2276,2096,4393216
341,missile explode,rocket explode,3.200000047683716,0.5358895342707388,2925,3177,-252,63504
342,dog play snow,dog paw fly carpet,1.600000023841858,0.14294300869870374,750,1569,-819,670761
343,woman dance woman,woman shed chicken,0.4000000059604645,0.24248645759984205,1136,544,592,350464
344,boy push van,person slide tomato,0.0,0.0,113,71,42,1764
345,boy make dance step,boy pour pitcher,0.4000000059604645,0.16669255654694287,851,583,268,71824
346,woman open soda drink,woman ride elephant,0.6000000238418579,0.10121609102952463,537,674,-137,18769
347,man assemble speaker part,man play guitar,1.0,0.110232614859808,599,972,-373,139129
348,dog walk edge pool,dog walk pool,4.599999904632568,0.7878007643029956,4779,5300,-521,271441
349,utter bowl,man cut butter mixing bowl,4.25,0.2501857892128736,1172,4936,-3764,14167696
350,raccoon eat,man eat,1.5,0.47228823448156454,2460,1433,1027,1054729
351,fall horse,man gets knock horse,3.5,0.27621197596943614,1313,3729,-2416,5837056
352,woman feel apple,man pip wheel motorcycle,0.0,0.0,96,70,26,676
353,man take path class,man rinse speak,0.0,0.09121338857934706,490,69,421,177241
354,animal play water,man play king long,0.0,0.2006806502137565,988,83,905,819025
355,man ride horse jump obstacle,man kick soccer ball,0.3330000042915344,0.07879563237420782,447,455,-8,64
356,person pencil trick hand,person slide carrot half,0.3330000042915344,0.15023717810101014,785,458,327,106929
357,person light camera fire,person blow touch camera,3.3329999446868896,0.43850849055042274,2237,3417,-1180,1392400
358,man slide tape box,man cut open box,4.333000183105469,0.41036589410383956,2070,4952,-2882,8305924
359,man fish river,man singe walk sidewalk,0.800000011920929,0.10342397462007653,546,821,-275,75625
360,man ride bike,woman dance street,0.2000000029802322,0.0,94,423,-329,108241
361,man push,woman cut octopus,0.0,0.0,79,117,-38,1444
362,man play guitar,woman slide pork,0.0,0.0,80,102,-22,484
363,little boy singe play guitar,baby play guitar,2.799999952316284,0.4808305586051754,2517,2711,-194,37636
364,woman powder face,woman tap finger table,0.800000011920929,0.10049218895849417,530,822,-292,85264
365,woman peel potato,lion walk,0.0,0.0,81,132,-51,2601
366,woman fire rifle,man perform sound,0.25,0.0,82,446,-364,132496
367,woman put grand man shoulder,man hour water pilot head,0.5,0.07371160563477296,435,612,-177,31329
368,old woman shake hand man,man woman shake hand,3.75,0.8874091646757998,5354,3994,1360,1849600
369,woman waterskie,woman wake boarding lake,1.75,0.09730915212080975,516,1604,-1088,1183744
370,tree bend storm,tree hit hard wind,2.6670000553131104,0.23043459306427957,1090,2532,-1442,2079364
371,man woman ride car,woman try shrimp,0.4000000059604645,0.15130587415764668,789,552,237,56169
372,man move tree limb,woman play violin,0.0,0.0,84,131,-47,2209
373,man play piano,woman play violin,1.0,0.22774738976892941,1078,897,181,32761
374,person hour oil skilled,person dine onion,0.800000011920929,0.1675578362200191,854,794,60,3600
375,animal eat,woman dance,0.0,0.0,85,130,-45,2025
376,woman walk dog,woman walk dog street,4.0,0.7968122945376528,4841,4552,289,83521
377,group people sing,people singe,5.0,0.2591825004471501,1223,5619,-4396,19324816
378,cat drink milk,cat lick saucer milk,4.400000095367432,0.5122249064653559,2746,5017,-2271,5157441
379,girl make eyelid,woman apply eyeshadow,2.0,0.0,87,1898,-1811,3279721
380,man fight,man fight form martial art,2.799999952316284,0.486659666817826,2551,2678,-127,16129
381,military officer bark recruit,officer talk recruit,2.5,0.636321483531433,3683,2338,1345,1809025
382,man put chicken container,man put food box,2.5,0.09775853937229383,519,2329,-1810,3276100
383,man tie stenographer machine,man stenographic,2.25,0.08442774197045148,464,2143,-1679,2819041
384,woman add past pot water,woman make nodule,3.5999999046325684,0.10043077060731659,529,3789,-3260,10627600
385,woman lie blanket rock read book,woman seat singe song play guitar,1.2000000476837158,0.058729400281240254,415,1242,-827,683929
386,supply play,man play soccer,0.2000000029802322,0.2729233244178296,1297,430,867,751689
387,man run field,man limb rope,1.0,0.13869611281884556,732,908,-176,30976
388,man hug,man take picture,0.4000000059604645,0.17387833760587332,886,561,325,105625
389,pour ingredient pot,man put vegetable pot,2.799999952316284,0.35647277805195665,1740,2697,-957,915849
390,couple walk,man saw,0.0,0.0,91,128,-37,1369
391,person play guitar,man play guitar,3.0,0.7702846778020567,4658,3060,1598,2553604
392,person add food pan,woman put rice pan,3.0,0.33922173176142195,1653,3050,-1397,1951609
393,group penguin walk,large penguin head ocean,2.799999952316284,0.49083957222869923,2592,2710,-118,13924
394,man play guitar,handle,0.0,0.0,93,125,-32,1024
395,dog jump trampling,boy play guitar,0.0,0.0,105,124,-19,361
396,man shake container kitchen sink,man empty plastic container,2.200000047683716,0.4291611483192477,2178,2036,142,20164
397,man walk horse,man lead horse halt,3.75,0.4288844809539092,2173,4029,-1856,3444736
398,paper cut scissor,piece paper cut,4.0,0.5662833953505405,3152,4657,-1505,2265025
399,person feel shrimp,lady peel shrimp,3.5,0.3990749713107049,1994,3716,-1722,2965284
400,man play guitar,man try read paper,0.800000011920929,0.11420258986604787,617,767,-150,22500
401,man make bed hotel,man hold animal,0.800000011920929,0.10614453323018172,561,790,-229,52441
402,dog pull dog tail leg,monkey pull dog tail,1.75,0.7106741621708053,4225,1614,2611,6817321
403,woman beat egg bowl,person mix ingredient bowl,3.0,0.251885535319889,1182,2789,-1607,2582449
404,man jump rope outside,woman slide cucumber,0.0,0.0,137,122,15,225
405,person slide onion,master singe,0.0,0.0,138,121,17,289
406,woman hold kangaroo,man hat sing song,0.0,0.0,139,120,19,361
407,soccer player kick soccer ball goal,soccer player score goal,3.799999952316284,0.7016500583944214,4146,4115,31,961
408,woman cook,woman pour ingredient try pan,3.200000047683716,0.12190035251924435,657,3152,-2495,6225025
409,woman swim beach,woman splash ocean wave,3.200000047683716,0.11187027544266871,609,3157,-2548,6492304
410,man carry man,man spray man water,0.800000011920929,0.4456174855014275,2285,801,1484,2202256
411,woman put paste dish,woman pull kind sticky bowl,1.5,0.06909246406110316,428,1430,-1002,1004004
412,man hold talk gray tube t shirt,man show t shirt,2.75,0.48039050890156315,2515,2548,-33,1089
413,hour olive oil bowl tomato edge,man pour oil tomato slice,3.75,0.36902323519919095,1801,4039,-2238,5008644
414,man play guitar,man play guitar friend,3.200000047683716,0.7505871588824229,4531,3159,1372,1882384
415,boil oka pot,hour olive oil bowl tomato edge,0.800000011920929,0.0,141,796,-655,429025
416,person peel potato,cat lick small bottle,0.0,0.0,142,133,9,81
417,cat jump box,young man talk leaf,0.0,0.0,143,118,25,625
418,woman reason oil,woman pour ingredient bowl,1.399999976158142,0.10910465061712675,588,1317,-729,531441
419,cat slide upside couch,cat crawl piece furniture,3.200000047683716,0.1588714382529931,814,3162,-2348,5513104
420,woman dance man play keyboard,woman dance stage,2.200000047683716,0.4437648239889671,2272,2079,193,37249
421,chef clean bowl soup,man wipe edge bowl,2.532999992370605,0.1910741381548378,950,2365,-1415,2002225
422,explosion boom desert,nuclear weapon explode desert,3.400000095367432,0.3282987301858242,1584,3673,-2089,4363921
423,woman slice lemon,man talk microphone,0.0,0.0,153,115,38,1444
424,overnight man ship rope,young man dance,0.800000011920929,0.107831534518649,575,792,-217,47089
425,lady crack raw egg,woman crack egg bowl,3.200000047683716,0.5476594520671864,3007,3145,-138,19044
426,man sharpen pencil knife,woman dance rain,0.0,0.0,146,114,32,1024
427,elastic toy float water,lady perform dance,0.0,0.0,147,113,34,1156
428,turtle follow fish,sea turtle hunt fish,3.0,0.5816965045478267,3256,2798,458,209764
429,woman pencil eye shadow,girl eye pencil eyelid,2.799999952316284,0.5312643427410234,2880,2668,212,44944
430,man tie shoe,dog ride bicyclist shoulder,0.0,0.0,148,111,37,1369
431,woman slide meat knife,man spread dough,0.4169999957084656,0.0,149,592,-443,196249
432,dog run ground,girl tap finger nail,0.0,0.0,150,110,40,1600
433,man pet tie dog,man show dog camera,1.0,0.31068169640531973,1485,1103,382,145924
434,woman walk open ground pet dog dog follow,man walk dog,2.0,0.47955002203804675,2509,1858,651,423801
435,woman mine garlic,person clean disk,0.0,0.0,152,108,44,1936
436,tear play soccer,different set tear play football field,2.5,0.4113336318642972,2075,2337,-262,68644
437,rat like creature smell,animal walk ground,2.0,0.0,136,1817,-1681,2825761
438,sum finger fight,man ride water toy water,0.0,0.0,135,107,28,784
439,man lay ground aim rifle,man spread butter gorilla,0.0,0.060727612551171824,417,106,311,96721
440,couple run ocean,man woman run hold hand,2.818000078201294,0.1897117571974721,945,2750,-1805,3258025
441,woman chop hard egg,person cut boil egg piece,3.532999992370605,0.25212615965008356,1183,3744,-2561,6558721
442,root share kiss,male female root kiss,3.799999952316284,0.6119375078516072,3505,4129,-624,389376
443,cat try touch dog,cat tease dog touch head,3.25,0.6014903685480756,3413,3385,28,784
444,rhine graze grass,rhine graze field,4.0,0.8093851558591048,4924,4356,568,322624
445,man drive little red car traffic,dog run water beach,0.0,0.0,133,103,30,900
446,man cut bread,man trick soccer ball,1.0,0.10227555133005761,542,1057,-515,265225
447,cat rapidly seat kid head,cat boy play,2.5999999046325684,0.22806606076640326,1081,2454,-1373,1885129
448,cat play box,dog play floor cleaner,1.399999976158142,0.16303593307279662,830,1284,-454,206116
449,couple dance church,couple slow dance,3.200000047683716,0.6118054429295134,3502,3192,310,96100
450,man pat alligator mouth,person dump chop vegetable pot stove,0.0,0.0,119,68,51,2601
451,person check rice pudding,horse run,0.0,0.0,120,67,53,2809
452,woman stir egg glass bowl,young girl singe stage,0.0,0.0,121,66,55,3025
453,man play drum,man hour clean sink,0.0,0.09189000487353144,494,49,445,198025
454,man slide pepper,person cut big green pepper apart,3.799999952316284,0.3344767641381951,1623,4134,-2511,6305121
455,woman speak sign language,woman space seafood,0.6430000066757202,0.09115490358468897,489,727,-238,56644
456,boy crawl dog house,cat play floor,0.0,0.0,122,30,92,8464
457,girl fly kite run hill,girl lose kite,2.25,0.556358664357856,3079,2147,932,868624
458,woman place food pot hot water,woman try meat,1.25,0.09606755751133428,510,1248,-738,544644
459,small monkey walk water,monkey wade marsh,3.400000095367432,0.2696499171448808,1279,3620,-2341,5480281
460,man ride bike,bear eat,0.0,0.0,124,28,96,9216
461,young man singe play piano,man write letter,0.2000000029802322,0.09002458727087642,485,390,95,9025
462,boy take sunglass,boy scream,0.5,0.25409174616442914,1195,593,602,362404
463,girl play piano,boy push,0.0,0.0,126,27,99,9801
464,lady slice tomato,cut tomato,4.0,0.4932614108582479,2610,4487,-1877,3523129
465,hold hedgehog,onion slice,0.0,0.0,127,25,102,10404
466,woman feel potato,woman trill pineapple,1.0,0.10627056591974184,562,1000,-438,191844
467,cat drink water,truck go hill,0.0,0.0,128,24,104,10816
468,person put salt pepper piece pork,youngster sit piano,0.0,0.0,129,23,106,11236
469,man sit chair stared,little girl put hair pony tail,0.0,0.0,130,22,108,11664
470,woman dine potato,woman cut tiny piece,1.7999999523162842,0.10375111984143068,548,1716,-1168,1364224
471,baby crawl happily,baby sneer scare baby,1.2000000476837158,0.30955698731612735,1480,1230,250,62500
472,person try meat pan,man cut vegetable,0.6000000238418579,0.0,132,720,-588,345744
473,man look window,woman swim water,0.25,0.0,78,443,-365,133225
474,man seat play guitar,man play caustic guitar singe microphone,3.25,0.42819600188865,2169,3384,-1215,1476225
475,woman slide onion knife,man prepare dish,1.25,0.0,76,1250,-1174,1378276
476,rider run jump horse,woman jump bundle horse,4.0,0.4092614832836546,2059,4495,-2436,5934096
477,boy play key board,boy sit room play piano lamp light,3.25,0.24253510936820355,1137,3394,-2257,5094049
478,man fight,man exercise,0.75,0.19515405822453866,966,737,229,52441
479,man play wooden flute man play long drum,man play flute,3.25,0.7091719099864577,4210,3382,828,685584
480,person pet monkey,man hold slow boris,1.2000000476837158,0.0,66,1227,-1161,1347921
481,cartoon rabbit kiss,rabbit kiss rabbit,3.799999952316284,0.7456654304488918,4502,4138,364,132496
482,hedgehog chew towel,hedgehog bite blanket,3.400000095367432,0.3701945260921888,1808,3427,-1619,2621161
483,cat lick,man slide white onion lanolin slice,0.0,0.0,22,17,5,25
484,small guinea pig gnaw eat piece carrot floor,guinea pig eat carrot,3.5,0.7353122136994859,4418,3701,717,514089
485,boy stand burn car,young man stand car explode,3.75,0.38029460987783836,1884,4036,-2152,4631104
486,man smoke,man sit suit smoke,4.0,0.6956795616586131,4102,4502,-400,160000
487,woman add sauce food,person cut leave,0.2000000029802322,0.0,25,374,-349,121801
488,child eat food,deer jump fence,0.0,0.0,26,15,11,121
489,submarine go water,baby fall asleep,0.0,0.0,27,14,13,169
490,man run street,man play guitar,0.800000011920929,0.16893583571051635,865,755,110,12100
491,person slide onion,cat pop toilet,0.0,0.0,28,13,15,225
492,badge dig dirt,man move large rock,0.0,0.0,29,12,17,289
493,woman slide big pepper,dog move mouth,0.0,0.0,30,11,19,361
494,man ride bicycle,man ride bike,5.0,0.4878691275384447,2567,5646,-3079,9480241
495,man woman kiss,man woman talk,0.6000000238418579,0.4335851711578316,2209,703,1506,2268036
496,woman slide onion,woman cut onion,4.199999809265137,0.6602532438598853,3853,4773,-920,846400
497,small boy play dog,baby play dog,3.75,0.44715031529802,2294,4032,-1738,3020644
498,man draw,man draw,5.0,1.0000000000000002,5704,5642,62,3844
499,man cut potato,woman cut tomato,1.25,0.31196556744957504,1490,1253,237,56169
500,boy play guitar,kid play guitar,3.5999999046325684,0.6091708816132378,3476,3767,-291,84681
501,woman cut onion,woman cut onion,5.0,1.0,5689,5641,48,2304
502,toy train strike toy car,toy train strike toy car,5.0,1.0000000000000002,5747,5639,108,11664
503,man play guitar,man play flute,2.200000047683716,0.39540143452390986,1973,2008,-35,1225
504,cat open drawer limb inside,cat open drawer climbing inside,5.0,0.7356557041058776,4422,5636,-1214,1473796
505,woman try food,woman deep try food,4.25,0.7736295414562948,4677,4922,-245,60025
506,man dine onion,woman cut onion,2.5,0.4351908436947565,2216,2348,-132,17424
507,girl play guitar,man play guitar,2.799999952316284,0.7774566146796076,4706,2687,2019,4076361
508,girl singe stage,man singe stage,2.799999952316284,0.8304174978686609,5052,2685,2367,5602689
509,woman ride horse,woman ride donkey,2.799999952316284,0.4310186576430034,2190,2684,-494,244036
510,girl play guitar,man play guitar,2.799999952316284,0.7774566146796076,4705,2683,2022,4088484
511,woman brush shrimp,woman brush shrimp,5.0,1.0,5642,5610,32,1024
512,man dance ceiling,man dance ceiling room,4.800000190734863,0.8551746470410769,5190,5413,-223,49729
513,woman thinly slice onion large knife,woman slide onion large knife,4.199999809265137,0.640163290341633,3713,4895,-1182,1397124
514,man play keyboard,man play keyboard,5.0,1.0,5624,5643,-19,361
515,man play guitar,man play guitar,5.0,0.9999999999999998,5584,5609,-25,625
516,woman peel potato,woman feel potato,5.0,0.5550346601259089,3072,5596,-2524,6370576
517,woman handle frog,man hold frog,3.75,0.5444662476524201,2987,4051,-1064,1132096
518,man play flute,man play guitar,2.0,0.39540143452390986,1977,1876,101,10201
519,man play guitar,man play flute,1.5829999446868896,0.39540143452390986,1972,1456,516,266256
520,man play piano,man play guitar,1.777999997138977,0.4118965147063531,2079,1625,454,206116
521,man play guitar,man play piano,2.0,0.4118965147063531,2080,1869,211,44521
522,man play flute,man play guitar,2.0,0.39540143452390986,1974,1871,103,10609
523,man play flute,man play guitar,2.0,0.39540143452390986,1975,1835,140,19600
524,woman couch,woman hug couch,3.200000047683716,0.6857773007390551,4030,3235,795,632025
525,slide cucumber,man slide cucumber,3.799999952316284,0.9415591312979258,5534,4233,1301,1692601
526,kitten play blue rope toy,kitten play toy,4.400000095367432,0.7859842987023785,4760,5025,-265,70225
527,dog bark toy,dog bark toy,5.0,1.0,5661,5573,88,7744
528,person fold gorilla,man fold gorilla,3.5,0.8677074230696513,5253,3722,1531,2343961
529,cat drink milk,kitten drink milk,4.0,0.7323614397633655,4392,4424,-32,1024
530,person drive car,man drive car,3.5,0.7902851771696229,4800,3721,1079,1164241
531,turtle walk,tortoise walk,4.400000095367432,0.25972484463060774,1226,5054,-3828,14653584
532,cow eat grass,cow eat hay,3.799999952316284,0.6080841580830824,3469,4235,-766,586756
533,woman chop broccoli,woman chop garlic,2.5999999046325684,0.4995370563683494,2653,2488,165,27225
534,man cry,man scream,3.0,0.37952220918378743,1877,2811,-934,872356
535,man play guitar,man play guitar,5.0,0.9999999999999998,5586,5569,17,289
536,man cut onion,man cut planting,3.6670000553131104,0.3927990083398092,1953,3983,-2030,4120900
537,man slide potato,woman peel potato,2.3329999446868896,0.46470513553185483,2401,2170,231,53361
538,woman tap finger table,woman tap finger,4.0,0.8936203089025528,5386,4505,881,776161
539,boil oka pot,cook oka pan,4.400000095367432,0.4276149580132318,2165,5053,-2888,8340544
540,man smoke,man mix,0.2000000029802322,0.17266883122912788,881,407,474,224676
541,man play drum,man play drum,5.0,1.0,5700,5568,132,17424
542,man give pool,man diving pool,5.0,0.6412595522962532,3721,5567,-1846,3407716
543,woman cut leak,woman slide week,4.0,0.15218249299903688,793,4512,-3719,13830961
544,little boy play guitar,boy play guitar,4.599999904632568,0.8388925303686177,5100,5287,-187,34969
545,woman dance,man dance,2.5999999046325684,0.730125145259356,4368,2372,1996,3984016
546,woman talk,man talk,2.5999999046325684,0.658667071393013,3841,2392,1449,2099601
547,girl put hair,woman put hair,2.5999999046325684,0.7191430185948642,4292,2421,1871,3500641
548,kid play guitar,man play guitar,2.200000047683716,0.6600556585753469,3850,2075,1775,3150625
549,group people march place,group people dance concert,1.7000000476837158,0.3389743773122097,1651,1599,52,2704
550,woman shoot machine gun,man shoot gun,2.0,0.7025323418983516,4157,1966,2191,4800481
551,man play piano,man play piano,4.0,1.0,5687,4492,1195,1428025
552,woman slide onion,slide onion,3.25,0.9177265129939542,5476,3371,2105,4431025
553,man slide cucumber,man cut cucumber,4.5,0.7067404625121475,4184,5145,-961,923521
554,girl eat cupcake,woman eat cupcake,2.5999999046325684,0.8588890451804483,5219,2439,2780,7728400
555,woman cut onion,man chop onion,2.0,0.46600938377964934,2414,1905,509,259081
556,man play guitar,baby play guitar,1.7999999523162842,0.7254915984125432,4328,1640,2688,7225344
557,man play guitar,man play drum,1.555999994277954,0.37638370949130484,1859,1454,405,164025
558,little girl talk telephone,girl talk phone,4.5,0.4235101694211738,2148,5128,-2980,8880400
559,man chop log axe,man chop tree trunk axe,4.0,0.6089439660508946,3475,4357,-882,777924
560,person cut capsicum piece,person slide garlic piece,1.600000023841858,0.4002536379920848,2008,1516,492,242064
561,man talk woman,woman walk dog,0.5,0.26177099069534954,1235,600,635,403225
562,man walk,man talk,1.399999976158142,0.31108969600854086,1487,1310,177,31329
563,pour oil skilled,pour milk slender,1.600000023841858,0.2849430628948949,1350,1514,-164,26896
564,small kitten play ball,kitten play ball,4.400000095367432,0.8869862065805312,5350,5032,318,101124
565,man play guitar,woman play flute,1.7999999523162842,0.24651510829677986,1153,1772,-619,383161
566,girl play violin,girl play flute,2.5999999046325684,0.4253168192539132,2155,2416,-261,68121
567,man play piano,cat play piano,1.600000023841858,0.7780159656332896,4710,1531,3179,10106041
568,man exercise,girl exercise,3.0,0.7636995559955492,4623,2959,1664,2768896
569,person slide gallop,person slide octopus,2.0,0.45192593294484484,2315,1941,374,139876
570,man woman ride bicycle,man woman ride motorcycle,2.0,0.5545834362954905,3069,1951,1118,1249924
571,man fight cow pasture,man fight cattle pen,4.0,0.31397466016024295,1504,4348,-2844,8088336
572,woman add oil pan,man pour oil pan,3.0,0.5937498623981978,3363,3066,297,88209
573,girl make bed,young girl make bed,4.400000095367432,0.8895051906542883,5360,5042,318,101124
574,cat play watermelon,cat play watermelon,4.800000190734863,1.0000000000000002,5713,5375,338,114244
575,girl jump car,girl jump car,4.800000190734863,1.0,5695,5372,323,104329
576,man pray,man run,0.7269999980926514,0.22453788455661422,1064,731,333,110889
577,car parking,cat play,0.0,0.0,61,50,11,121
578,man run,man dance,1.25,0.2967170216439927,1410,1245,165,27225
579,man singe,man dance,0.5,0.2297726397694594,1086,613,473,223729
580,man carry man shoulder,man carry shoulder,3.25,0.9633540093928976,5573,3354,2219,4923961
581,woman peel potato,woman slide tomato,1.3329999446868896,0.13424982237825497,716,1262,-546,298116
582,woman cut tomato,woman slide potato,1.0,0.14860252781723216,774,1090,-316,99856
583,peel potato,slide tomato,1.399999976158142,0.0,64,1303,-1239,1535121
584,woman peel potato,woman slide tomato,1.3329999446868896,0.13424982237825497,717,1265,-548,300304
585,root kiss,root kiss,5.0,1.0,5697,5586,111,12321
586,boy couch play video game,boy play video game,4.0,0.8583721785325485,5215,4405,810,656100
587,woman squeeze lemon,woman squeeze juice lemon,4.400000095367432,0.7871450967381469,4775,5104,-329,108241
588,woman slide onion,man slide tomato,1.2000000476837158,0.33074757583574416,1601,1160,441,194481
589,woman slide carrot,man slide tomato,1.2000000476837158,0.31218986167450136,1493,1159,334,111556
590,girl say hair,girl file nail,1.25,0.23147609565207727,1097,1247,-150,22500
591,man walk stair,man walk staircase,5.0,0.3220674430127678,1551,5606,-4055,16443025
592,people ride motorcycle,people ride bike,2.0,0.5488231600758279,3019,1921,1098,1205604
593,man play guitar,woman play electric guitar,2.200000047683716,0.6096740554812146,3480,2025,1455,2117025
594,man play guitar singing,man play guitar,3.200000047683716,0.7335578147789306,4407,3290,1117,1247689
595,man walk rain,man woman walk grand,1.5,0.3773180255653567,1864,1438,426,181476
596,kangaroo eat,kangaroo eat,4.75,1.0,5676,5340,336,112896
597,man fish,man exercise,0.5,0.19317779176833474,959,614,345,119025
598,woman swim,man singe,0.06700000166893,0.0,75,368,-293,85849
599,woman eat,animal eat,1.600000023841858,0.5622977548099317,3118,1547,1571,2468041
600,boy girl dance rain,man woman dance rain,2.5999999046325684,0.7073795510623628,4195,2371,1824,3326976
601,man drive car,man drive car,4.875,1.0,5674,5481,193,37249
602,woman grate onion,woman rate onion,5.0,0.5119914944068009,2745,5603,-2858,8168164
603,poster fight,man fight,2.0,0.5045937130067613,2692,1945,747,558009
604,man ride horse,man drive car,1.399999976158142,0.1567240059681606,804,1296,-492,242064
605,man ride horse,man drive car,1.399999976158142,0.1567240059681606,803,1295,-492,242064
606,man shoot gun,man slide,0.800000011920929,0.1838202874024162,926,881,45,2025
607,woman cut onion,woman cut meat,2.0,0.49176091048648196,2596,1916,680,462400
608,woman slide,man slide bread,1.600000023841858,0.4676801319206921,2435,1541,894,799236
609,boy play piano,man play piano,3.0,0.7985177100862921,4856,2940,1916,3671056
610,baby elephant eat,baby elephant eat sailing,3.615000009536743,0.8158394360891744,4957,3976,981,962361
611,woman crack egg bowl,woman crack egg,4.0,0.8586718093955756,5217,4696,521,271441
612,person play keyboard,boy play key board,4.0,0.1796116703690702,911,4691,-3780,14288400
613,boy thank man sword,boy spark man plastic sword,3.3329999446868896,0.5155269261379828,2764,3400,-636,404496
614,person slide carrot piece,person cut onion piece,1.5,0.4570869524917781,2350,1435,915,837225
615,man slice bunch water bottle knife,man slide line water bottle knife,4.400000095367432,0.5800424433834107,3249,5098,-1849,3418801
616,man write book,man write paper,2.875,0.5431988064540474,2978,2753,225,50625
617,woman slide garlic,woman slide big pepper,2.200000047683716,0.38960419925548645,1937,2096,-159,25281
618,person make bed,person eat table,0.2000000029802322,0.24885029653184199,1164,429,735,540225
619,man play keyboard,man play guitar,1.7999999523162842,0.4033602420384753,2028,1703,325,105625
620,man play violin,man play harp,1.600000023841858,0.31585544168169477,1513,1538,-25,625
621,woman smoke,man walk,0.2000000029802322,0.0,73,433,-360,129600
622,man erase man board,man erase work board,3.0,0.8730911684368949,5293,3063,2230,4972900
623,man ride motorcycle,man ride motorcycle town,3.5,0.7823634419277506,4738,3709,1029,1058841
624,man ride motorcycle highway,man ride motorcycle,3.5,0.7131445580721801,4245,3710,535,286225
625,woman slide meat,woman slide onion,2.0,0.5047790312248237,2694,1958,736,541696
626,woman cut broccoli,woman cut broccoli,5.0,1.0,5645,5594,51,2601
627,man play piano,woman peel potato,0.0,0.0,74,39,35,1225
628,slide tomato,slide fruit,3.200000047683716,0.3184716552091255,1532,3270,-1738,3020644
629,woman dance cage,woman dance,3.25,0.642515323237479,3729,3364,365,133225
630,woman swim,man spit,0.0,0.0,58,38,20,400
631,man run,man move,1.0,0.5916330563091751,3347,976,2371,5621641
632,man play guitar,man play guitar,3.6670000553131104,0.9999999999999998,5583,3980,1603,2569609
633,cat stare camera,cat address camera,3.0,0.5107882946042125,2732,3047,-315,99225
634,baby laugh crawl,baby laugh crawl floor,4.199999809265137,0.8835907733287253,5339,4843,496,246016
635,woman shoot gun,woman shoot shotgun,4.091000080108643,0.45753604151765037,2354,4699,-2345,5499025
636,woman dance rain,woman dance railway station,2.0,0.369089585661655,1804,1810,-6,36
637,woman dance,woman exercise,1.0,0.24017952157916764,1125,977,148,21904
638,kid play instrument,young boy play wind instrument,3.799999952316284,0.4930690372372904,2607,4076,-1469,2157961
639,slice bottle sword,man break bottle sword,4.0,0.6705946289593859,3924,4676,-752,565504
640,woman cut apple,woman cut potato,1.7999999523162842,0.47582516139726866,2491,1701,790,624100
641,man peel apple,man feel apple,5.0,0.5596435082858325,3095,5590,-2495,6225025
642,man play guitar,man play skull,1.0,0.3709323358058904,1813,935,878,770884
643,animal walk ground,solenodon walk ground,3.0,0.5238294808133839,2817,2795,22,484
644,little girl play grand piano stage,little girl play piano,2.5999999046325684,0.7458843536848299,4503,2520,1983,3932289
645,group people dance,group man dance,3.400000095367432,0.7905729962534238,4801,3658,1143,1306449
646,man play guitar,woman play guitar,2.0,0.8250188422281313,5013,1850,3163,10004569
647,cat swing ceiling fan,cat spin ceiling fan,4.199999809265137,0.690725811665716,4072,4858,-786,617796
648,woman play flute,girl play flute,3.799999952316284,0.8057878923903845,4897,4085,812,659344
649,woman dine onion,woman cut onion,4.400000095367432,0.5685213940132238,3173,4988,-1815,3294225
650,monkey brush bull dog,monkey brush dog,4.199999809265137,0.8195161013556755,4982,4804,178,31684
651,woman slide onion,woman cut potato,1.2000000476837158,0.1585579766482436,811,1150,-339,114921
652,man play piano,woman play guitar,1.2000000476837158,0.2560341956592156,1203,1196,7,49
653,woman wash hand,woman straighten hair,0.800000011920929,0.11143377907940383,605,878,-273,74529
654,woman fire shotgun,woman shoot gun,3.200000047683716,0.15281884985711414,794,3268,-2474,6120676
655,man eat bowl cereal,man eat cereal,4.0,0.8691482719946687,5263,4567,696,484416
656,woman bathe bath tub,woman take bath,4.400000095367432,0.6064642953546606,3457,5000,-1543,2380849
657,motorcyclist clash motorcycle,person clash motorcycle,4.199999809265137,0.591564230861386,3346,4797,-1451,2105401
658,man dangle mouse near snake,man feed mice snake,3.200000047683716,0.33338767392740803,1618,3222,-1604,2572816
659,man woman walk wood,man woman walk jungle,3.400000095367432,0.44986811413205896,2303,3561,-1258,1582564
660,person hour rice pudding bowl,lady pour rice pudding bowl,4.0,0.6816213053564345,3999,4524,-525,275625
661,man stare window,man look window,4.800000190734863,0.5516821151236895,3047,5429,-2382,5673924
662,woman fire rifle,woman cut lemon,0.2000000029802322,0.1605186922709483,821,388,433,187489
663,man eat banana,peel banana,1.7999999523162842,0.5711203271618028,3187,1634,1553,2411809
664,man perform stage,comedy time perform stage,2.5999999046325684,0.658793806278589,3844,2448,1396,1948816
665,cartoon woman give pool,cartoon woman dive board,2.799999952316284,0.530830443528812,2871,2615,256,65536
666,lady baby trashcan,woman put baby trash,5.0,0.2394875994385765,1123,5721,-4598,21141604
667,try meat,play pain,0.25,0.0,46,440,-394,155236
668,man rapidly chop mushroom knife,person quickly chop mushroom knife,3.75,0.6635608592820538,3880,4045,-165,27225
669,woman add ingredient bowl,woman crack egg bowl,1.75,0.3618817464939841,1763,1608,155,24025
670,skateboarder trick half pipe,man skateboard half pipe,3.5,0.57949442235227,3246,3738,-492,242064
671,man speak stage,man speak sodium,3.400000095367432,0.507546507692366,2712,3607,-895,801025
672,man play guitar,man hat play harp,1.399999976158142,0.29913345774204697,1423,1379,44,1936
673,man play keyboard,man play guitar,1.399999976158142,0.4033602420384753,2027,1381,646,417316
674,person cut potato,person slide shallow,1.0,0.2244562513218232,1063,954,109,11881
675,man dance ceiling room,man dance upside ceiling,4.599999904632568,0.660550547537873,3856,5222,-1366,1865956
676,man dance,woman shop,0.4000000059604645,0.0,50,489,-439,192721
677,reason egg,reason raw egg bowl,3.5999999046325684,0.6915329697739673,4079,3773,306,93636
678,man swinge rope,gibbon swinge tree,1.25,0.3815937421604483,1893,1249,644,414736
679,man cut potato,woman cut broccoli,1.5,0.29661553760576875,1409,1444,-35,1225
680,woman boil shrimp,woman come hair,1.0,0.12563185085903888,677,939,-262,68644
681,man cut potato,man slide potato,3.75,0.656534535714811,3831,4041,-210,44100
682,man dance road,man dance,3.25,0.7459316616862455,4504,3381,1123,1261129
683,deer jump fence,deer jump cycling fence,4.0,0.819196144204146,4979,4608,371,137641
684,girl dance rain,woman dance rain,3.0,0.8244847596939923,5010,2905,2105,4431025
685,woman write letter,woman sit desk,1.6670000553131104,0.13944577822934714,734,1596,-862,743044
686,gorilla play drum,monkey play drum,3.3329999446868896,0.6203847842183727,3565,3413,152,23104
687,woman ride horse,woman pick potato,0.5,0.16449828614491602,840,602,238,56644
688,boy cut grass curb scissor,boy cut grass scissor,3.75,0.8072484411613039,4905,4028,877,769129
689,man glass talk,man library talk,3.25,0.385790320993067,1914,3390,-1476,2178576
690,woman cut flower,woman cut broccoli,1.0,0.41401496899797285,2093,963,1130,1276900
691,person walk stone path,man walk sidewalk,3.5,0.22363892767111682,1061,3728,-2667,7112889
692,man play keyboard nose,man play piano nose,4.400000095367432,0.6386358024239482,3703,4986,-1283,1646089
693,man play guitar,cat play,0.4000000059604645,0.3354352357956158,1625,484,1141,1301881
694,animal eat,animal hop,0.4000000059604645,0.4413484456037359,2256,492,1764,3111696
695,man lift weight,man lift tarbell,4.199999809265137,0.4839723388702701,2533,4898,-2365,5593225
696,man run bus,man run truck,2.5,0.4549552962603498,2339,2339,0,0
697,man climb rope,man sit rock,0.25,0.1311833397029455,702,450,252,63504
698,cat play piano,cat lick paw,0.25,0.24115529917616407,1130,449,681,463761
699,woman dance rain,woman add oil dish,0.25,0.11177462621886619,608,448,160,25600
700,man run race,face run track,2.5999999046325684,0.2695969778654009,1278,2431,-1153,1329409
701,man cut potato piece,woman cut potato,1.7999999523162842,0.6993302917756301,4125,1767,2358,5560164
702,man play flute,woman apply eye line,0.0,0.0,156,229,-73,5329
703,woman cut potato,woman slide carrot,1.2000000476837158,0.149661543768311,782,1193,-411,168921
704,chicken pack dead mouse,monster neck dead mouse,3.5999999046325684,0.4276506671394814,2167,3798,-1631,2660161
705,woman thinly slide cucumber,woman slide tomato,1.2000000476837158,0.3310498175809405,1604,1192,412,169744
706,person slide bread piece,man slide bread,3.200000047683716,0.7040512156146538,4171,3276,895,801025
707,woman cut square,woman cut big pepper,2.200000047683716,0.3749662105618841,1847,2013,-166,27556
708,woman add oil fish,woman ride horse,0.800000011920929,0.1446218705864698,754,834,-80,6400
709,woman grate carrot,woman coat pork chop,1.600000023841858,0.08615551796006718,470,1554,-1084,1175056
710,clean animal,woman clean shrimp,2.799999952316284,0.4925477505771304,2604,2583,21,441
711,man talk phone,man talk,3.200000047683716,0.6786346672723073,3984,3305,679,461041
712,woman smoke,woman make food,0.800000011920929,0.16848213502624257,861,854,7,49
713,man lay shoot gun,man lay ground shoot rifle,3.799999952316284,0.5445900109031605,2989,4090,-1101,1212201
714,man ambulance,man pour past plate,0.0,0.09921904640904566,525,226,299,89401
715,man dive swimming pool,man singe microphone,0.6669999957084656,0.08317030990186479,458,730,-272,73984
716,man fire shot gun,man shoot shotgun,5.0,0.10026112141477171,527,5719,-5192,26956864
717,man play guitar,man play flute,1.7999999523162842,0.39540143452390986,1976,1739,237,56169
718,man peel potato,man play guitar,0.4000000059604645,0.13349231968293784,710,475,235,55225
719,woman ride horse,man ride horse arena,2.0,0.56195337856329,3112,1778,1334,1779556
720,airplane move runaway,plane land runaway,2.799999952316284,0.4831049265665537,2529,2603,-74,5476
721,woman slip water tub,woman lie raft,0.800000011920929,0.09840447083315904,521,848,-327,106929
722,man mow lawn,man mix,0.800000011920929,0.11658878419552351,630,847,-217,47089
723,woman peel potato,woman hit man,0.75,0.17938642170049687,909,745,164,26896
724,man play piano,man lay ground,0.75,0.1329345947179033,706,746,-40,1600
725,woman ballet,woman ride horse,1.0,0.1664455992153036,849,922,-73,5329
726,woman cut onion,woman row boat,0.800000011920929,0.14474936785080184,755,845,-90,8100
727,woman stir rice pot,put rice pan,2.7690000534057617,0.4222105779889272,2138,2573,-435,189225
728,woman put slab meat pan,man put piece meat plastic bag,2.400000095367432,0.23363549544129095,1102,2305,-1203,1447209
729,boy play trumpet,boy play trumpet,4.400000095367432,1.0,5649,4977,672,451584
730,person ride horse,man ride motorcycle,1.7999999523162842,0.33007363635005954,1594,1726,-132,17424
731,woman slide onion,woman cut carrot,1.399999976158142,0.15065875670538542,787,1406,-619,383161
732,man slide vegetable,woman slide potato,2.25,0.3300886974715915,1595,2146,-551,303601
733,cat play,woman play flute,0.25,0.2983586282304273,1418,439,979,958441
734,man ride bicycle,man ride bicycle parking lot,3.25,0.6444344158487154,3744,3393,351,123201
735,band perform stage,band play singe stage,4.5,0.624986860252051,3592,5142,-1550,2402500
736,woman slide fish cake,woman ride horse,0.800000011920929,0.13076265767734344,700,867,-167,27889
737,man eat bread,man play flute,0.800000011920929,0.12243408894120611,663,877,-214,45796
738,woman cook shrimp,woman dance,0.800000011920929,0.18220405916220106,921,870,51,2601
739,woman dance,woman slide ginger,0.25,0.18131432144069334,916,441,475,225625
740,woman losse cat air cat hang rod ceiling,person throw cat air grab ceiling,3.5,0.4228545990470219,2145,3698,-1553,2411809
741,big turtle walk,tortoise walk,4.25,0.22150182171083238,1050,4920,-3870,14976900
742,man burn flag,man shoot gun,0.5,0.1099143717632796,598,605,-7,49
743,man push van,woman singe,0.0,0.0,257,223,34,1156
744,man eat wood,man add oil car,0.5,0.11142491362824819,604,607,-3,9
745,dog speak camera,dog eat water melon,0.6000000238418579,0.12928849103519185,694,648,46,2116
746,man put paper towel paper plate,man put paper dish,2.200000047683716,0.510994956666408,2733,2018,715,511225
747,man woman walk,man woman walk hold,3.200000047683716,0.8160037981465744,4960,3080,1880,3534400
748,man cut rope sword,man lead thick rope sword,4.400000095367432,0.7750065217148422,4686,4992,-306,93636
749,man singe play guitar,man play guitar,3.0,0.7885309020416359,4787,2826,1961,3845521
750,man cut paper,person tear paper,2.5829999446868896,0.4446907768479519,2281,2367,-86,7396
751,man dance,rat run,0.0,0.0,261,221,40,1600
752,boy talk phone,woman talk telephone,1.7999999523162842,0.26201048502948016,1238,1730,-492,242064
753,man play guitar,woman peel tube,0.0,0.0,269,220,49,2401
754,woman slide onion,woman slide lemon,1.399999976158142,0.46526212411626483,2407,1420,987,974169
755,woman ride horse,man run rope,0.0,0.0,263,234,29,841
756,man play soccer,man draw figure,0.4000000059604645,0.12269164884031561,667,508,159,25281
757,woman peel orange,man play flute,0.0,0.0,264,219,45,2025
758,crack egg open,man break egg,3.0,0.4108063557711445,2072,2832,-760,577600
759,man cut snake cook,woman cut meat,2.0,0.24115474799995704,1129,1867,-738,544644
760,woman scrape carrot,man strike clay pot,0.0,0.0,266,217,49,2401
761,man woman bollywood dancing,man woman dance rain,1.6670000553131104,0.18435084835228582,928,1598,-670,448900
762,woman cut flower,man hold huge sunflower,1.0,0.0,267,1063,-796,633616
763,man dance dinner,bomb explode desert,0.0,0.0,268,216,52,2704
764,american flag wave,american flag blow wind,4.199999809265137,0.5485332651733726,3015,4887,-1872,3504384
765,lion walk enclosed area,lion walk,2.5999999046325684,0.649522971104517,3779,2500,1279,1635841
766,woman slide lemon,man show bread,0.25,0.0,252,452,-200,40000
767,woman play flute,woman slide tune,0.4000000059604645,0.1352030527776438,722,503,219,47961
768,dog bark toy,dog bark electronic toy duck,3.5,0.7058526412443935,4178,3725,453,205209
769,woman add egg stirring,woman mix egg bowl,3.5,0.36314464281879705,1769,3704,-1935,3744225
770,woman cover piece meat flour,woman reason piece meat,3.0,0.5430010759718229,2976,2838,138,19044
771,white cat perch small wooden cabinet look outside window,cat perch table look window,3.400000095367432,0.6284492463202304,3616,3429,187,34969
772,man floor exercise,man exercise,3.5999999046325684,0.78705780900252,4772,3791,981,962361
773,man slide potato,man peel banana,1.0,0.1114920277028147,606,1092,-486,236196
774,play piano,person play keyboard piano,3.5999999046325684,0.6866536946821931,4037,3827,210,44100
775,woman put man,woman paint face man,2.799999952316284,0.4670283236026934,2428,2613,-185,34225
776,woman drop eggplant pan,woman put chop eggplant skilled,4.0,0.4597753943627853,2366,4603,-2237,5004169
777,man play trumpet,man play musical instrument,3.400000095367432,0.24864578582425054,1162,3466,-2304,5308416
778,woman slide lemon,woman kitchen feel lemon,2.6670000553131104,0.5510527532760306,3040,2528,512,262144
779,tiger try climb wall,lion try climb wall,3.0,0.6893462802848109,4063,2842,1221,1490841
780,man prepare hang rope,man tie noose,4.666999816894531,0.07604147670837974,440,5315,-4875,23765625
781,woman dance stage,woman dance,3.200000047683716,0.736216995846511,4424,3088,1336,1784896
782,girl ride horse,girl spray plant water,0.2000000029802322,0.20605583508403058,1008,393,615,378225
783,person try,person peel potato,1.2000000476837158,0.29499657901645726,1401,1185,216,46656
784,man shoot pistol,woman chop garlic,0.800000011920929,0.0,234,853,-619,383161
785,woman swinge arm,woman slide onion,0.800000011920929,0.14828702410445976,772,851,-79,6241
786,man walk outside,man dance,0.75,0.19577685846835766,969,736,233,54289
787,man dry hand,woman fix hair,0.25,0.0,235,437,-202,40804
788,soccer player kick soccer ball goal long way field,soccer player kick ball goal,3.25,0.8367292474083708,5086,3398,1688,2849344
789,girl play piano,little girl play grand piano stage,3.3329999446868896,0.6347310036992908,3670,3407,263,69169
790,man draw figure,man draw digital dry ease board,3.3329999446868896,0.3434267029185637,1678,3409,-1731,2996361
791,monkey hang tree,monkey swing branch branch,2.0,0.21649173291065457,1033,1834,-801,641601
792,child jump trampoline,boy play trampling,3.0,0.0,237,2908,-2671,7134241
793,woman knife slide pepper,woman slide green pepper,4.0,0.7075750087502818,4196,4551,-355,126025
794,man add oil car,man put anti freeze car,2.0,0.3333787669311006,1617,1837,-220,48400
795,man slide carrot machine,man climb rope,0.4000000059604645,0.09319344363476545,500,496,4,16
796,boy play keyboard,person play piano keyboard,3.200000047683716,0.6104042295467569,3493,3184,309,95481
797,cat play antenna,boy play mud,0.4000000059604645,0.1735849742518359,884,493,391,152881
798,woman slide pushkin,person slide cantaloupe,2.0,0.2289642639987858,1083,1836,-753,567009
799,people throw dummy cliff edge,people throw dummy cliff,4.5,0.8947841323183221,5392,5137,255,65025
800,gun fire,potato peel,0.5,0.0,239,611,-372,138384
801,woman cut plastic sheet,woman play guitar street,0.5,0.1043459435528653,550,603,-53,2809
802,woman cut pineapple,woman slide pineapple piece,4.0,0.6404729923945938,3715,4682,-967,935089
803,woman add space meat,woman add ingredient beef,3.75,0.32652332116908267,1572,4056,-2484,6170256
804,person add oil pan,cook pour oil pan,4.25,0.5029260166468167,2678,4926,-2248,5053504
805,cook season dough,man reason dough pan,3.75,0.36015273600668307,1754,4000,-2246,5044516
806,boy run beach,boy play beach,2.75,0.743318432138492,4484,2572,1912,3655744
807,baby monkey scratch,monkey scratch mummy,3.25,0.6871368580720638,4041,3339,702,492804
808,boy ride bike gate,woman ride horse,0.800000011920929,0.25978658249004505,1228,880,348,121104
809,man card trick,man squeeze water,0.25,0.10872940782488613,581,454,127,16129
810,man play piano,play guitar,0.75,0.2841578930824607,1348,732,616,379456
811,man mow grass,guy mow lawn,4.800000190734863,0.4737350699694381,2473,5421,-2948,8690704
812,person mix water flour,person hitchhike road,0.800000011920929,0.15377338925724152,797,879,-82,6724
813,dog pen,cowboy ride horse desert,0.0,0.0,245,210,35,1225
814,man ride wheel motorcycle,person perform trick motorcycle,3.0,0.2747876306534522,1305,2765,-1460,2131600
815,cat open drawer limb inside,big cat open plastic drawer paw hope inside,3.75,0.6167992085797176,3544,3992,-448,200704
816,man open box knife,man play guitar,0.0,0.120575150291341,650,209,441,194481
817,man kick boot water,woman slide red pepper,0.25,0.0,246,453,-207,42849
818,man eat,woman rock climbing,0.0,0.0,247,208,39,1521
819,puppy repeatedly roll,dog roll,3.5,0.5286104853268081,2848,3708,-860,739600
820,young boy sing play guitar,kid play guitar,3.25,0.4285826254184023,2171,3334,-1163,1352569
821,woman peel lemon,man balance wire,0.4000000059604645,0.0,248,461,-213,45369
822,man play trumpet,play tell,0.800000011920929,0.27353189039458653,1300,875,425,180625
823,dog look,dog watch store counter,1.600000023841858,0.1774956187551318,901,1463,-562,315844
824,woman slide onion,man show slide carrot knife,1.2000000476837158,0.27532488606745287,1308,1180,128,16384
825,man drill hole wood,man drill wood,4.199999809265137,0.8127225517847414,4942,4838,104,10816
826,cut circle pink sheet paper,pour tomato sauce pot meat,0.2000000029802322,0.0,260,426,-166,27556
827,man play flute,man pet tie dog,0.2000000029802322,0.10900111988126139,584,431,153,23409
828,man place meat bag,man drive car,0.5,0.10665539652577134,566,595,-29,841
829,girl eat cupcake,man play trumpet,0.0,0.0,271,207,64,4096
830,rabbit sniff paw stuff rabbit,live rabbit play stuff animal funny,4.5,0.5229315877404042,2811,5132,-2321,5387041
831,man mutter bread,woman ride horse,0.0,0.0,299,205,94,8836
832,woman squeeze cucumber slice,woman getting rouse green slime,0.75,0.0593607143482182,416,741,-325,105625
833,man take inside green pepper,remove seed bell pepper,4.0,0.2643359744483034,1254,4523,-3269,10686361
834,man take piece pepperoni penza penza box put lid close box,man take piece pepperoni penza box,2.75,0.8688671194091858,5260,2562,2698,7279204
835,man add vegetable pot,man add slice vegetable cooking bowl water,3.400000095367432,0.48659139552631714,2549,3616,-1067,1138489
836,man run jump wall,man jump wall,3.400000095367432,0.8926969514753726,5383,3622,1761,3101121
837,man reason sausage,man add reasoning water bowl,2.400000095367432,0.07104052967865004,430,2234,-1804,3254416
838,clown singe people dance,clown singe,3.0,0.8164862395507293,4963,2808,2155,4644025
839,woman feed aardvark,woman chop garlic,0.4000000059604645,0.10464445143864787,553,470,83,6889
840,person rinse speak water,man rinse large speak,3.928999900817871,0.7155202271492855,4260,4340,-80,6400
841,boy ride bike metal fence,bmx baker ride fence,3.0,0.3524093409297141,1723,2812,-1089,1185921
842,man throw knife tree,man show magic,1.75,0.09844857737187405,522,1605,-1083,1172889
843,girl walk stage,woman model walk catwalk,2.5999999046325684,0.20158529144122653,991,2499,-1508,2274064
844,woman weight exercise,woman exercise tarbell,3.5,0.5045518348138692,2688,3742,-1054,1110916
845,man peel potato,man hide,0.5,0.13037739060599202,697,598,99,9801
846,large bird stand table pick plastic glass contain liquid place bowl,bird pick plastic cup contain liquid beak put cup bowl,3.5,0.5044998859858114,2687,3733,-1046,1094116
847,woman rain,car drive road,0.0,0.0,293,218,75,5625
848,woman hit man,man hold slow boris,0.0,0.12664754362142316,686,236,450,202500
849,woman ride elephant,man lift,0.0,0.0,294,252,42,1764
850,man lift weight,woman exercise,1.0,0.0,295,1039,-744,553536
851,person ride jet wave,woman ride seldom,2.0,0.1992816783129441,983,1805,-822,675684
852,woman wear headphone,woman chop leave,0.6000000238418579,0.12890136054773993,693,618,75,5625
853,kitten eat food plate,kitten eat food,4.0,0.841699728587354,5112,4364,748,559504
854,woman read lifestyle magazine,woman slide meat piece,0.5,0.08302282107735778,455,599,-144,20736
855,man pour child bowl,man open hour content bowl,2.5,0.3276449323916682,1580,2359,-779,606841
856,bird eat food tree bowl,bird eat bowl,3.25,0.7640965149338157,4625,3358,1267,1605289
857,group girl exist taxi,video clip hanna leave taxi,2.0,0.32631006008972324,1571,1801,-230,52900
858,woman reason piece meat,man load rifle bullet,0.0,0.0,296,267,29,841
859,man chop commander leaf,man play guitar,0.800000011920929,0.10113036528940474,536,783,-247,61009
860,man take slice penza,man talk cell phone,0.800000011920929,0.09421250090666222,503,784,-281,78961
861,man place meat inside plastic bag,woman carry allay bag,0.4000000059604645,0.25531050168401975,1199,569,630,396900
862,rabbi talk,man walk rope,0.0,0.0,297,266,31,961
863,man ride horse,woman rub baby leg,0.0,0.0,298,265,33,1089
864,man play guitar,lay,0.0,0.0,300,264,36,1296
865,man slide,man break pot,0.4000000059604645,0.178402751123731,907,516,391,152881
866,man drive car,woman lip shrimp matter,0.0,0.0,308,263,45,2025
867,dog paw fly carpet,dog play bug carpet,3.5999999046325684,0.46628850272703526,2418,3811,-1393,1940449
868,dog bark,jet fly,0.231000006198883,0.0,301,436,-135,18225
869,monkey walk bed,man ride horse,0.0,0.0,302,262,40,1600
870,woman cook broccoli,man eat food,0.5,0.0,303,597,-294,86436
871,man try gorilla,person perform card trick,0.0,0.0,304,261,43,1849
872,woman serve volleyball net,woman hand volleyball woman serve,2.75,0.7400939264584131,4456,2556,1900,3610000
873,man slide cucumber knife,man cook gorilla skilled,0.75,0.06914042570662543,429,735,-306,93636
874,man play electronic keyboard,band play instrument,1.25,0.14206923966560434,747,1252,-505,255025
875,man play violin,baby laugh crawl,0.0,0.0,305,259,46,2116
876,man severe toe leather boot sword,man cut boot sword,3.75,0.5742524222940333,3207,3993,-786,617796
877,person remove scale fish,person deal fish,5.0,0.4931308403396657,2608,5713,-3105,9641025
878,people walk garden,boy talk man,0.0,0.0,306,258,48,2304
879,young child ride horse,little girl ride horse,3.200000047683716,0.5014953699902481,2667,3151,-484,234256
880,person cut garlic piece knife,put ingredient work,0.75,0.0,307,740,-433,187489
881,man fold piece paper,man slide plastic container sword,0.5,0.06361460980128188,419,606,-187,34969
882,man push water,man push man ocean,2.5,0.6361776651204851,3681,2345,1336,1784896
883,boy upset play video game,play pageboy,1.75,0.13733887048341173,729,1620,-891,793881
884,man make cell phone,man make phone,4.0,0.8081305409971238,4912,4413,499,249001
885,man speak phone,bear chew stick,0.0,0.0,291,255,36,1296
886,woman apply cosmetic face,woman put,4.599999904632568,0.28563369406534295,1354,5181,-3827,14645929
887,man lift barrel,man lift weight,4.0,0.4839723388702701,2534,4439,-1905,3629025
888,woman need animal hand,woman feed animal,3.0,0.47487301445905583,2484,3019,-535,286225
889,ferret climb cage,secret climb shelf,2.200000047683716,0.2640977278455621,1252,2030,-778,605284
890,young woman play flute,woman wash freeze,0.0,0.11496688769426362,621,251,370,136900
891,woman shoot shotgun,woman shoot rifle,2.799999952316284,0.42911523730379064,2177,2648,-471,221841
892,person add child powder child bean,man add reasoning bean,3.799999952316284,0.463684118705492,2393,4326,-1933,3736489
893,woman rapidly fire handful,woman shoot gun,4.400000095367432,0.11493638638378652,620,5100,-4480,20070400
894,person slide onion,solenodon walk ground,0.0,0.0,273,249,24,576
895,dog open fridge,dog close refrigerator door,1.75,0.10690552614989857,568,1624,-1056,1115136
896,woman hold dancing baby,woman abuse child,1.0,0.12355059895282387,669,1002,-333,110889
897,woman joke man,girl apply face man,1.7999999523162842,0.11373377018125817,615,1672,-1057,1117249
898,lady add cheese sauce,man hour plate shrouded cheese pot sauce,1.600000023841858,0.4623892773372643,2387,1508,879,772641
899,man give lecture sodium,man deliver lecture event celebrate game cricket,2.3329999446868896,0.3510901937232389,1718,2168,-450,202500
900,cat shimmy bed,cat crawl upside couch,2.0,0.16448090921315855,839,1955,-1116,1245456
901,woman chop garlic,woman slice fish,1.0,0.12568658358200427,678,1006,-328,107584
902,man cut grass,masked man sing,0.0,0.10945127678393654,592,247,345,119025
903,man cut grass,clown singe,0.0,0.0,274,246,28,784
904,boy run away fishing line,boy run fish hang fishing rod,3.0,0.46901078875761293,2440,3061,-621,385641
905,man play office,man reason vegetable,0.4000000059604645,0.1263092706783408,681,589,92,8464
906,man carry man,man take picture ant,0.4000000059604645,0.2161412633038573,1032,568,464,215296
907,seat drop pan,woman put meat pan,3.25,0.381540540523549,1891,3366,-1475,2175625
908,woman cut stallion,woman fall sand castle,0.0,0.09444102458712121,504,243,261,68121
909,man slam dun ball,woman slide onion,0.0,0.0,277,242,35,1225
910,machine sharpen pencil,girl ride bicycle,0.0,0.0,278,241,37,1369
911,woman brush foot,sun rise tree,0.0,0.0,279,240,39,1521
912,man clean window,man drive car,0.4000000059604645,0.12129054779746208,652,566,86,7396
913,person stir rice,woman crack egg,1.0,0.0,280,1015,-735,540225
914,man put knife vice,man dance,0.25,0.16795286251078773,856,438,418,174724
915,boy play violin stage,boy stage play violin,4.25,1.0000000000000002,5711,4928,783,613089
916,woman cut pink loaf knife,man play guitar,0.1180000007152557,0.0,282,369,-87,7569
917,man add pork crop pan,woman peel potato,1.0,0.0,283,1019,-736,541696
918,man fight,man draw white paper,0.4000000059604645,0.14120658421603055,741,538,203,41209
919,man catch ball,cat rub baby,0.0,0.0,284,239,45,2025
920,girl read newspaper,chef peel potato,0.0,0.0,285,238,47,2209
921,slow boris bite person finger,small animal chew finger,2.5,0.2680223195881893,1273,2330,-1057,1117249
922,man walk path wilderness,man peel onion,0.75,0.0868195360145637,472,733,-261,68121
923,man play guitar,guy singe play guitar,3.0,0.5624843062423526,3120,3008,112,12544
924,man state road,boy state boarding,2.5999999046325684,0.23775360793458997,1115,2427,-1312,1721344
925,man hour liquid pan,chef pour oil pan,2.5999999046325684,0.2525631960515355,1186,2430,-1244,1547536
926,boy play piano singing,pig agitate lion,0.0,0.0,287,203,84,7056
927,cat ferret play,ferret kitten play,4.25,0.6861563064815054,4033,4942,-909,826281
928,monkey walk water,guy play trumpet,0.0,0.0,233,202,31,961
929,woman put,band singe,0.0,0.0,232,201,31,961
930,dog drive car,guy talk microphone,0.0,0.0,231,184,47,2209
931,man sing stage microphone,man suit stand microphone singing,3.5,0.3608470204977997,1758,3737,-1979,3916441
932,car back space,car take reverse,2.400000095367432,0.31728610439139526,1524,2301,-777,603729
933,man hold frog,man empty plastic container,0.6000000238418579,0.10069144587671702,532,638,-106,11236
934,man travel boat,woman cut carrot knife,0.0,0.0,177,164,13,169
935,man ride motorcycle highway,person drive motorcycle road,3.75,0.2793747234331452,1325,4037,-2712,7354944
936,man dine onion,man play guitar,0.4000000059604645,0.12664295461503425,685,535,150,22500
937,man perform stage,man gun fish,0.4000000059604645,0.1113593286969497,603,533,70,4900
938,woman sit,woman sit close talk,2.5999999046325684,0.6532369099187307,3803,2438,1365,1863225
939,man remove couple master scramble plastic packet,man remove food bag,1.75,0.2640381579367086,1251,1602,-351,123201
940,woman dance fire,man tie noose,0.0,0.0,181,163,18,324
941,man meditate,man ride horse,0.75,0.1479986534427077,770,738,32,1024
942,boy cut paper,man load rifle,0.0,0.0,182,162,20,400
943,man talk telephone,girl walk stage,0.0,0.0,183,161,22,484
944,man play guitar singing,man open package contain headphone,0.800000011920929,0.06570457765342336,421,827,-406,164836
945,soccer player kick ball leg,person kick soccer ball forth foot,3.400000095367432,0.4924393652542256,2601,3497,-896,802816
946,animal walk,woman apply eye,0.0,0.0,184,160,24,576
947,scratch animal belly,woman stroke femur,2.0,0.0,185,1903,-1718,2951524
948,man lift heavy weight,allay lick woman hand,0.25,0.0,186,451,-265,70225
949,boy play toy,boy play handed game,3.0,0.3622423751013715,1764,2962,-1198,1435204
950,man give cliff,man ride motorcycle,0.6669999957084656,0.16420990248416917,836,728,108,11664
951,man come water,man rise swamp,3.200000047683716,0.13589151833177548,723,3207,-2484,6170256
952,man woman dance,man pet dog,0.3330000042915344,0.1701215478125514,870,457,413,170569
953,man sweep floor house long broom,man sweep living room,3.3329999446868896,0.34342859428685535,1679,3414,-1735,3010225
954,group couple dance,man woman dance slowly,3.3329999446868896,0.2833861989904329,1344,3418,-2074,4301476
955,man seal fish,man hour cook oil pot,1.0,0.07804056812791396,446,1060,-614,376996
956,man set camera sunset picture beach,man take picture lake,2.200000047683716,0.360696918860627,1756,2136,-380,144400
957,hold pet baby tiger,rinse large beef speak kitchen sink,0.4000000059604645,0.0,189,530,-341,116281
958,man play guitar,cat clean face paw,0.0,0.0,190,158,32,1024
959,man push wall,man base food,0.25,0.1224661441649848,664,445,219,47961
960,woman cut vegetable,woman slide egg plant,2.25,0.11914134662640728,642,2163,-1521,2313441
961,person break egg small bowl,man crack egg,2.5999999046325684,0.3273991058620336,1578,2412,-834,695556
962,man play keyboard,man ride mechanical bull,1.2000000476837158,0.09451298632460114,505,1173,-668,446224
963,dog run yard,black pet dog run garden house,3.200000047683716,0.264447430925144,1256,3181,-1925,3705625
964,child walk street deep pull,woman walk road man morcar pull,1.399999976158142,0.343315530959284,1676,1417,259,67081
965,man add oil pot,dog catch fish river,0.2000000029802322,0.0,191,382,-191,36481
966,girl dance bonfire,woman dance music stand near bonfire,2.75,0.6260179285988889,3603,2536,1067,1138489
967,man chop butter container,woman cut shrimp,0.6000000238418579,0.0,172,644,-472,222784
968,girl drag downhill dog,dog pull child hill,3.799999952316284,0.10167065716947493,540,4310,-3770,14212900
969,man take sunglass talk,man wear hard hat remove glass speak,3.400000095367432,0.0649026306694164,420,3515,-3095,9579025
970,man funny skin boxer crowd people,boy dance people,1.5,0.14349436854797742,752,1439,-687,471969
971,girl tide bed,woman make bed,2.5,0.3764774091650002,1860,2347,-487,237169
972,cook onion,man swinge nunchuck,0.0,0.0,158,153,5,25
973,man sledghammer break concrete block man,man break slab concrete lie prone man sledge hammer,5.0,0.39238971759129215,1950,5707,-3757,14115049
974,lady dry nodule hot water cook,woman place container nodule pan water,4.333000183105469,0.31980830160806845,1538,4953,-3415,11662225
975,girl dance stage,girl put,0.3330000042915344,0.48565308394225915,2542,456,2086,4351396
976,bear lay,baby relax log,3.3329999446868896,0.0,160,3405,-3245,10530025
977,kiss play swimming pool green color crocodile float,kiss push inflammable crocodile pool,4.199999809265137,0.48935882507821654,2580,4785,-2205,4862025
978,couple policewoman singe karaoke,woman dance,0.800000011920929,0.0,162,809,-647,418609
979,man put broccoli water,person peel potato,1.0,0.0,163,1075,-912,831744
980,doctor help patient,doctor try revive man,2.799999952316284,0.29181158388426076,1379,2576,-1197,1432809
981,grate onion water,person rate potato bowl,1.5,0.0,164,1427,-1263,1595169
982,baby talk,boy try firetruck,1.2000000476837158,0.0,165,1178,-1013,1026169
983,woman boil egg,woman place egg pot water,3.0,0.41476887713858246,2099,2998,-899,808201
984,woman put ingredient whiskey egg,man hour gasoline,0.0,0.0,166,152,14,196
985,woman slide mange,man put cheese gorilla,0.6000000238418579,0.0,167,658,-491,241081
986,girl slide butter piece,woman slide,1.0,0.3745780190631628,1844,1080,764,583696
987,man play guitar,person slide meat piece,0.0,0.0,169,151,18,324
988,man open package contain headphone,woman ride horse,0.0,0.0,170,150,20,400
989,girl play guitar,boy play key board people,1.0,0.17975443947679232,912,1082,-170,28900
990,little girl play violin beach,girl sit couch rocket,0.0,0.14407733079753415,753,149,604,364816
991,monkey rate kicking gloved hand,monkey practice martial art,3.5,0.1767659254740733,899,3688,-2789,7778521
992,female apply hair hand,cat eat slice watermelon,0.0,0.0,171,148,23,529
993,man rate kicking man wear protective boxing glove,man kick box trainer,2.5,0.08615770690157681,471,2340,-1869,3493161
994,man play wooden flute,little boy vacuum floor,0.0,0.0,173,147,26,676
995,young woman play guitar,woman cut meat,0.75,0.14854436332242116,773,739,34,1156
996,man play soccer,man ride motorcycle,0.0,0.14864353541230532,775,146,629,395641
997,woman run beach,dog swim pool,0.0,0.0,192,145,47,2209
998,man strain past,man play wooden flute,0.0,0.08492007480620936,465,144,321,103041
999,play swing,man play guitar,0.800000011920929,0.2742078473026017,1302,806,496,246016
1000,green white train sit track,green white train track,4.400000095367432,0.914011852219951,5458,5006,452,204304
1001,small white cat glow eye stand underneath chair,white cat stand floor,2.5999999046325684,0.36317812698475244,1770,2390,-620,384400
1002,large boat water marina,large boat sea,3.200000047683716,0.4765007166715878,2495,3110,-615,378225
1003,bus drive street,red double hecker bus drive street,4.0,0.6881746792146886,4051,4529,-478,228484
1004,passenger train wait station,passenger train sit station,4.800000190734863,0.7554241903229288,4562,5464,-902,813604
1005,woman dinner table write notebook,woman table busy,3.400000095367432,0.2917264891014437,1378,3663,-2285,5221225
1006,apple computer sit floor,farintosh computer sit floor,3.799999952316284,0.6315081608750504,3649,4250,-601,361201
1007,close brown horse head,view horse head,3.400000095367432,0.5523121102577324,3052,3573,-521,271441
1008,group people eat table outside,group elderly people sit table,2.799999952316284,0.5229905034021683,2812,2574,238,56644
1009,jockey ride horse,jockey ride horse pen,3.799999952316284,0.8206186677992172,4991,4263,728,529984
1010,man ride motorcycle road,man ride red motorcycle road,4.0,0.9088304816188638,5439,4592,847,717409
1011,woman ride brown horse,young girl ride brown horse,3.799999952316284,0.7332986405320876,4405,4320,85,7225
1012,kid jump ledge bike,black white cat play blanket,0.0,0.0,194,140,54,2916
1013,black dog stand yellow flower,black dog stand field,3.0,0.5077031293518075,2715,3051,-336,112896
1014,close bottle water,close view bottle water,4.400000095367432,0.8201002373819906,4989,4969,20,400
1015,close brown face cat,close ostrich face,0.6000000238418579,0.444575579816478,2280,656,1624,2637376
1016,sheep stand afield,sheep grazing field,3.200000047683716,0.27832546369773836,1321,3097,-1776,3154176
1017,long haired cat eye close,close cat eye close,3.5999999046325684,0.6821735707360963,4005,3897,108,11664
1018,woman gray shirt smile camera woman make face,woman surprised look face hold smile woman,2.5999999046325684,0.4597074265106579,2365,2411,-46,2116
1019,silver blue amtrak train track near small train station,small white car mark gas station,0.6000000238418579,0.23521552465955456,1106,633,473,223729
1020,person blue shirt decline near coffee table television,person stand motorcycle seat pip wheel,0.0,0.08437271566826413,463,139,324,104976
1021,black white photo woman show horse,black white photo cow stall,1.399999976158142,0.5189406727775441,2787,1401,1386,1920996
1022,dark brown horse stand field,brown horse stand lush green field,4.199999809265137,0.5686472596377735,3175,4715,-1540,2371600
1023,pitch tent horse background,black white lamb lamb background,0.0,0.163092280197528,831,137,694,481636
1024,group people sit table food,group people sit table food beer,4.0,0.8272982982752534,5028,4591,437,190969
1025,brown horse stand lush green field,brown horse green field,3.799999952316284,0.7318469757063089,4388,4306,82,6724
1026,black white cow hay,black white cow pen hay,4.0,0.8448407933448532,5134,4585,549,301401
1027,elderly woman stand kitchen cat foot,old lady stand kitchen cat foot,5.0,0.6831459206146266,4011,5705,-1694,2869636
1028,school bus drive uphill rural road,race care drive dirt road,1.0,0.30295804270946314,1438,920,518,268324
1029,camouflage airplane sit grassy field,camouflaged plane sit green grass,4.400000095367432,0.10635526776573685,564,4997,-4433,19651489
1030,young woman stand room,indian woman indian girl near water,0.4000000059604645,0.08962308665974611,483,556,-73,5329
1031,red double hecker bus drive street,double hecker passenger bus drive traffic,4.0,0.6921194180688777,4084,4625,-541,292681
1032,white sheep hillside look camera,skinny cow stand grass,1.2000000476837158,0.0,222,1172,-950,902500
1033,group sheep field,group horse graze field,1.600000023841858,0.4924629283867546,2603,1539,1064,1132096
1034,close distorted photo glass joke bottle,close picture desk computer paper,0.0,0.10230523472361575,543,198,345,119025
1035,crowded office desk computer monitor,computer desk monitor,3.0,0.7569679356666668,4573,3027,1546,2390116
1036,man sit fluttered room,man lie bed fluttered room,3.200000047683716,0.7002923947330641,4133,3104,1029,1058841
1037,white cow green pasture,horse pasture,1.399999976158142,0.5253179413011682,2826,1297,1529,2337841
1038,black cow walk tree pasture,walk tree pasture,3.799999952316284,0.8287726718167358,5041,4265,776,602176
1039,people sit table restaurant,people sit table,1.7999999523162842,0.7719734538469282,4664,1718,2946,8678916
1040,smile woman beer sit outside smile woman,woman sit outside laugh,3.200000047683716,0.41265900311502873,2086,3099,-1013,1026169
1041,bird hold metal gate,multi colored bird cling wire fence,3.200000047683716,0.14677425875089734,767,3089,-2322,5391684
1042,skinny cow stand grass,white duck stand ground,0.6000000238418579,0.14138369531190761,744,630,114,12996
1043,woman lay man sit sofa,man woman smile camera sit blue sofa,2.200000047683716,0.5861210506924714,3293,2031,1262,1592644
1044,woman big necklace,young woman black necklace,3.400000095367432,0.6849254981577056,4023,3581,442,195364
1045,grown cow horn stand field,grown horse stand middle grassy field,1.7999999523162842,0.48840115160898634,2572,1720,852,725904
1046,cruise line lock shoreline,cruise ship lock shore,4.400000095367432,0.5010573810148558,2664,4983,-2319,5377761
1047,black white cat lie bush,black white cat yellow eye lounge dirt,2.400000095367432,0.3152947587900545,1511,2249,-738,544644
1048,grown white cow stand grass road,brown white cow stand grassy area tree,3.5999999046325684,0.36772837460470226,1796,3937,-2141,4583881
1049,small dog look camera stand grass,man woman smile camera stand kitchen,0.800000011920929,0.328158085388135,1582,824,758,574564
1050,calf yellow tag left ear look camera,man glass plastic bottle foreground,0.6000000238418579,0.0,226,626,-400,160000
1051,black white photo couch purse end,black white photo cow tree,0.0,0.4463939861600379,2290,195,2095,4389025
1052,man boat float water,large green boat float,2.400000095367432,0.6427432168639999,3731,2255,1476,2178576
1053,rear view chevrolet sport car,rear view red chevrolet concept car,3.5999999046325684,0.7279469046210718,4344,3946,398,158404
1054,person wear helmet ride bike near white structure,person wear bike helmet ride bike path tree,3.200000047683716,0.6303795213691045,3634,3100,534,285156
1055,black white photo old train station,black white photo motorcycle lay ground,0.2000000029802322,0.4328302579586667,2203,412,1791,3207681
1056,grey white cabby cat sleep purple fabric,black white cat sleep brown trap,2.400000095367432,0.3607136052490837,1757,2237,-480,230400
1057,woman hold small baby,smile woman hold small baby,4.0,0.8456657072937271,5137,4527,610,372100
1058,group horse graze grassy field,group horse graze field,4.599999904632568,0.8752449883887882,5305,5193,112,12544
1059,man sit table drink,man sit table beer food,3.400000095367432,0.4692445914566874,2442,3630,-1188,1411344
1060,people dress white standing grass field,person stand underneath overcast near highway,0.4000000059604645,0.0,228,550,-322,103684
1061,orange cabby cat sleep sofa,man watch foot bed,0.6000000238418579,0.0,229,631,-402,161604
1062,eagles perch branch,bald eagle perch branch,3.799999952316284,0.5003459810309311,2659,4258,-1599,2556801
1063,striped cat lay bag cat litter,domestic cat lay cat litter,3.799999952316284,0.7023844877674303,4155,4277,-122,14884
1064,man small child living room lose camera,man woman lose camera,2.400000095367432,0.567530462567718,3165,2296,869,755161
1065,home office computer monitor equipment desk,room computer monitor,3.0,0.4906235092030669,2591,2980,-389,151321
1066,bird stand snow,cardinal stand snow,3.799999952316284,0.4963368916566393,2636,4315,-1679,2819041
1067,black vehicle mark view low lie mountain,black car mark dirt country,2.5999999046325684,0.2545864487737466,1198,2415,-1217,1481089
1068,passenger train snow,passenger train wait station,2.200000047683716,0.5606810914481214,3105,1999,1106,1223236
1069,black bird sit ground,blackbird sit ground,5.0,0.48541124241631867,2540,5726,-3186,10150596
1070,black white bull look camera,black white dog look camera,2.0,0.743090664791911,4480,1913,2567,6589489
1071,young girl ride white grey horse,young blonde girl ride gear sit gray white horse,3.799999952316284,0.5309435362880184,2874,4316,-1442,2079364
1072,black white sheep walk white sheep,little black white calf tag ear,0.800000011920929,0.21855711463024913,1042,816,226,51076
1073,living room dining table background,boy wheel plank beach background,0.0,0.1860166039667871,933,191,742,550564
1074,dining room table get afternoon sun,dining room wooden dining table set playmate,2.200000047683716,0.5420013379816464,2970,2122,848,719104
1075,red move mark sidewalk graffiti,red soon sit street building,3.5999999046325684,0.13617098085852372,725,3967,-3242,10510564
1076,seagull float water,little bird float water,3.5999999046325684,0.48675140159565733,2555,3968,-1413,1996569
1077,black dog stand material construction site,sign toller girl sit pot flower marble post,0.0,0.0,196,188,8,64
1078,woman lose apartment building snow,woman stand building snow,4.400000095367432,0.5964345330042304,3385,5117,-1732,2999824
1079,cow graze road,sheep grazing field,1.0,0.0,197,979,-782,611524
1080,mountain goat graze aline lake,animal graze mountain body water,3.200000047683716,0.4093474328444394,2060,3194,-1134,1285956
1081,black white cow fence,black white cow metal gate partly cloudy blue sky,3.200000047683716,0.3421573699466431,1669,3211,-1542,2377764
1082,passenger train wait station,passenger train wait city train station,4.0,0.8913664567927214,5377,4377,1000,1000000
1083,white animal run snow cover wood,white dog run snow cover wood,3.400000095367432,0.8444583450460852,5129,3437,1692,2862864
1084,man sit grass look sky,train ride track snow,0.0,0.0,200,187,13,169
1085,black flat screen television place floor,flat screen floor,4.0,0.7618359894148852,4611,4390,221,48841
1086,silver bicycle mark living room,bicycle dining room,2.400000095367432,0.46552874931045346,2409,2270,139,19321
1087,black train train track,train train track,4.099999904632568,0.939104390784226,5528,4701,827,683929
1088,black train train track,train train track,4.099999904632568,0.939104390784226,5529,4702,827,683929
1089,orange cabby cat sleep sofa,wear big sitting green couch,0.0,0.0,201,185,16,256
1090,bald eagle perch rope,bald eagle perch branch,2.5999999046325684,0.7800856450796965,4722,2419,2303,5303809
1091,couple lose picture couch,young couple sit couch,4.0,0.5828637576194557,3267,4485,-1218,1483524
1092,man play guitar have drink,young boy red blue jacket feed sheep,0.0,0.0,203,183,20,400
1093,cat sit sofa look window,cat look window,3.799999952316284,0.7785524704503982,4713,4297,416,173056
1094,red double hecker bus,red double hecker bus hood,3.75,0.8275506628738379,5031,4040,991,982081
1095,close animal long face stand grass near tree,close woman black boot blue motorcycle,0.0,0.11708276155725345,632,181,451,203401
1096,brown white dog sit flora patter chair,small orange white dog collar bell relax flower print pillow,1.7999999523162842,0.09303033631182084,499,1693,-1194,1425636
1097,group people sit restaurant table,group people sit table food,4.199999809265137,0.6895353523468173,4064,4787,-723,522729
1098,sheep cliff look camera,sheep stand look camera face opposite direction,2.0,0.48334231594202415,2531,1933,598,357604
1099,black white photo train station,black white photo cat lie,1.600000023841858,0.5567865493049324,3083,1585,1498,2244004
1100,row locomotive riding field,dark brown horse stand field,1.2000000476837158,0.15031138963157686,786,1232,-446,198916
1101,white apple computer sit beige carting bedroom,apple computer sit floor,3.5999999046325684,0.46170614896333306,2381,3834,-1453,2111209
1102,dog tap small table,dog sleep table,4.599999904632568,0.41022024093553516,2068,5250,-3182,10125124
1103,boat sail sail water,nail boat sail water,3.5999999046325684,0.8056015393224043,4896,3838,1058,1119364
1104,red sport car race track,red sport car drive quickly track,4.599999904632568,0.6909906677863222,4073,5253,-1180,1392400
1105,black bird sit concrete slab,small dog sit white wall,0.800000011920929,0.14146426026310682,745,764,-19,361
1106,victory miner bus white red gold stripe,white tour bus red orange yellow stripe,3.200000047683716,0.46639963112683047,2420,3127,-707,499849
1107,red double hecker bus street,red double hecker bus city street,4.400000095367432,0.9188151253647865,5478,5113,365,133225
1108,group river barge tree background,young girl wear bike helmet bicycle background,0.4000000059604645,0.17528004733854632,894,578,316,99856
1109,seagull float water,large cruise ship float water,1.2000000476837158,0.4096145251853974,2065,1239,826,682276
1110,motorcycle mark car,bmw motorcycle mark car,3.0,0.7488258084058081,4515,3025,1490,2220100
1111,gray cat look window,cat look window,4.0,0.8325480622874577,5065,4452,613,375769
1112,black white photo cow tree,black white photo cow walk tree field,4.199999809265137,0.8583661125970399,5214,4903,311,96721
1113,post plant sunlight window,post plant sprouting,2.799999952316284,0.4539379170104172,2331,2645,-314,98596
1114,people row boat near shore,people boat green water,2.799999952316284,0.3921855737533551,1947,2642,-695,483025
1115,girl red shirt ride brown horse,white dog lay bed yellow coverlet,0.0,0.0,311,175,136,18496
1116,small desk chair sundry room,room wall washed dwyer,1.399999976158142,0.14802465167448373,771,1352,-581,337561
1117,amtrak passenger train wait station,passenger train wait station,4.0,0.8197309667834671,4986,4506,480,230400
1118,large jet ground airport,passenger jet fly air,1.7999999523162842,0.2942186742873109,1394,1688,-294,86436
1119,young girl wear helmet ride pony,girl wear red louse ride brown horse,2.0,0.3316830697045481,1608,1799,-191,36481
1120,people sit porch,people sit couch,1.399999976158142,0.4416096007214943,2259,1374,885,783225
1121,horse stand pen,group horse graze field,1.600000023841858,0.2417073778119253,1133,1464,-331,109561
1122,red train yellow train track,train travel track,3.400000095367432,0.5906997417630189,3331,3631,-300,90000
1123,people sit table restaurant,group people sit table porch,1.0,0.5171435542243703,2771,952,1819,3308761
1124,lamb stand near tiny animal,sheep stand near child,1.399999976158142,0.32945945516055525,1592,1373,219,47961
1125,person ride dirt bike outdoor,person jump motorbike air,2.200000047683716,0.1396592573752448,736,2128,-1392,1937664
1126,cow ear tag grassy field,sheep stand green hill,0.2000000029802322,0.0,209,389,-180,32400
1127,nail boat sail water,nail boat float blue water,4.199999809265137,0.6167949729245141,3543,4829,-1286,1653796
1128,woman like hat,smile woman sit wear like hat,4.199999809265137,0.706634054775249,4183,4796,-613,375769
1129,mark white double hecker bus,red white double hecker bus mark,4.199999809265137,0.9383213271347954,5526,4806,720,518400
1130,field black faced sheep,black faced sheep,2.799999952316284,0.9036853941165338,5425,2585,2840,8065600
1131,bird perch metal band,small bird perch metal bar,4.0,0.6836411810853986,4015,4392,-377,142129
1132,table blue table cloth kitchen,wooden cabinet kitchen,1.600000023841858,0.252681685011234,1187,1503,-316,99856
1133,young woman bracelet wear like jean,woman wear like jean,4.0,0.7599371950571021,4602,4670,-68,4624
1134,brown horse grazing field green grass,grown horse stand middle grassy field,4.0,0.2716413090336698,1292,4645,-3353,11242609
1135,pot liquid center trefoil cover plate,pot food place center red tablecloth,1.399999976158142,0.30873597061417435,1474,1330,144,20736
1136,black white cow stand grassy field,blue jay stand grassy field,0.6000000238418579,0.5060784647840598,2702,653,2049,4198401
1137,yellow blue airplane fly sky,white airplane fly blue sky,3.200000047683716,0.8550074987321522,5188,3170,2018,4072324
1138,woman sit chair christmas holding,train sit track train yard,0.0,0.10611328773270189,560,172,388,150544
1139,sign young people sit den living room,girl sit living chair,0.800000011920929,0.3791547123742702,1875,771,1104,1218816
1140,brain go track,brain glide track,4.599999904632568,0.7374416861167523,4434,5266,-832,692224
1141,young woman dress black,young kiss dress sit chair,0.2000000029802322,0.4961537089503836,2635,427,2208,4875264
1142,group people sit table drink,people sit table,3.0,0.7093289047554044,4212,2897,1315,1729225
1143,plane fly distance,woman white horse,0.0,0.0,198,171,27,729
1144,group river barge tree background,group cow field yellow tag ear,0.2000000029802322,0.11751411651493916,634,411,223,49729
1145,living room dining table background,living room large sofas dining table background,3.5999999046325684,0.8072057406155808,4903,3884,1019,1038361
1146,fellow stripe cat rest blue sofa,orange cabby cat sleep sofa,4.0,0.2870937466285255,1360,4662,-3302,10903204
1147,passenger train come station,large bird fly air,0.0,0.0,210,271,-61,3721
1148,people waddle red canoe tree background,people add yellow canoe river tree background,3.400000095367432,0.6101453405082408,3490,3608,-118,13924
1149,black train move track,black train idle track,2.200000047683716,0.7120227475322503,4235,2133,2102,4418404
1150,white deep mark store,white deep mark street,3.5,0.7489836128994913,4518,3706,812,659344
1151,woman stand tour bus,man talk plane,0.4000000059604645,0.0,211,501,-290,84100
1152,man ride large black motorbike,child sit large black leather chair,0.0,0.2767466532376852,1314,170,1144,1308736
1153,bicycle mark outside bookstore,people stand outside bookstore,0.800000011920929,0.6447594808389753,3748,769,2979,8874441
1154,lane mid flight sunset,plane fly near sunset,3.799999952316284,0.3237279863767925,1560,4249,-2689,7230721
1155,red bush mark garden,red bush mark large white building formal garden,3.400000095367432,0.7419087751482387,4471,3594,877,769129
1156,yellow parrot cling cage,yellow orange bird hold cage,3.400000095367432,0.44786230827359674,2296,3585,-1289,1661521
1157,couple sailing small sailboat,man sail small sailboat,3.0,0.5152026678864802,2762,2914,-152,23104
1158,silver blue motorcycle sit car,motorcycle mark car,3.5999999046325684,0.5132406861240144,2750,3867,-1117,1247689
1159,red double hecker bus,red double hecker bus,5.0,1.0,5670,5703,-33,1089
1160,foot stand pretty day large building background,police officer stand van bus background,0.4000000059604645,0.26483747181353656,1257,504,753,567009
1161,small white dog chess twig lie wooden deck,white dog lay wooden floor underneath table,1.600000023841858,0.25215679236824645,1184,1505,-321,103041
1162,standing silver train,standing silver rail car,4.400000095367432,0.6602472117558458,3852,5007,-1155,1334025
1163,close sheep tongue hang,close image sheep tongue hang,5.0,0.8894490834593263,5359,5690,-331,109561
1164,black white horn cow stand field,black white cow stand field,4.199999809265137,0.7934390459077031,4821,4880,-59,3481
1165,man ride white horse arena,man ride white horse,4.0,0.7311059064771299,4381,4594,-213,45369
1166,train sit track near field,train travel track,2.200000047683716,0.48737261682636024,2562,2043,519,269361
1167,woman small child sit dinner table smile camera,small cat lay wooden beam look camera,0.4000000059604645,0.24152038008933882,1132,502,630,396900
1168,buddha statue sit table wooden table runner,bird stand wooden fencepost,0.4000000059604645,0.15555999592483272,799,473,326,106276
1169,red bush drive garden,brain pull station,0.0,0.0,213,174,39,1521
1170,row grazing snow cover field,cow grazing snow cover field,3.799999952316284,0.7819794971047292,4736,4102,634,401956
1171,man ride white horse,woman ride brown horse,1.7999999523162842,0.6121383504745044,3508,1769,1739,3024121
1172,blue shirt stand fountain,man blue shirt part stand statue man gobble stone pave place,3.200000047683716,0.3269969025121801,1573,3280,-1707,2913849
1173,girl ride gear sit stop brown horse,girl red shirt ride brown horse,4.0,0.5417466716244401,2968,4578,-1610,2592100
1174,clear plastic chair bookcase,clear plastic chair book shelf,4.199999809265137,0.5835930275186594,3277,4904,-1627,2647129
1175,dog wear gray jacket,dog lay pet jacket,3.0,0.4540415473359564,2333,2822,-489,239121
1176,sheep stand hillside,large sheep stand hill,4.0,0.441349668684515,2257,4601,-2344,5494336
1177,black white cow stand grassy field,black white cow stand field,3.799999952316284,0.864153788693357,5243,4088,1155,1334025
1178,woman black like jean,woman black hat stand subway,1.0,0.23091923867322361,1092,947,145,21025
1179,girl ride brown horse,jockey wear purple ride brown horse,2.200000047683716,0.5411824935656708,2962,2065,897,804609
1180,standing yellow coquette,man stand yellow sport car,3.200000047683716,0.2188826346199941,1044,3217,-2173,4721929
1181,man sit grass look sky,man stand sidewalk horse,0.0,0.08853295654167692,477,177,300,90000
1182,man pose large fountain statue,blue shirt stand fountain,2.799999952316284,0.40400465419702986,2030,2611,-581,337561
1183,white cat stand carpet,sheep stand forest,0.4000000059604645,0.17323090310955702,883,577,306,93636
1184,flat screen floor,flat screen sit floor,5.0,0.9305049148648787,5514,5670,-156,24336
1185,brown horse stand grassy field,man sail small sailboat,0.0,0.0,225,178,47,2209
1186,sheep stand doorway,ram stand snowy ground,1.399999976158142,0.13635132133273567,726,1283,-557,310249
1187,room computer monitor,room computer monitor row,4.0,0.8378603768724888,5092,4528,564,318096
1188,line outside bookstore street,yellow motorcycle mark street,0.4000000059604645,0.198601102452633,979,573,406,164836
1189,passenger jet sit runaway,large passenger jet fly close ground,1.7999999523162842,0.4530301978844654,2324,1646,678,459684
1190,old green bottle sit table,man suit sit table,0.4000000059604645,0.3944401989470917,1965,584,1381,1907161
1191,white horse stare fence,horse stand pen,3.0,0.2266352603866606,1071,2803,-1732,2999824
1192,black white cow pause gate,white airplane fly sky,0.0,0.10520266086590313,555,179,376,141376
1193,black white cow stand grassy field,black white horn cow stand field,4.0,0.685653357618384,4027,4692,-665,442225
1194,black white photo cat lie,black white image cat lay rug,4.199999809265137,0.36627255257076863,1789,4841,-3052,9314704
1195,man woman stand smile camera,man woman lose camera,4.199999809265137,0.5348946910757065,2913,4845,-1932,3732624
1196,orange white cat asleep leather chair,ginger cat sit office chair,3.0,0.2973093192076095,1413,3049,-1636,2676496
1197,white cat stand carpet,pretty white stripe cat head hang table,1.600000023841858,0.2439375305381348,1142,1581,-439,192721
1198,grey white domestic kitten lie desk,man bicycle lay green grass,0.2000000029802322,0.0,223,386,-163,26569
1199,woman lose apartment building snow,white bus mark grass building,0.0,0.20537134656930242,1003,186,817,667489
1200,young woman bracelet wear like jean,woman wear jean dark like bracelet,4.599999904632568,0.8425401548602492,5119,5234,-115,13225
1201,table chair room picture wall ceiling fan,school bus drive road green tree grass background,0.0,0.0,219,189,30,900
1202,man sit cross legge bed watch small,man sit bed close small television,3.400000095367432,0.4859789550387543,2544,3431,-887,786769
1203,headlight blue car,close headlight blue car,4.199999809265137,0.9143018397136269,5460,4847,613,375769
1204,passenger train come station,passenger train sit station,2.400000095367432,0.7978927204538906,4853,2212,2641,6974881
1205,airplane face camera,lone cow sit cold yard,0.0,0.0,217,194,23,529
1206,woman ride brown horse,person dress white brown horse,3.200000047683716,0.4945919113067162,2623,3232,-609,370881
1207,jockey ride horse,jockey ride horse pen,3.799999952316284,0.8206186677992172,4992,4074,918,842724
1208,dog blend stuff animal,dog sit couch stuff animal,3.400000095367432,0.6365716202834278,3689,3496,193,37249
1209,train run track,train run track rural area,4.0,0.666985201948177,3897,4639,-742,550564
1210,stand snowy mountain watch plane,man stand mountain watch plane,4.400000095367432,0.8126306879986993,4941,5084,-143,20449
1211,bird flap wing water,large black bird sit water,3.200000047683716,0.39365448562950117,1959,3309,-1350,1822500
1212,cruise line lock port,cruise ship lock coast,3.200000047683716,0.5328982810037411,2897,3310,-413,170569
1213,red double hecker bus crowded street,white bus partially snow public street,2.0,0.27724883409915685,1316,1885,-569,323761
1214,woman pet dog fenced area,woman pet dog gaze yard,4.800000190734863,0.3966611340434898,1981,5408,-3427,11744329
1215,black white cat play blanket,black white cat get basket yarn,2.200000047683716,0.3725383571133004,1828,2010,-182,33124
1216,man mountain bike go incline,man ride mountain bike rock clear day,3.200000047683716,0.4666966167442856,2426,3302,-876,767376
1217,cat decline office chair,ginger cat sit office chair,3.799999952316284,0.6164494377141617,3537,4193,-656,430336
1218,group horse graze field,brown horse grazing field green grass,2.5999999046325684,0.34467026930324207,1684,2480,-796,633616
1219,group people have drink,row locomotive riding field,0.0,0.0,215,196,19,361
1220,dog fence tunnel look ahead,woman pose dining room baby,0.0,0.0,214,197,17,289
1221,sheep dirt road view passenger vehicle,sheep middle gravel road,3.400000095367432,0.31511746835814824,1510,3611,-2101,4414201
1222,yellow blue airplane fly sky,line red white aircraft fly formation trailing smoke,1.0,0.13073440938134323,699,925,-226,51076
1223,train sit train station,blue train station,4.0,0.7325588289796819,4395,4372,23,529
1224,train sit track near field,baby sit grass,0.0,0.20012819009482463,984,199,785,616225
1225,red double hecker bus take passenger,red double hecker bus pick passenger city,4.400000095367432,0.8476448362392985,5151,5099,52,2704
1226,gun sit couch hold bee girl lie law,woman watch street bite cross,0.0,0.0,193,166,27,729
1227,woman kitchen look object,woman kitchen take picture,2.799999952316284,0.49850428384862977,2651,2745,-94,8836
1228,race horse gallop rider,horse gallop wear number,2.799999952316284,0.5341676873456436,2908,2739,169,28561
1229,steam engine train move camera,large bird prey fly camera,0.800000011920929,0.1655893358755101,844,800,44,1936
1230,black white photo glass bottle local old,black white picture short squat local cold bottle,4.199999809265137,0.4550872297399305,2341,4800,-2459,6046681
1231,small bird perch icy branch,yellow bird perch branch,3.200000047683716,0.6639396383687174,3882,3324,558,311364
1232,boy glass tie computer,boy look computer screen,3.200000047683716,0.39947802844859737,1997,3313,-1316,1731856
1233,red truck spine tire black leave frame,red truck spinning tire emit smoke,3.200000047683716,0.3864338043753878,1919,3312,-1393,1940449
1234,living room table chair sofa alongside large palm,living room blue sofa camp bed wooden bench dresser,2.400000095367432,0.3165986247947924,1520,2192,-672,451584
1235,smile woman hold small baby,woman sit sofa hold baby,3.400000095367432,0.5133345831664183,2751,3461,-710,504100
1236,gas station tree background,police officer stand van bus background,0.0,0.22282657545136014,1058,138,920,846400
1237,blue yellow plane fly boat,blue yellow plane flight,4.199999809265137,0.6292966063304994,3623,4826,-1203,1447209
1238,horse stand near gate horse background,group river barge tree background,0.0,0.16884199788887425,864,141,723,522729
1239,bottle table,old green bottle sit table,2.400000095367432,0.6885768988170109,4058,2214,1844,3400336
1240,steam engine come train track near tree,train train station,1.399999976158142,0.27737873600611285,1317,1382,-65,4225
1241,train train station,train mark train station,4.199999809265137,0.9006901442801687,5416,4870,546,298116
1242,woman sit sofa hold baby,bird sit log lake,0.4000000059604645,0.14578648356315846,761,518,243,59049
1243,bird fly water tender,bird fly near bird leader,3.5999999046325684,0.5597121999850898,3096,3909,-813,660969
1244,cow stand large field,horse stand field,1.600000023841858,0.5320044324485909,2886,1458,1428,2039184
1245,group sheep grazing hill,group sheep hill,4.0,0.80945764123448,4925,4520,405,164025
1246,man stand train,man stand raise statue,2.0,0.3746817799987672,1845,1793,52,2704
1247,woman lose camera give thumb sign,smile young woman give thumb sign,4.400000095367432,0.6302387140809456,3632,5056,-1424,2027776
1248,woman hold small baby sit sofa,woman sit sofa hold baby,4.800000190734863,0.9128505418037178,5453,5424,29,841
1249,double hecker red united bus city street,doubly hecker red bus drive road,4.0,0.410016227776592,2066,4504,-2438,5943844
1250,woman sit brown couch,woman stand outside bus,1.0,0.12630443979414196,680,1071,-391,152881
1251,grey cat green eye look camera,grey black white cat look camera,3.200000047683716,0.7157835209500005,4263,3273,990,980100
1252,bird sit branch,sheep stand tree,0.0,0.0,157,154,3,9
1253,group people sit table restaurant,people sit table restaurant,3.799999952316284,0.9088008087210455,5438,4177,1261,1590121
1254,black white cow stand grass partly cloudy blue sky,black white cow metal gate partly cloudy blue sky,2.400000095367432,0.7783431665930529,4711,2200,2511,6305121
1255,guy white horse,man ride white horse arena,3.200000047683716,0.37987118136860704,1881,3257,-1376,1893376
1256,dairy cow drink pond,cow drink pond,4.599999904632568,0.8093421441155093,4923,5242,-319,101761
1257,share sheep pen,white sheep enclosure,2.400000095367432,0.28892959339988616,1366,2201,-835,697225
1258,black dog lie grass,black dog lie grass,5.0,1.0000000000000002,5735,5502,233,54289
1259,young people sit table slide glass door person point,people sit face table point,4.199999809265137,0.5497768108640154,3031,4794,-1763,3108169
1260,man woman hold hand walk beach,man beard skullcap boy walk ocean shore,2.200000047683716,0.17473293501666862,891,2100,-1209,1461681
1261,men sheep look camera,cat look camera,1.2000000476837158,0.5503591927758714,3036,1121,1915,3667225
1262,black white dog look camera,small black white goat pen look camera,1.399999976158142,0.5987867712594155,3396,1391,2005,4020025
1263,black table white fully chair,woman child,0.0,0.0,188,165,23,529
1264,red double hecker bus take passenger,red double hecker bus drive street,2.200000047683716,0.7279079773787681,4343,2104,2239,5013121
1265,nail boat sail water,sailboat sailing cloudy day,3.400000095367432,0.0,187,3642,-3455,11937025
1266,blue bird perch gloved hand person,bird perch person gloved hand,4.199999809265137,0.937557316627744,5525,4873,652,425104
1267,girl ride brown white horse,girl ride brown horse,3.5999999046325684,0.9197484063642342,5482,3905,1577,2486929
1268,black train track,car mark train track,1.0,0.6170111004204213,3546,1004,2542,6461764
1269,young boy color red blue carbon,young blonde girl ride gear sit gray white horse,0.0,0.09746144128147807,517,250,267,71289
1270,group people living room,group people walk past giant mushroom,0.800000011920929,0.27101203997626466,1288,788,500,250000
1271,millard tame white duck grass near water,small child pink dress sit table,0.0,0.0,180,253,-73,5329
1272,cat sit bicycle door,horse stand field fence,0.0,0.0,178,268,-90,8100
1273,girl red bag stand street,black dog stare sheep,0.0,0.0,176,256,-80,6400
1274,horse rider ride white horse,woman lead white horse,3.400000095367432,0.5239064444742749,2818,3662,-844,712336
1275,long train train track,train train track,4.199999809265137,0.9103299480106666,5446,4881,565,319225
1276,black dog look black sheep,black dog look brown sheep pen,3.0,0.7099257640238865,4220,2814,1406,1976836
1277,room computer picture wall,home office computer monitor equipment desk,2.799999952316284,0.1795853373325963,910,2667,-1757,3087049
1278,black white photo cow walk tree field,black white dog look camera,1.0,0.2476051878224158,1156,1027,129,16641
1279,silver areomexico met miner sit tartar,aeromexico silver plane runaway,4.199999809265137,0.19120098482207673,953,4888,-3935,15484225
1280,man dirt bike jump high,man motorbike jump sky,3.400000095367432,0.2599241097933561,1229,3569,-2340,5475600
1281,people sail small white sail boat,couple sailing small sailboat,4.199999809265137,0.10744419856479591,571,4906,-4335,18792225
1282,white airplane mark cement,blue motorcycle mark sidewalk,0.800000011920929,0.21955544093979554,1046,779,267,71289
1283,cow grazing field,sheep grazing field,0.800000011920929,0.7048195611794139,4174,775,3399,11553201
1284,man sit mess table lawton,man sit look lawton computer mess table,4.800000190734863,0.8572289705611243,5203,5465,-262,68644
1285,dining table candle wine weapon,wooden table set candle wine purple plastic bowl,3.0,0.524928516930674,2824,2770,54,2916
1286,people waddle red canoe reflect water,people red canoe clear lake,3.200000047683716,0.46008818485653075,2371,3271,-900,810000
1287,scantily clothe woman stand car,scantily clad woman stand small red vehicle,3.799999952316284,0.44878658888866807,2298,4234,-1936,3748096
1288,red double hecker bus take passenger,red double hecker bus hood,2.200000047683716,0.730552034296892,4373,2078,2295,5267025
1289,buddha statue hold candle sit table,man fish small boat lake,0.0,0.0,286,206,80,6400
1290,people sit dinner table smile camera,elderly woman sit dinner table man,2.0,0.5491402043571596,3024,1818,1206,1454436
1291,multi colored train track,black train track,2.799999952316284,0.49286383356216174,2606,2714,-108,11664
1292,white red bus travel street,red bus street,2.200000047683716,0.7420184469594406,4473,2139,2334,5447556
1293,red blue plane fly landing year,wwii fighter plane landing gear,3.200000047683716,0.3776979443567253,1869,3240,-1371,1879641
1294,small boat go creek,boat move river,3.0,0.3614784691523668,1762,2895,-1133,1283689
1295,woman man sit long table restaurant,group people sit table italian restaurant,3.0,0.6005353851591305,3409,2894,515,265225
1296,goat stand field tree,large boat pull small white boat,0.0,0.0,275,211,64,4096
1297,black white photo living room large window sofa chair,black white scene furnish room view outlooke forest,3.0,0.20540983925127165,1004,2890,-1886,3556996
1298,close brown horse blue halted,close horse wear blue halted,3.5999999046325684,0.8480233490808604,5152,3879,1273,1620529
1299,large black bird sit water,bird swim water,2.5999999046325684,0.5231309050729,2814,2516,298,88804
1300,close cat cream sofa,soame cat rest white sofa,3.400000095367432,0.37544869336092235,1849,3600,-1751,3066001
1301,person jump bicycle perform trick,person ride dirt bike outdoor,2.25,0.12309331498013992,668,2162,-1494,2232036
1302,yellow school bus mark rural area,yellow school bus mark field,4.0,0.686415611883673,4035,4462,-427,182329
1303,dog wit yellow chair green dumpster,bulldog sit yellow chair large waste receptacle,3.200000047683716,0.24048776155336687,1127,3225,-2098,4401604
1304,woman sit red motorcycle,white sheep stand green hill,0.0,0.0,288,212,76,5776
1305,sheep stand table auction,coolly sheep auction house,4.199999809265137,0.5476833245560639,3008,4905,-1897,3598609
1306,close black train engine,close white sheep black head,0.0,0.35050775133503004,1713,213,1500,2250000
1307,orange white cat asleep leather chair,orange white cat lay blanket black leather chair,4.0,0.6801691878601115,3989,4455,-466,217156
1308,train ride track,train come track row tree,3.0,0.4968733411031435,2641,2923,-282,79524
1309,black white cow stand grassy field,black white horn cow stand field,3.799999952316284,0.685653357618384,4028,4225,-197,38809
1310,double hecker red united bus city street,double hecker bus drive city street,4.0,0.7977976666860155,4850,4447,403,162409
1311,television desk hotel room lamp lighting,television lawton computer hotel room,2.5999999046325684,0.48233987829414837,2525,2504,21,441
1312,man ride small bicycle,man wheel bike,2.799999952316284,0.10747391527206825,572,2690,-2118,4485924
1313,woman wear navy dress cut cake white table,person wear helmet sit bicycle sunny day,0.4000000059604645,0.10636619481279468,565,499,66,4356
1314,black train move track,train travel track,4.0,0.6459562606660522,3757,4449,-692,478864
1315,close picture white purple motorcycle,close picture desk computer paper,1.0,0.3593176179565163,1748,1098,650,422500
1316,young girl ride brown horse,woman ride brown horse,3.799999952316284,0.7332986405320876,4404,4217,187,34969
1317,woman kitchen look object,man suit sit table,0.0,0.0,290,214,76,5776
1318,woman lose baby,woman pose baby,2.200000047683716,0.5327844587661846,2896,2028,868,753424
1319,group people sit table contain food,people sit living room,2.799999952316284,0.27920874285610053,1322,2659,-1337,1787569
1320,blue motorcycle mark sidewalk,blue move mark sidewalk,4.0,0.8581031070280648,5212,4463,749,561001
1321,red double hecker bus city street,red double hecker bus drive street,4.800000190734863,0.8358695673896639,5082,5394,-312,97344
1322,train inside train station,train sit train station,2.400000095367432,0.8163255610520638,4962,2179,2783,7745089
1323,man ride white horse,woman white horse,2.200000047683716,0.6669041738584566,3896,2039,1857,3448449
1324,man woman smile camera sit blue sofa,man woman smile camera stand kitchen,2.200000047683716,0.5351679186834479,2918,2063,855,731025
1325,large cruise ship harbor tree,cruise ship lock coast,3.400000095367432,0.4672945487642774,2432,3508,-1076,1157776
1326,cow cross road intervention,cow cross paved street,3.799999952316284,0.43387211861716846,2210,4216,-2006,4024036
1327,cow grazing median road,cow grazing patch grass roadway,4.0,0.4137036860339206,2090,4415,-2325,5405625
1328,black cow brown cow stand plain promote tree,black cow brown cow stand small copse tree field,4.199999809265137,0.6528809253031593,3799,4731,-932,868624
1329,red double hecker bus drive street,double hecker bus city street,3.5999999046325684,0.7681278861570127,4645,3836,809,654481
1330,cow ear tag grassy field,person grassy field tend sheep,1.2000000476837158,0.3305243739122917,1596,1119,477,227529
1331,close end purple white motor cycle,close rear red sport car,1.2000000476837158,0.11335144068358957,614,1111,-497,247009
1332,woman shop clothing store,woman clothing store,4.599999904632568,0.8304840084795577,5053,5264,-211,44521
1333,group people sit restaurant table,group people sit table restaurant,4.599999904632568,1.0000000000000002,5738,5263,475,225625
1334,close brown horse head,close yellow school bus,0.0,0.20703092664355305,1010,224,786,617796
1335,person red cap stand brick support beam,brown horse stand grass scrub,0.0,0.09513037502591357,508,225,283,80089
1336,bay foal walk mother grassy field,close young horse walk large horse,2.5999999046325684,0.09659482504373655,513,2405,-1892,3579664
1337,woman stand brown cow,woman glass stand cow field,3.799999952316284,0.5913203694597396,3340,4210,-870,756900
1338,dog peak truck,dog seek van,3.5999999046325684,0.12874382444353222,692,3835,-3143,9878449
1339,woman blue shift dress cutting food,woman blue dress cut cake,3.799999952316284,0.36270326125643637,1768,4175,-2407,5793649
1340,black white cat look camera,grey black white cat look camera,3.5999999046325684,0.8472215581575608,5147,3856,1291,1666681
1341,brunette girl sit stop red yellow motorcycle car,couple lose red yellow motorcycle,3.200000047683716,0.43115528663747665,2192,3119,-927,859329
1342,small white cat stand sink,grey white cat sit bathroom sink,3.5999999046325684,0.518494743506661,2784,3872,-1088,1183744
1343,man seat red tender bicycle,man tender bicycle,3.5999999046325684,0.7876286957415147,4778,3871,907,822649
1344,computer desk,computer operate desk,4.0,0.7757691780696514,4694,4515,179,32041
1345,small child smile camera,small child sit cement wall near white flower,1.600000023841858,0.2898343741989723,1370,1523,-153,23409
1346,little bird float water,duck float water,2.400000095367432,0.5175571347286925,2772,2306,466,217156
1347,white bus word julia near water big ship,white bus water barge background,3.799999952316284,0.31785650524583275,1527,4172,-2645,6996025
1348,old blue white train track,blue train mountainous area,2.5999999046325684,0.371148535352613,1814,2477,-663,439569
1349,fellow boat beach,yellow boat shore,4.0,0.29421450610615724,1393,4494,-3101,9616201
1350,kitchendiner paper lay blue clothe dining table,small kitchen fluttered table blue table cloth,3.400000095367432,0.2619683343528304,1237,3487,-2250,5062500
1351,brain station,train inside indoor station,3.799999952316284,0.2870254839235041,1358,4136,-2778,7717284
1352,gray cat sit window ledge look camera,cat stand window sill look camera,4.0,0.530858684534774,2872,4471,-1599,2556801
1353,play guitar sit,red white bus drive road,0.0,0.0,292,136,156,24336
1354,red double hecker bus drive street,double hecker bus city street,4.199999809265137,0.7681278861570127,4644,4754,-110,12100
1355,cow graze grassy field,cow grazing field,4.599999904632568,0.4629654417221334,2389,5255,-2866,8213956
1356,brown train sit railroad track,white train sit track,2.25,0.6408065568602133,3719,2157,1562,2439844
1357,black white horn cow stand field,black white photo cat sit sofa,0.4000000059604645,0.20515121957726057,1002,488,514,264196
1358,tiny blonde child blue dress sit table near mother,young blonde girl wear helmet sit red bicycle,1.600000023841858,0.2595890509596263,1225,1550,-325,105625
1359,group people sit restaurant table,group people sit table porch,2.5999999046325684,0.6362027759483276,3682,2495,1187,1408969
1360,black white cow pen hay,black white cat lie dirt,0.4000000059604645,0.2309884888132277,1093,490,603,363609
1361,red double hecker bus,leave red double hecker bus,3.200000047683716,0.9001316202504543,5412,3103,2309,5331481
1362,close view horse head,view horse head,3.200000047683716,0.9006434710179639,5415,3106,2309,5331481
1363,old fashioned wooden sailing ship ocean,wooden yacht ocean,3.200000047683716,0.3906771837993903,1940,3116,-1176,1382976
1364,sheep stand mountainous area,large sheep stand hill,4.400000095367432,0.3922013528551081,1948,5048,-3100,9610000
1365,white plane runaway,white airplane runaway,4.800000190734863,0.6505305434249744,3783,5353,-1570,2464900
1366,puppy pet,puppy hold pet,4.400000095367432,0.8948676689436974,5393,5030,363,131769
1367,elegant dining room wood furniture,elegant pink dining room wooden furniture,3.799999952316284,0.7717236751293195,4661,4133,528,278784
1368,woman lay man sit sofa,man short sit sofa,2.0,0.6244430514378021,3585,1839,1746,3048516
1369,motorbike dirt track,dirt baker ride dirt hill,3.5999999046325684,0.41537815552259455,2101,3862,-1761,3101121
1370,black white cat look camera,black white dog look camera,2.200000047683716,0.8271963625671912,5026,2116,2910,8468100
1371,gray cat green eye look camera,grey cat green eye look camera,5.0,0.7732708324931523,4674,5555,-881,776161
1372,lamb stand grassy hill,dirt baker ride dirt hill,0.2000000029802322,0.19854107190550513,977,420,557,310249
1373,man white wine bottle woman red turtleneck white vest,man woman lose field bottle wine,3.0,0.4753554402704391,2487,2876,-389,151321
1374,lone cow sit cold yard,black white cow stand field,1.7999999523162842,0.20127343419222488,990,1642,-652,425104
1375,double hecker bus drive city street,red double hecker bus drive street,3.5999999046325684,0.8706167105054796,5275,3857,1418,2010724
1376,large black white cat rest windowsill,small white cat sit sink,1.7999999523162842,0.25276400873768234,1188,1648,-460,211600
1377,boy feed sheep,boy feed sheep hay,4.199999809265137,0.8042348697728673,4887,4762,125,15625
1378,girl black desktop hold open box worn lakes carbon milk,girl wear black short boot stand blue motorcycle,0.0,0.11742288410226379,633,35,598,357604
1379,close small cactus pot,close woman hold white puppy,0.800000011920929,0.16003372731584997,819,874,-55,3025
1380,white sheep stand green hill,sheep stand hillside,4.0,0.4047885836202294,2038,4393,-2355,5546025
1381,black white bird body water grass background,bus road ferry wheel background,0.0,0.1910903291942828,951,40,911,829921
1382,wooden bicycle owning,group elderly people sit dining table,0.0,0.0,244,42,202,40804
1383,black white photo dilapidated wooden fence,black white photo old wooden fence near dirty street,4.5,0.5871307027640581,3298,5140,-1842,3392964
1384,brown horse stand green meadow,brown horse stand tall grass,2.5999999046325684,0.4278077124162738,2168,2484,-316,99856
1385,man wear bike helmet,man stand bicycle outside shop,1.600000023841858,0.07585822179221745,439,1537,-1098,1205604
1386,man play video game store,playing game store,3.400000095367432,0.5467825203927814,3003,3603,-600,360000
1387,group people sit table porch,group people sit table food,3.5999999046325684,0.6584066606560501,3840,3926,-86,7396
1388,young girl wear bike helmet bicycle background,woman hold small dog leash chair background,0.0,0.17203404529670735,879,43,836,698896
1389,stop sign stick,stop sign adorn stick,5.0,0.7729489874169242,4670,5533,-863,744769
1390,bicycle mark outside bookstore,green bike mark outside book store,4.0,0.340380252995546,1657,4402,-2745,7535025
1391,brown double hecker tour bus street ferry wheel,double hecker bus drive ferry wheel,4.400000095367432,0.7574686639657886,4578,5102,-524,274576
1392,black white chair sit brick wall window bamboo plant vase,black headed sheep cover thick white wool stand pasture sheep,0.6000000238418579,0.0853752501144533,467,680,-213,45369
1393,man black uniform white horse,man tax white horse,3.5999999046325684,0.4946639723798973,2625,3928,-1303,1697809
1394,woman stand living room black dog,woman stand living room black dog look camera,4.0,0.837947884834988,5093,4369,724,524176
1395,people waddle red canoe reflect water,people waddle red canoe tree background,3.200000047683716,0.6761797704053155,3959,3199,760,577600
1396,close view headlight blue old fashioned car,close headlight blue car,4.0,0.7070255227340023,4188,4375,-187,34969
1397,war drive near model building,vehicle drive infant senate building,2.400000095367432,0.3169316520142453,1521,2244,-723,522729
1398,blue orange airplane fly landing gear,red blue plane fly landing year,2.5999999046325684,0.5216646423127543,2807,2460,347,120409
1399,black white cat lie blanket,black white cat sleep purple blanket,4.0,0.6423511805255344,3727,4380,-653,426409
1400,building temporary sign entrance parking lot,road rear image tail light bus,0.2000000029802322,0.0,238,380,-142,20164
1401,group people sit table contain food,group people sit table porch,3.400000095367432,0.5603678376027899,3099,3549,-450,202500
1402,man woman sit sofa hold small baby,woman sit sofa hold baby,3.200000047683716,0.8844494883593497,5343,3169,2174,4726276
1403,black white cat lie blanket,black white cat sleep purple blanket,3.0,0.6423511805255344,3726,2771,955,912025
1404,black white photo love seat,black white photo bicycle,1.7999999523162842,0.5454010661464493,2995,1636,1359,1846881
1405,living room dining table background,view living room dining room background,4.199999809265137,0.8046298920905705,4889,4767,122,14884
1406,red gray train go tunnel,red gray train travel tunnel tree,4.25,0.8046901471669794,4891,4913,-22,484
1407,red double hecker bus hood open,old red london double hecker bus hood raise,4.199999809265137,0.7523893503567454,4544,4736,-192,36864
1408,man ride white horse,woman lead white horse,1.7999999523162842,0.527527897653604,2840,1695,1145,1311025
1409,view living room dining room background,living room large sofas dining table background,3.799999952316284,0.6495018679664037,3778,4122,-344,118336
1410,orange kitten lie leather couch,young couple sit black couch,0.800000011920929,0.23347440152169113,1101,858,243,59049
1411,person wear bike helmet talk cell phone,person wear helmet ride bike near white structure,3.0,0.5245339968965155,2822,2805,17,289
1412,subway train pull station,white train pull station,3.5999999046325684,0.7290627215466785,4357,3961,396,156816
1413,bicycle mark shop,green bike mark outside book store,3.799999952316284,0.19608567370193625,971,4121,-3150,9922500
1414,man stand beach,woman stand tour bus,0.0,0.23887729476935943,1120,53,1067,1138489
1415,long haired black dog stand grassy field,blue jay stand grassy field,1.399999976158142,0.44644460049984613,2291,1307,984,968256
1416,small desk chair near sundry closet,room wall washed dwyer,0.2000000029802322,0.0,249,392,-143,20449
1417,red double hecker bus drive street,red double hecker bus drive street,4.599999904632568,1.0,5654,5278,376,141376
1418,goose flap wing body water,black swan flap wing water,3.0,0.5871495029471951,3299,2807,492,242064
1419,boy lay couch dog,boy lie couch puppy,4.400000095367432,0.4931467613104773,2609,5114,-2505,6275025
1420,black white image cat lay rug,black white picture cat lay rug,5.0,0.7990235521100227,4858,5513,-655,429025
1421,large jet ground airport,large airplane mark airport night,3.5999999046325684,0.4002686894491888,2009,3973,-1964,3857296
1422,woman sit cafe,man catch fish swamp,0.0,0.0,250,55,195,38025
1423,right bottle karp later line floor,right bottle karp beer line wooden floor,4.0,0.7574946031156589,4579,4407,172,29584
1424,small child smile camera,cat look camera,1.399999976158142,0.29724670604603803,1412,1312,100,10000
1425,woman ride brown horse,person dress blue ride brown horse,2.5999999046325684,0.6417039172645589,3723,2524,1199,1437601
1426,photo television screen show movie,wall mount flat screen show movie,3.200000047683716,0.4608376618532799,2376,3165,-789,622521
1427,bird perch flowerpot,bird perch flowerpot stuck wall,4.199999809265137,0.7501145331252878,4529,4713,-184,33856
1428,white cat sit inside sink,grey white cat sit bathroom sink,3.400000095367432,0.6014313095078102,3411,3667,-256,65536
1429,young woman ride gear horse,young girl ride gear horse,4.400000095367432,0.8854689328407204,5349,5101,248,61504
1430,people sail small boat,woman sailboat,3.799999952316284,0.0,251,4118,-3867,14953689
1431,small bird tiny branch,small bird perch icy branch,3.0,0.5558269789811477,3076,2775,301,90601
1432,animal sit rock,eagle sit long branch,1.600000023841858,0.17384964960307295,885,1522,-637,405769
1433,cat sit couch look window,cat sit couch look window sea photo,4.199999809265137,0.8048043527214409,4893,4711,182,33124
1434,young woman hear sheep,woman sneer sheep,4.400000095367432,0.40447056329468134,2036,5086,-3050,9302500
1435,young rider take ride brown horse,young female rider brown horse,3.799999952316284,0.7785430452277087,4712,4117,595,354025
1436,people seat restaurant table look camera,group people sit restaurant table,3.0,0.5796392197954892,3247,2776,471,221841
1437,little white lamb nose wood,white lamb nose wooden box,3.799999952316284,0.6306898991149124,3638,4116,-478,228484
1438,young girl ride white grey horse,little girl ride white grey horse,4.599999904632568,0.8299367802888024,5047,5219,-172,29584
1439,black dog stand material construction site,black dog stand room construct,3.200000047683716,0.2992378378442412,1425,3154,-1729,2989441
1440,bird flap wing water,black swan flap wing water,3.5999999046325684,0.6940565970709762,4094,3929,165,27225
1441,black white cat lie blanket,black white cat lay cat bed,3.75,0.493953006342464,2619,4033,-1414,1999396
1442,young woman ride gear horse,woman ride brown horse,3.799999952316284,0.5714938759674512,3191,4114,-923,851929
1443,plane reply,small turboprop plane load tartar,3.400000095367432,0.1924375968025117,956,3644,-2688,7225344
1444,white leather couch purse throw blanket,television,0.0,0.0,262,33,229,52441
1445,kitchen wooden cabinet furniture,kitchen wooden table cabinet,4.199999809265137,0.7391078267022402,4447,4734,-287,82369
1446,cat attack corn dusk broom,grey white cat sit bathroom sink,0.800000011920929,0.10677332605387384,567,776,-209,43681
1447,couple hold baby,couple newton baby,4.199999809265137,0.6222163275675079,3574,4710,-1136,1290496
1448,small bird eat tender,bird eat bird tender,4.25,0.8520344155421276,5170,4923,247,61009
1449,close white sheep black head,close sheep black head,4.0,0.9249502002422098,5496,4642,854,729316
1450,young boy lay sofa dog,small boy lay sofa dog,5.0,0.8165027282496962,4964,5526,-562,315844
1451,red bird perch tree,small red grey bird perch tree,3.200000047683716,0.8025332270714305,4878,3124,1754,3076516
1452,bush mark street,fellow soon mark alley way,0.4000000059604645,0.18906962366347546,943,506,437,190969
1453,black white dog look camera,grey black white cat look camera,1.0,0.7008185911964422,4138,1042,3096,9585216
1454,train railroad track,train train track,4.800000190734863,0.6802881743081692,3991,5432,-1441,2076481
1455,large silver locomotive engine shed,close silver train engine red strike,3.0,0.4412802334523446,2255,3039,-784,614656
1456,woman sit table drink basketball picture background,woman safi drink sit table,2.5999999046325684,0.513348481540045,2752,2387,365,133225
1457,green steam engine travel railroad track,black steam train travel railroad track,3.0,0.7639042790192943,4624,3044,1580,2496400
1458,small red car semi truck,red sport car white semi truck,4.0,0.7694630828889419,4653,4665,-12,144
1459,man pose photo train,man stand platform silver train,3.400000095367432,0.2575598773689182,1214,3476,-2262,5116644
1460,bicycling black black red racing bike,cycling black white liar speeding past spectator,3.400000095367432,0.11964985734663407,646,3430,-2784,7750656
1461,kitchen sink countertop bowl shelf,small kitchen item stack shelf counter,3.799999952316284,0.36906137559142216,1802,4124,-2322,5391684
1462,television mess room bookcase,room television sterno bookshelf,3.200000047683716,0.35531178199929503,1735,3148,-1413,1996569
1463,black white cat sleep purple blanket,black white cat lay ground sun,2.799999952316284,0.31253321092438785,1495,2670,-1175,1380625
1464,woman ride bicycle large concrete area,woman ride mountain bike large concrete area,3.799999952316284,0.7203326276623148,4299,4140,159,25281
1465,cow stand large field,cow graze field,2.799999952316284,0.5584680750615952,3090,2664,426,181476
1466,bald man touch nose black horse fence,bald man beard pet nose black white horse fence,3.400000095367432,0.7127985913473335,4241,3444,797,635209
1467,man stand yellow sport car,man stand yellow corvette,4.0,0.4539374275650264,2330,4643,-2313,5349969
1468,black white photo cow stall,black white photo cattle trough,3.200000047683716,0.3798655526419974,1880,3128,-1248,1557504
1469,double hecker bus london eye ferry wheel background,brown double hecker tour bus street ferry wheel,4.199999809265137,0.654006327616678,3807,4743,-936,876096
1470,yellow black bird eat bird tender,flock bird fly body water,0.6000000238418579,0.2956843166026389,1404,715,689,474721
1471,man stand train,man stand platform silver train,3.799999952316284,0.5783100669539887,3235,4171,-936,876096
1472,small plane mark fairfield cloudy sky overhead,small white plane mark airport cloudy day,4.599999904632568,0.5351066418382502,2917,5203,-2286,5225796
1473,boat water near small plane,boat water small airplane dock,3.400000095367432,0.5153031946019593,2763,3524,-761,579121
1474,man ride white horse arena,domestic animal stand pen,0.6000000238418579,0.0,255,666,-411,168921
1475,farintosh computer sit floor,computer floor,4.199999809265137,0.6720394405014616,3933,4756,-823,677329
1476,black white cat sit brown chair look,dog sit yellow chair green dumpster,0.4000000059604645,0.3051805186777637,1456,517,939,881721
1477,sheep stand afield,large dog stand sheep field,2.799999952316284,0.4328634202020875,2204,2743,-539,290521
1478,group elderly people sit table,group elderly people pose dining table,3.400000095367432,0.7021482036751612,4150,3484,666,443556
1479,woman brown hair smile,woman indian dress crowded room smile,2.799999952316284,0.3188260493693258,1533,2677,-1144,1308736
1480,black white photo train station,black white photo cat sit sofa,1.600000023841858,0.5043629397347322,2686,1564,1122,1258884
1481,dog fence tunnel look ahead,girl guy lose bow boat,0.0,0.0,253,116,137,18769
1482,black white cow look fence,black white cat lay ground sun,0.6000000238418579,0.2217018160764948,1052,691,361,130321
1483,people motorcycle market square,people ride move urban setting,1.7999999523162842,0.12190021086514033,656,1698,-1042,1085764
1484,close sheep grass,close lamb ear ragged stand grass,1.7999999523162842,0.3625020230263812,1765,1697,68,4624
1485,domestic cat lay cat litter,domestic cat black trap,2.0,0.5189123497798502,2786,1899,887,786769
1486,green bird fly wooden telephone pole,green bird fly telephone wire,3.200000047683716,0.6839722034072995,4019,3168,851,724201
1487,person sit motorcycle man stand,man stand helmet man motorcycle parking lot,3.0,0.4697644043215606,2450,2955,-505,255025
1488,cow grazing field,cow graze field,2.5999999046325684,0.5391452047057727,2947,2432,515,265225
1489,blue bird perch gloved hand,bird perch person gloved hand,4.400000095367432,0.8758531973147781,5307,5014,293,85849
1490,baby hold ketchup packet,baby highchair hold ketchup packet,4.0,0.8456642006963179,5136,4687,449,201601
1491,close view horse head,close brown horse head,4.199999809265137,0.7023558819870099,4154,4760,-606,367236
1492,train train station,train station,5.0,0.9452883159327599,5545,5490,55,3025
1493,dark brown horse stand field,horse stand field,3.5999999046325684,0.7081691544776445,4201,3955,246,60516
1494,small cat lay wooden beam look camera,small dog wear sweet look camera,0.800000011920929,0.3887263738916305,1932,829,1103,1216609
1495,black bird sit ground,bird sit branch,2.5,0.5059498879967731,2700,2332,368,135424
1496,small brown bird eat bird tender hang tree,small red grey bird perch tree,2.0,0.4727238060863337,2465,1906,559,312481
1497,pair dog play purple ball,dog play purple football,4.400000095367432,0.5202880074520597,2797,4990,-2193,4809249
1498,bird land water,boat float water,0.6000000238418579,0.22764879599752885,1076,667,409,167281
1499,child stand near fence,child stand fence,4.599999904632568,0.8669640624268948,5251,5314,-63,3969
1500,black dog emerge water white ball mouth,black dog walk water white ball mouth,4.800000190734863,0.7674501656996563,4642,5404,-762,580644
1501,girl purple shirt pink headband lose,young girl wear hat blue jean swing,0.4000000059604645,0.08395278711050606,462,523,-61,3721
1502,brown dog dig hole plant,group people walk railroad track,0.0,0.0,270,80,190,36100
1503,brown white dog swim swimming pool,brown white dog swim backward swimming pool,4.599999904632568,0.8744836770568482,5300,5313,-13,169
1504,boy red lead ride hill,multicolour dog red collar crouch grass,0.0,0.11600768732663254,627,84,543,294849
1505,black brown dog run wood,dog run wood,4.0,0.7963436824950543,4839,4558,281,78961
1506,dog run grass,dog play grass,4.400000095367432,0.7009398224511525,4141,4995,-854,729316
1507,young girl hold peace sign,little girl hold pole city street,0.6000000238418579,0.28735678015173005,1362,717,645,416025
1508,man hang line cliff water,sitting pier bottle water,0.6000000238418579,0.12649166461215933,682,724,-42,1764
1509,man crouch hold camera,crouch man hold large camera,4.599999904632568,0.9102686141575742,5445,5310,135,18225
1510,ride bicycle narrow path,man ride bicycle paved road,2.5999999046325684,0.37127536962859925,1818,2418,-600,360000
1511,man wear orange coat speak walk snow,man woman dress old fashion clothing sit outside table,0.6000000238418579,0.03934968638881007,409,698,-289,83521
1512,dog jump air catch toy,black dog jump air catch toy,4.0,0.9443174583491662,5542,4570,972,944784
1513,brown dog lay blue cover,person diving clear blue water,0.0,0.17075420787984003,875,94,781,609961
1514,boy play field,people head cover scarf,0.0,0.0,54,95,-41,1681
1515,dog run grass,dog run snow,2.200000047683716,0.5363115692298379,2927,2091,836,698896
1516,boy broken arm rest bed,boy broken arm sleep,4.0,0.621300594513285,3570,4628,-1058,1119364
1517,boy trick skateboard,boy trick skateboard,4.800000190734863,1.0000000000000002,5742,5433,309,95481
1518,dog play snow,dog play water,2.5999999046325684,0.5565807676119856,3082,2394,688,473344
1519,little girl ribbon hair pick nose,little girl purple shirt helmet ride soon,1.2000000476837158,0.2043959914592442,998,1110,-112,12544
1520,young girl go tube slide,young girl swinge tire swing,1.7999999523162842,0.2802856226158197,1330,1656,-326,106276
1521,people bicycle racing include man wheeled bike,man ride wheel wheelchair,2.5999999046325684,0.05124387867495711,412,2395,-1983,3932289
1522,group people wear funny ear,group people ride race,0.800000011920929,0.33131264570487384,1606,752,854,729316
1523,dog sherman shirt sleep blanket,brown dog superman shirt lay blue blanket,4.0,0.41560386731237886,2103,4525,-2422,5866084
1524,white brown dog run grass,brown white dog run grass,4.800000190734863,1.0,5647,5435,212,44944
1525,brown dog rest paw lawton keyboard,dog sit paw lawton computer,3.799999952316284,0.5890879807584575,3317,4165,-848,719104
1526,young girl glass sit hold american flag,girl glass look american flag near wooded area,2.5999999046325684,0.5754910337979542,3213,2403,810,656100
1527,small white brown dog jump horizontal pole,brown white dog jump red yellow pole,3.0,0.6317542821860483,3652,2943,709,502681
1528,dog run grassy area,dog run grassy field,4.800000190734863,0.7091855431274482,4211,5438,-1227,1505529
1529,man swinge rope water,man warm clothe swinge monkey bar night,1.600000023841858,0.3034216651888085,1440,1469,-29,841
1530,sign man sign woman sit black massage chair,sign man woman relax massage chair,4.599999904632568,0.7535591000340691,4549,5292,-743,552049
1531,girl playing pile colourful ball,little girl play pit colourful ball,5.0,0.4662828527906991,2417,5519,-3102,9622404
1532,old man stand outside truck,woman dress green roller state outside event,0.0,0.18636806470728326,934,306,628,394384
1533,smile man effective class,gentleman smile show effective sunglass,4.599999904632568,0.4964684307889705,2639,5282,-2643,6985449
1534,people stand sidewalk,people sidewalk,4.800000190734863,0.8715180363950972,5281,5423,-142,20164
1535,white dog run snow,white bear walk snow cover ground cast shadow snow,1.399999976158142,0.4176562167223139,2111,1319,792,627264
1536,young boy brown jacket play snow,dog play snow,1.2000000476837158,0.46220563472918175,2385,1147,1238,1532644
1537,man pick big rock,woman pick large rock,2.400000095367432,0.6417837732567382,3725,2279,1446,2090916
1538,white brown dog run grass,brown white dog run grass,4.599999904632568,1.0,5646,5284,362,131044
1539,carry tool box sidewalk,woman ride blue bicycle park,0.0,0.0,48,282,-234,54756
1540,man wear t shirt say gigolo stand counter talk,man wear shirt say gigolo stand desk area camera,3.400000095367432,0.6523689430519721,3794,3486,308,94864
1541,tent campfire submit forest,white dog beach carry stick mouth,0.0,0.0,47,288,-241,58081
1542,large dog run grass,bridle dog run grass,4.199999809265137,0.5681590534977672,3170,4781,-1611,2595321
1543,dog swim stick mouth,dog run stick mouth,2.5999999046325684,0.7536300866178692,4550,2414,2136,4562496
1544,man play fetch brown dog,woman play brown dog,2.3299999237060547,0.5939273970348571,3364,2164,1200,1440000
1545,dog run sand stick mouth,dog run creek stick mouth,3.5999999046325684,0.6511404529478321,3788,3945,-157,24649
1546,man stand water near waterfall,man wage water watch water fall,3.400000095367432,0.29373654222941026,1387,3481,-2094,4384836
1547,dog jump catch tennis ball,red dog jump catch tennis ball mouth,3.0,0.8549667861653993,5187,2988,2199,4835601
1548,man jump water,man air,2.400000095367432,0.21701891642540344,1036,2280,-1244,1547536
1549,woman black shirt stand banana fruit stand,woman wear black stand pick truck,2.400000095367432,0.34558720782753677,1688,2277,-589,346921
1550,child jump swimming pool,dog jump swimming pool,1.2000000476837158,0.843711775214223,5127,1131,3996,15968016
1551,little boy jump chair,young boy jump chair house,4.800000190734863,0.6554100995656377,3822,5476,-1654,2735716
1552,girl swe long wet hair lake,person ride dirt bike,0.0,0.0,44,344,-300,90000
1553,dog play shore,dog play snow,2.799999952316284,0.4600008139257834,2369,2689,-320,102400
1554,little girl walk boardwalk blue dome background,man go jump bike river background,0.0,0.1845813792875719,929,325,604,364816
1555,woman sit bench face obscure woman carry inflammable tiger woman kidney snow white costume,girl sit bench hold inflammable tiger girl colourful outfit,2.200000047683716,0.3546392411029378,1732,2012,-280,78400
1556,guy girl smile camera,dog white brown run field grass,0.0,0.0,43,312,-269,72361
1557,dog swim stick mouth,dog swim water stick mouth,5.0,0.9206115837005693,5484,5532,-48,2304
1558,black people play snow,black people frolic snow,5.0,0.6082059916127294,3472,5557,-2085,4347225
1559,girl hold scar movie ulcer,girl hold sack stand field,1.399999976158142,0.24499550742439657,1148,1331,-183,33489
1560,boy run beach play game,young boy young man run beach water,3.200000047683716,0.445020845369984,2283,3114,-831,690561
1561,girl wear purple sash watch skirt,group girl stand wear jean skirt sherman shirt,1.600000023841858,0.3799677452274113,1883,1507,376,141376
1562,man wear grey jacket stand street,boy wear blue life jacket hold green boat,0.6000000238418579,0.3540495731293498,1730,624,1106,1223236
1563,brown black dog jump catch red ball,brown black dog jump red ball,5.0,0.8735461411056528,5296,5503,-207,42849
1564,dog run leave,white dog run ocean,1.7999999523162842,0.4243940508666336,2152,1745,407,165649
1565,white black dog jump pool,woman black apron stand mirror,0.0,0.12355083318627094,670,316,354,125316
1566,black white dog carry stick mouth,black white dog stick paw,3.0,0.5888924069533459,3315,2931,384,147456
1567,deer jump fence,deer jump fence,5.0,1.0000000000000002,5733,5544,189,35721
1568,little girl hold wooden stick,little girl swim pool,2.200000047683716,0.38185868826098845,1894,1988,-94,8836
1569,black dog jump water,dog walk snow,2.400000095367432,0.19287320995437854,957,2286,-1329,1766241
1570,group people red fire truck,group people stand red fire truck,4.199999809265137,0.9172171054563197,5473,4707,766,586756
1571,boy jump blue pool water,young boy jump pool belly,3.400000095367432,0.562977727291013,3125,3680,-555,308025
1572,blonde dog catch ball mouth snow,little blonde girl sit green chair,0.0,0.27482011500458287,1306,338,968,937024
1573,child play laugh floor,child play floor,3.799999952316284,0.7810256005326813,4727,4153,574,329476
1574,man sit fishing pole near body water,man sit rock fold deck chair fishing pole,3.400000095367432,0.5156387301169784,2765,3617,-852,725904
1575,woman dog stand grass,man carry sign stand rain,0.0,0.19886091381805265,981,336,645,416025
1576,man blue shirt run stadium field,man wear blue hat shirt ride white horse,1.0,0.3773977390694344,1868,1032,836,698896
1577,black dog run water,black dog run water,4.800000190734863,1.0000000000000002,5739,5384,355,126025
1578,child jump trampling,man shed orange slide,0.0,0.0,41,333,-292,85264
1579,large brown dog crouch grassy field,brown dog run field,3.0,0.5192444175934344,2792,2965,-173,29929
1580,dog run grass,dog run snow,2.200000047683716,0.5363115692298379,2928,2040,888,788544
1581,sky speed snow,brown dog carry frisbee run snow,0.2000000029802322,0.1971736850685146,974,384,590,348100
1582,people play golf golf course,people golf course play golf,5.0,1.0000000000000002,5732,5546,186,34596
1583,boy girl play beach,dog play wave ball,0.800000011920929,0.18354966879027063,925,749,176,30976
1584,child red coat lay red mat,toller ready climb red piece equipment,0.800000011920929,0.16291741604222174,829,754,75,5625
1585,dog play grass,dog play grass,5.0,1.0,5673,5497,176,30976
1586,child blue white team uniform chase soccer ball,young boy blue soccer uniform chase ball,4.0,0.7574088041772923,4576,4599,-23,529
1587,football player swinge pitch,baseball player hit ball,2.799999952316284,0.24414425875224768,1143,2736,-1593,2537649
1588,man kite surge away camera,man sky surge water,2.799999952316284,0.4037917188955863,2029,2748,-719,516961
1589,black dog run grass,boy run green grass,1.0,0.535797742482336,2924,1101,1823,3323329
1590,little boy little girl play outside,young boy young girl walk,2.0,0.22173020131214172,1053,1926,-873,762129
1591,people sit end dock,people sit dock,4.199999809265137,0.8749886683162762,5303,4729,574,329476
1592,dog yard,dog stream,2.0,0.1990198520013421,982,1928,-946,894916
1593,man case dog try pass barrier enter play area,man follow black white dog take obstacle course,2.200000047683716,0.10549966868356364,557,1979,-1422,2022084
1594,large brown white dog run snow,gerard dog run snowy field,4.0,0.21738709981231713,1037,4597,-3560,12673600
1595,bloody man woman pose picture,man woman dress warmly pose picture,2.0,0.5429104428549514,2974,1930,1044,1089936
1596,yellow dog play grassy area near flower,girl play swing,0.4000000059604645,0.13018885144259026,696,582,114,12996
1597,boy play noble pool,boy play foam noble toy pool,4.599999904632568,0.7408348711738332,4462,5305,-843,710649
1598,big brown dog run snow,brown dog run grass,2.0,0.5712077711116733,3189,1912,1277,1630729
1599,young boy jump pool outstretched arm,dog jump backward pool,1.2000000476837158,0.36817482082380937,1798,1149,649,421201
1600,girl hold yellow balloon animal,child hold yellow balloon,4.0,0.7316951633273916,4386,4411,-25,625
1601,dog share toy field vegetation,snowboarder air snow,0.1700000017881393,0.0,57,371,-314,98596
1602,blood haired lady white pose camera,black white dog run mouth open,0.0,0.10088429385946136,534,356,178,31684
1603,dog run field chase ball,child run grass,0.2000000029802322,0.18876033137494924,942,381,561,314721
1604,girl sit statue,blonde girl sit statue,3.799999952316284,0.7858154859143917,4757,4144,613,375769
1605,girl orange light candle,girl orange shirt light candle,4.0,0.9064466242435525,5434,4595,839,703921
1606,white dog run field yellow flower,dog red collar run forest middle winter,1.600000023841858,0.1625472821423296,828,1487,-659,434281
1607,infant sit cot reach touch face old boy,boy ill touch face toller,2.200000047683716,0.3682490029865883,1799,1983,-184,33856
1608,dog shake water,dog shake water,5.0,1.0000000000000002,5729,5499,230,52900
1609,young boy run pavement,black dog run edge ocean,0.5,0.13959648763813345,735,609,126,15876
1610,young child side orange slide,little boy denis overall side orange slide,3.670000076293945,0.3960693090991852,1980,3986,-2006,4024036
1611,black white dog run red white pole,black white dog living room stand hind leg,1.600000023841858,0.29396832158925473,1391,1486,-95,9025
1612,individual lose skin skin sign,people skin stand skin sign,4.400000095367432,0.7831427246410632,4740,4967,-227,51529
1613,man white suit walk street hold newspaper,man white suit walk outside carry newspaper,4.599999904632568,0.7071584769521255,4191,5302,-1111,1234321
1614,black dog blue collar run snow,black dog wear blue collar run snow,5.0,0.9214616258924917,5487,5495,-8,64
1615,dog run camera,brown white dog run grass,0.800000011920929,0.4095134665106792,2062,826,1236,1527696
1616,boy swinge swing,girl swing,2.400000095367432,0.5330544094868881,2899,2303,596,355216
1617,group youngster swim lake water,child play swim water,4.400000095367432,0.4216388277232509,2134,4961,-2827,7991929
1618,blue white soccer team play,hopeless woman face paint cover mud,0.0,0.0,72,273,-201,40401
1619,brown dog catch green frisbee,brown dog wait frisbee come catch,3.799999952316284,0.7273219857417604,4339,4147,192,36864
1620,black white dog swim large green lake,black dog run fast shallow water,2.200000047683716,0.16507643455291493,843,2035,-1192,1420864
1621,large black dog play grassy field,white dog run,2.200000047683716,0.1657642687796397,846,2032,-1186,1406596
1622,brown black dog splint snow,black dog run quickly ground,2.799999952316284,0.21760136679278863,1039,2746,-1707,2913849
1623,man backpack look left,adult male wear backpack walk look left,3.799999952316284,0.6503433328721817,3782,4148,-366,133956
1624,elderly man blue shirt hold piece canvas art,black man walk building big city,0.0,0.048763444028015364,411,278,133,17689
1625,skinny young boy play sand water,dog shake water,0.4000000059604645,0.1684085702840347,859,588,271,73441
1626,small dog run obstacle course,small dog jump obstacle,3.799999952316284,0.6720788131102824,3934,4149,-215,46225
1627,brown dog run wood,brown dog run grass,3.200000047683716,0.622969084308195,3579,3087,492,242064
1628,group people stand window watch,group people stand wait,3.400000095367432,0.51832262235648,2781,3547,-766,586756
1629,dog jump barrier agility competition,dog jump obstacle course fence,4.400000095367432,0.19864623306208518,980,5009,-4029,16232841
1630,people race ice state,ice state round corner,3.200000047683716,0.457207903705625,2352,3085,-733,537289
1631,woman contestant walk dog dog,woman walk dog dog,4.800000190734863,0.7432507734288711,4482,5345,-863,744769
1632,man barge,man lie grass long hair beard,0.0,0.0831555503308664,457,283,174,30276
1633,brown dog run grass,brown dog run grass,4.800000190734863,1.0,5641,5383,258,66564
1634,person ride bike trail wood,small child yellow shirt hold arm side,0.4000000059604645,0.0,70,572,-502,252004
1635,woman black dress smile silver truck,girl wear black smile silver truck background,3.5999999046325684,0.691213998650723,4074,3974,100,10000
1636,dog beach near ball,guy go lay basketball court,0.6000000238418579,0.0,69,655,-586,343396
1637,dog bound brown grass,dog bind grass,2.5999999046325684,0.3612836571836532,1760,2483,-723,522729
1638,woman play young boy park,woman kiss play park,3.200000047683716,0.6353799625094114,3676,3079,597,356409
1639,dog emerge form water stick mouth,dog run camera stick mouth,2.400000095367432,0.5110320128627169,2735,2232,503,253009
1640,dog play snow,boy play sand,0.800000011920929,0.24840896316659017,1161,786,375,140625
1641,dog carry leash mouth,fluffy dog carry black leash mouth,4.199999809265137,0.7890555593053182,4793,4708,85,7225
1642,man jean play ball woman jeans stand nearby look away,man tie red arm band man arm street,0.0,0.06267880670405178,418,335,83,6889
1643,sky fall snow,sky fall face snow,4.0,0.8908283429774461,5371,4587,784,614656
1644,dog red toy mouth,brown dog carry stick mouth,2.200000047683716,0.39108201318860447,1942,2056,-114,12996
1645,hockey player fight ice,hockey player struggle ice,4.800000190734863,0.7626670729601958,4616,5382,-766,586756
1646,barrier play wood floor home,supply play red chew toy field,1.600000023841858,0.08788205874699795,475,1476,-1001,1002001
1647,dog run field,dog play field,4.199999809265137,0.6913670255834917,4076,4725,-649,421201
1648,man gray suit lock bicycle,man woman stand city street,0.4000000059604645,0.07546751071924102,438,459,-21,441
1649,man black leather jacket sleep subway car,man black leather jacket fall asleep public transportation,4.599999904632568,0.45217176941266524,2316,5297,-2981,8886361
1650,dog leap hardly,dog leap hardly,4.800000190734863,1.0,5698,5390,308,94864
1651,man set electronic equipment,dog wrest ground snow,0.0,0.0,65,343,-278,77284
1652,black dog walk grass stick mouth,boy hold net snake close ground,0.0,0.0,63,313,-250,62500
1653,girl run dog dry field,grey dog dog play grassy field,2.200000047683716,0.3459228524524476,1689,2047,-358,128164
1654,dog play snow,black dog snow,4.0,0.7020029135570309,4149,4620,-471,221841
1655,dog leap dock water,black dog leap dock water,4.0,0.9424500338589212,5537,4614,923,851929
1656,group old man walk street,couple walk street,2.0,0.505467279915716,2698,1935,763,582169
1657,dog stand snow blue fence,dog play shallow rocky shore,2.200000047683716,0.08771620745097455,474,2044,-1570,2464900
1658,black white dog run field,black white dog run grass,4.800000190734863,0.7112378109509142,4230,5370,-1140,1299600
1659,boy black wave arm people field,man black shirt roller blaze past bench city,0.4000000059604645,0.08309234051031694,456,482,-26,676
1660,elderly woman ride bicycle city street,elderly woman walk uphill cross street,2.0,0.45357530768204024,2328,1950,378,142884
1661,young boy munch yellow ball,small dog jump yellow beam,0.4000000059604645,0.20633633403276802,1009,474,535,286225
1662,group young ballerina dance studio,group young lady bikinis,1.399999976158142,0.2570986229339693,1209,1336,-127,16129
1663,young boy white dress shirt play grassy plain,woman get hair salon,0.0,0.0,60,315,-255,65025
1664,man dog play tug war,man dance colourful wall,0.4000000059604645,0.07389070755509927,436,479,-43,1849
1665,wet child shiver towel pool,wet child shiver towel pool,4.599999904632568,1.0,5693,5289,404,163216
1666,white dog run beach,white dog run beach,5.0,1.0,5678,5548,130,16900
1667,dog run sandy beach,dog walk beach,3.400000095367432,0.475706714279,2489,3627,-1138,1295044
1668,man hold handle water,man hold candle air,3.200000047683716,0.293549377419572,1385,3105,-1720,2958400
1669,white dog walk snow,black dog walk snow,3.0,0.7866546870101707,4765,2942,1823,3323329
1670,white brown dog run grass,dog run grass,3.200000047683716,0.77185890891761,4662,3111,1551,2405601
1671,boy go inflammable slide,boy red side inflammable ride,3.799999952316284,0.6832166815064762,4012,4155,-143,20449
1672,dog play ball puddle,dog stand puddle yellow tennis ball,3.799999952316284,0.6741306063339866,3943,4156,-213,45369
1673,dog play water,dog run snow,1.399999976158142,0.24387833095077505,1141,1334,-193,37249
1674,dog play snow,kiss play dog,1.2000000476837158,0.4874832597945896,2563,1108,1455,2117025
1675,girl bend beach,girl bend beach,4.800000190734863,1.0,5679,5361,318,101124
1676,dog play fetch snow,dog play grass,2.200000047683716,0.3648413706125634,1776,1976,-200,40000
1677,suffer ride small wave,suffer perform trick wave,3.5999999046325684,0.5542616373389919,3067,3958,-891,793881
1678,people walk beach sunset,people walk shore sunset,5.0,0.7127333866920259,4239,5550,-1311,1718721
1679,supply play grass,dog wrest grass,4.0,0.29787132867051563,1416,4607,-3191,10182481
1680,young girl sit santa lap,little girl sit santa lap,4.800000190734863,0.8549451350553466,5186,5350,-164,26896
1681,black white dog run mouth open,black white dog swim blue water,2.200000047683716,0.37302262713286444,1832,1972,-140,19600
1682,young boy jump air beach,boy jump air beach,4.800000190734863,0.9018975794495862,5418,5396,22,484
1683,man tuxedo walk step,man tuxedo walk set step,5.0,0.9095340944862778,5443,5554,-111,12321
1684,red short white shirt kick soccer ball,black dog stand surf hold red rubber ball,0.0,0.2031244883011316,994,322,672,451584
1685,man dog rocky seashore,dog stand rock water,4.800000190734863,0.11818432849340198,638,5458,-4820,23232400
1686,grown dog splash water,dog splash water,2.400000095367432,0.789920599045394,4797,2269,2528,6390784
1687,smile woman beach bury seated,girl cowboy hat sheep leash,1.0,0.0,16,899,-883,779689
1688,dog big ear hold small stick mouth,puppy big ear chew stick,3.799999952316284,0.5272482899974773,2838,4158,-1320,1742400
1689,large brown dog jump tall grass,girl wear blue shirt run science center,0.0,0.0,15,311,-296,87616
1690,dog fight snow,dog play snow,2.5999999046325684,0.6167772177493719,3542,2398,1144,1308736
1691,brown dog middle line dog chase dirty tennis ball dirt,white dog brown dog chase ball,2.799999952316284,0.6149488359048181,3522,2691,831,690561
1692,grey hound active grassy field,bunch bite race track,0.0,0.0,310,327,-17,289
1693,people race sidecar motorcycle mud,dog carry long stick mouth,0.0,0.0,14,328,-314,98596
1694,man sit rocky mountain,person stick head tent mountain,2.400000095367432,0.27125735831057557,1289,2274,-985,970225
1695,man stand boat pull boat close bamboo stick,man black hat standing brick wall sign,0.0,0.03642028880217168,408,341,67,4489
1696,man play white guitar,man play white guitar singing,3.200000047683716,0.7731231091187443,4673,3187,1486,2208196
1697,person skijore dog mountain,brown dog play ball water,0.0,0.10946585151485141,593,340,253,64009
1698,shortness young people play water,lot people play water beach,2.400000095367432,0.4206674433326717,2129,2304,-175,30625
1699,close hummingbird,close hummingbird flying,3.5999999046325684,0.7419373375236042,4472,3942,530,280900
1700,woman black dress walk street,woman watch dog jump stair,0.800000011920929,0.0917005508799815,493,872,-379,143641
1701,man woman look camera,man woman laugh,2.3299999237060547,0.2935563480505744,1386,2166,-780,608400
1702,brown dog run dirty muddy grass,large brown dog run outside dirt,3.5999999046325684,0.3131437111769936,1500,3944,-2444,5973136
1703,dog pull man bicycle snow,dog pull man type bike snow,5.0,0.5883593909371752,3305,5505,-2200,4840000
1704,baby red hat sit strolled hold doll,man gray shirt sit field flower,0.0,0.09229521450334313,497,337,160,25600
1705,child play hay outdoor throw camera lens,young child play hay throw camera,4.800000190734863,0.7006967042012615,4137,5478,-1341,1798281
1706,climber stand rock face pink rope,child run snow fence background,0.0,0.0,10,330,-320,102400
1707,black dog wear orange collar entangle fishing wire,black dog wear red collar shake water,1.7999999523162842,0.41804418302782015,2116,1755,361,130321
1708,dog play dirt,dancer lose camera red white dress,0.0,0.0,9,329,-320,102400
1709,golden dog run grass,large beige dog run grass,3.400000095367432,0.44823080700186785,2297,3518,-1221,1490841
1710,dog run grass,dog run grass,4.800000190734863,1.0,5685,5473,212,44944
1711,man red short walk rock river carry stick,man walk rock water flow,3.400000095367432,0.36566427256790796,1783,3521,-1738,3020644
1712,rowing boat,man trick skateboard,0.0,0.0,8,308,-300,90000
1713,dog run racetrack,dog round bend racetrack,4.800000190734863,0.5902938616350787,3326,5467,-2141,4583881
1714,black brown dog walk snow near building,old man stand outside old board building,0.800000011920929,0.14876096780123427,776,758,18,324
1715,dog jump swimming pool duck,dog jump swimming pool,3.400000095367432,0.8173757062309605,4971,3540,1431,2047761
1716,dog run forest winter time,dog run lot twig,3.200000047683716,0.20126677446812374,989,3180,-2191,4800481
1717,girl play image big screen,girl hold umbrella back camera,0.4000000059604645,0.13327713601101976,709,571,138,19044
1718,people run race street,puppy run street,1.0,0.48100219537559585,2519,1008,1511,2283121
1719,man swimming trunk stand rock,man gray shirt limb large rock wall,1.0,0.2325643761425957,1100,1018,82,6724
1720,white dog walk snow,dog black collar barking snow,2.0,0.34178980073232607,1666,1893,-227,51529
1721,woman wear pink shirt jump air arm leg spread side,man wear suspend sunglasse leap air arm leg spread,2.400000095367432,0.5480531567197761,3012,2278,734,538756
1722,dog run grass,dog run brush,2.799999952316284,0.43916442603353445,2241,2722,-481,231361
1723,dog run sand,dog run water,2.799999952316284,0.5035832511089007,2683,2655,28,784
1724,woman attempt ride small wave,man woman sit outside sun,0.0,0.08936229391800528,481,272,209,43681
1725,black white dog swim river,black man dog beach,0.6000000238418579,0.33606067229029324,1631,678,953,908209
1726,standing jagged rock near ocean,man stand rock overlook ocean,4.599999904632568,0.37574876910145105,1854,5281,-3427,11744329
1727,girl black blue wet suit surge,woman wear black blue stripe suit surge wave,4.400000095367432,0.5774677869049196,3229,5010,-1781,3171961
1728,woman lead dog obstacle course,woman lead small dog obstacle course,4.599999904632568,0.9249580232334589,5497,5280,217,47089
1729,dog beach,dog walk beach,2.400000095367432,0.8116802409782032,4938,2275,2663,7091569
1730,young boy stand gray tile area,young boy practice rate grm,1.0,0.21592966949376022,1031,970,61,3721
1731,dog run food mouth,dog run yellow ball mouth,2.200000047683716,0.5812803124482908,3253,2123,1130,1276900
1732,dog run beach,dog run beach,4.800000190734863,1.0000000000000002,5720,5446,274,75076
1733,black white dog swim pool,black white dog run mouth,2.0,0.4407646068141474,2253,1894,359,128881
1734,dog head inside red green gift bag,pet playfully investigate content gift bag,3.799999952316284,0.389866116207492,1938,4162,-2224,4946176
1735,yellow skirt man wear golden sun mask,man yellow shirt wear gold sun shape mask,5.0,0.5619725542224115,3113,5524,-2411,5812921
1736,man call sheer rock face rope support,young man ski jump purple board,0.4000000059604645,0.048697970240243624,410,545,-135,18225
1737,child hand head,little boy stand hand head,4.199999809265137,0.570787418578053,3185,4763,-1578,2490084
1738,man wear orange vest can blue water,man orange jacket raise hand sky sand,1.7999999523162842,0.22755045804638213,1074,1714,-640,409600
1739,old man black trench coat stand marketplace,baby wear red shirt walk place,1.2000000476837158,0.0,5,1139,-1134,1285956
1740,man climb cliff face,man limb sheer cliff face,4.800000190734863,0.5253026070980386,2825,5437,-2612,6822544
1741,girl panama part appear dance,girl baseball cap eat snack outside,0.6000000238418579,0.09872139118831263,524,719,-195,38025
1742,white brown dog play black toy,white brown dog play tug o war,3.400000095367432,0.48670753183882276,2552,3527,-975,950625
1743,boy play baseball,man play baseball,3.0,0.818800247098305,4977,2941,2036,4145296
1744,boy wear red shirt run grass furry dog,sport fan wear face paint stand,0.0,0.11796259942438118,636,354,282,79524
1745,black dog retrieve snow,skateboarder jump street,0.0,0.0,4,365,-361,130321
1746,smile man baby girl lose photo,smile man hold small child wear pink red,3.200000047683716,0.2446349369723052,1145,3172,-2027,4108729
1747,dog jump frisbee snow,dog jump snow,3.200000047683716,0.7493231053218015,4523,3193,1330,1768900
1748,brown white dog pink collar bark brown dog blue collar snow,dog red collar bear tooth dog blue collar,3.400000095367432,0.591400684567267,3341,3640,-299,89401
1749,brown dog bite,brown dog bite sand,4.199999809265137,0.8090087793956574,4919,4739,180,32400
1750,skateboarder attempt trick low wall,boy skateboard trick railing,4.0,0.2140367358084122,1029,4526,-3497,12229009
1751,young girl lip water,young girl wear purple run water,2.799999952316284,0.4820254043132246,2522,2740,-218,47524
1752,snowboarder ride snowboard railing flight step,boy grind skateboard concrete wall,0.800000011920929,0.0,2,757,-755,570025
1753,woman man hat socialize outside,young woman knit cap stand wall coming dizzy,1.399999976158142,0.0535022437532019,413,1372,-959,919681
1754,small boy bathroom sit metal chair,boy robe sit chair,4.199999809265137,0.42320790696473576,2147,4744,-2597,6744409
1755,black dog run snow,black pit bull dog run dirt,2.200000047683716,0.4041280262593908,2032,2073,-41,1681
1756,group teenager dance wooden floor,group people dark color clothing line dancing wooden floor,3.400000095367432,0.37167739220595797,1820,3533,-1713,2934369
1757,young boy ride bike,young girl lay blue inflammable toy,0.4000000059604645,0.16858968547020037,862,511,351,123201
1758,black dog run snow,black dog run beach,1.7999999523162842,0.6314671636848248,3648,1654,1994,3976036
1759,dog snow fence,dog drink water lake,1.0,0.13659484019294416,727,956,-229,52441
1760,girl run river bank black dog,little boy pet tiger lay,0.2000000029802322,0.0,36,417,-381,145161
1761,teenage girl run beach shouting old man walk,young child run shore beach,1.7999999523162842,0.25808312462916694,1215,1658,-443,196249
1762,brown white dog walk man skateboard,blood child lay branch tree green field,0.0,0.0,20,98,-78,6084
1763,ride surfboard wave,man black surfboard ride wave,4.0,0.9042763943553903,5430,4547,883,779689
1764,man red shirt climb mountain,man climb mountain,4.199999809265137,0.7933111354280018,4819,4747,72,5184
1765,man ride motorcycle wear black uniform,white motorcycle ride race track,1.399999976158142,0.37988803745813865,1882,1369,513,263169
1766,black dog swim river,black dog dig snow,1.2000000476837158,0.2890348057563365,1367,1114,253,64009
1767,man woman smile,man woman laugh,3.200000047683716,0.3422750956328844,1671,3206,-1535,2356225
1768,man stand rock mountain watch sun set,man stand mountain watch sunset,4.800000190734863,0.5644901248291324,3139,5431,-2292,5253264
1769,little girl play trampling,little boy play playground,1.399999976158142,0.38377258279990567,1904,1365,539,290521
1770,girl jump high air,dog muscle grass near lake,0.2000000029802322,0.0,35,408,-373,139129
1771,woman hold black purse smoke cigarette,woman black bag smoke cigarette,4.800000190734863,0.6931582569685617,4088,5358,-1270,1612900
1772,dog run grass,brown dog run grass,4.199999809265137,0.8462242287941113,5141,4750,391,152881
1773,man long hair look camera,woman stand wall near video camera,1.0,0.19396603616500455,962,940,22,484
1774,grown dog run grass,dog run grass,4.0,0.7344430114919336,4415,4565,-150,22500
1775,people wear hat sit look camera,man wear blue shirt make crouch face,0.0,0.1450204666847923,756,85,671,450241
1776,girl play people flower,young girl wear skirt play garden,3.200000047683716,0.2618397228786387,1236,3202,-1966,3865156
1777,girl pink shirt sprawl limb impair,man dress santa suit climb large concrete building,0.0,0.0,33,99,-66,4356
1778,little girl red shirt pull kite,girl red shirt take picture phone,1.399999976158142,0.4342613373653653,2212,1358,854,729316
1779,child slide snow,sleeping street,0.0,0.0,32,72,-40,1600
1780,dog play water,dog swim water,4.199999809265137,0.5740221594638913,3205,4755,-1550,2402500
1781,white dog run sand,white dog run sand,5.0,1.0000000000000002,5719,5539,180,32400
1782,little girl hand air sit man lay blanket,kid run opposite direction play game,0.2000000029802322,0.0,31,421,-390,152100
1783,red white race car race dirt racetrack,person ride dirt bike race dirt track,1.399999976158142,0.48807963376088176,2569,1356,1213,1471369
1784,black white dog run cow field,large black white dog run ocean water,2.200000047683716,0.4782265146084346,2503,2102,401,160801
1785,man straw hat shade phone walk busy sidewalk,man lie street head shoulder marked car pack,0.6000000238418579,0.030136859906299353,407,665,-258,66564
1786,man messenger bag gray tile wall,red jacket stand lighthorse,0.800000011920929,0.0,23,825,-802,643204
1787,dog swim water,dog swim water,3.200000047683716,1.0,5690,3198,2492,6210064
1788,little white curly haired dog run pavement stick mouth,white curly haired dog run stick mouth,4.599999904632568,0.8423284754017507,5116,5312,-196,38416
1789,blonde woman wear black american flag tartar cap,red haired woman wear black beset adorn american flag,2.799999952316284,0.4221411243232978,2137,2734,-597,356409
1790,person hold net stand water,black woman black child sit thatched tent,0.6000000238418579,0.0,21,690,-669,447561
1791,woman red tracksuit squeeze lemon press,young woman pink hood take picture,0.4000000059604645,0.056728538107988905,414,558,-144,20736
1792,man walk dog leash street,man walk dog city,4.199999809265137,0.47497938339349055,2486,4759,-2273,5166529
1793,dog run snow,dog run dirt,2.200000047683716,0.49134463560696784,2595,2095,500,250000
1794,small boy play snow,brown white dog play snow,1.600000023841858,0.470089846675233,2452,1563,889,790321
1795,woman blue shirt short sit table,smile young woman tourquoise shirt banana pose table outdoor,3.200000047683716,0.30494792847851815,1450,3196,-1746,3048516
1796,white dog run snow,dog run snow,3.200000047683716,0.8821612540905137,5334,3171,2163,4678569
1797,black dog run snow,race car driver drive car mud,0.0,0.0,77,129,-52,2704
1798,dog wear green sweeter backpack walk snow,small dog wear green sweeter backpack walk snow,4.400000095367432,0.9519708910791215,5556,5016,540,291600
1799,group people sit desk,group girl beach,0.6000000238418579,0.2663144410158387,1266,684,582,338724
1800,dog run field,dog run grassy field,2.799999952316284,0.7770447885032492,4701,2672,2029,4116841
1801,man woman hand chin stand christmas tree,man white beard blue cap stand doorway workshop,0.4000000059604645,0.11243714933341653,612,562,50,2500
1802,black white dog stick paw,black dog white dog stand snow,1.2000000476837158,0.45728817085822054,2353,1124,1229,1510441
1803,white dog run snow,black white dog run grass,1.399999976158142,0.5758246802758121,3217,1349,1868,3489424
1804,man skin snow cover hill mountain background,dog enjoy rome water mountain sand background,0.6000000238418579,0.2938790859904215,1390,683,707,499849
1805,man bike nest river,man bike high jump,1.2000000476837158,0.36336616701224067,1771,1145,626,391876
1806,sky go snowy hill,brown dog lay snow,0.4000000059604645,0.0,125,526,-401,160801
1807,dog run grass,dog run dirt,3.5999999046325684,0.4887918902356597,2575,3953,-1378,1898884
1808,man spray fluid long beach,guy sit bike wheel air,0.6000000238418579,0.0,123,693,-570,324900
1809,person red vest touch blue ice state person,lady fasten ice state snow,2.200000047683716,0.2537306434184381,1193,2129,-936,876096
1810,girl ounce upside head trampling,girl bound head trampling,4.800000190734863,0.5293369692054009,2854,5420,-2566,6584356
1811,woman stand tree smile,man walk tree city skyline,2.0,0.2509462709918721,1177,1954,-777,603729
1812,boy lip swimming pool,boy wear red blue swim trunk jump head swimming pool,2.400000095367432,0.4496422130201962,2301,2300,1,1
1813,little boy cover bubble,child stand pool cover foam bubble,4.199999809265137,0.5262376110648463,2831,4757,-1926,3709476
1814,boy look girl girl ignore,boy diving pool couple watch,0.2000000029802322,0.10951218460545309,595,383,212,44944
1815,black dog blue collar run snow,black dog red collar play snow,3.200000047683716,0.7192070021075063,4293,3143,1150,1322500
1816,bird sit tree,bird sit leaflet tree,3.799999952316284,0.7591281737818517,4593,4169,424,179776
1817,brown dog chess orange ball,dog orange ball mouth,4.0,0.5818011553907145,3258,4680,-1422,2022084
1818,brown dog jump air catch ball,young woman jump air catch ball,0.6000000238418579,0.7665175433514564,4639,668,3971,15768841
1819,child walk picnic table,boy hope picnic table park,3.200000047683716,0.578833313551603,3237,3142,95,9025
1820,dog snow,dog snow,3.0,1.0,5635,3007,2628,6906384
1821,salvation run beach,salvation run beach,4.800000190734863,1.0,5592,5460,132,17424
1822,dog run snow,dog run snow,5.0,1.0000000000000002,5718,5496,222,49284
1823,black dog run grass,dog run grassy field,2.0,0.3699584670179935,1807,1963,-156,24336
1824,man red black hit soccer ball head,man red stripe soccer shirt head ball,3.5999999046325684,0.6623697640369415,3867,3951,-84,7056
1825,brown dog walk grass,dog case tree,1.2000000476837158,0.16820892674147217,857,1140,-283,80089
1826,woman place baby skateboard beach,woman hold small baby skateboard beach,4.599999904632568,0.7428563403793453,4478,5223,-745,555025
1827,black dog bite light brown dog ear playful manner,black dog playfully bit dog living room set,4.0,0.21300058821275003,1022,4677,-3655,13359025
1828,eagle walk beach watering,eagle walk calm shore,4.400000095367432,0.43677857489730854,2226,4963,-2737,7491169
1829,black white dog run grass,black white dog run grass,5.0,1.0,5596,5537,59,3481
1830,dog run snow tennis ball,boy stung air bicycle,0.0,0.0,151,105,46,2116
1831,black dog walk grass stick mouth,black dog run grass toy mouth,3.200000047683716,0.6160497498720102,3532,3132,400,160000
1832,man walk policeman stand crossway city street,policeman stand crossway city,3.0,0.8554521394283243,5193,3064,2129,4532641
1833,black dog white dog play street,black dog white dog play street,4.599999904632568,1.0,5599,5201,398,158404
1834,large black white dog swim water,black white dog stick muddy water,3.5999999046325684,0.46651457086183923,2424,3950,-1526,2328676
1835,little boy clown commander head,boy metal commander head,4.199999809265137,0.5767888309946795,3223,4751,-1528,2334784
1836,construction worker sit beam take break,man put shirt near elevator,0.0,0.0,145,104,41,1681
1837,man woman laugh,man woman kiss,1.2000000476837158,0.33821839612308213,1646,1120,526,276676
1838,black brown white dog run field,white brown dog run field,2.8299999237060547,0.9208522439592656,5486,2752,2734,7474756
1839,child play swimming pool adult man watch,child play pool adult look,4.599999904632568,0.7084312296755999,4206,5204,-998,996004
1840,kiss splash water,dog play bed,0.0,0.0,140,29,111,12321
1841,brown white dog walk shallow water,white brown dog appear walk water,4.599999904632568,0.6540831975978709,3810,5205,-1395,1946025
1842,woman read public transportation,man fall asleep public transportation,1.600000023841858,0.5346311737419465,2911,1587,1324,1752976
1843,bulldog run grassy park people stand background,dog run large body water cause splash,1.7999999523162842,0.08262267924172469,453,1665,-1212,1468944
1844,young boy ride bike brick road,person trick bike camp surround tree,2.200000047683716,0.1633545428699669,832,1992,-1160,1345600
1845,young man skateboard state park,boy blue t shirt airborne skateboard state park,3.799999952316284,0.5592955052312171,3094,4142,-1048,1098304
1846,girl jump rope sidewalk near parking garage,girl jump rope sidewalk parking garage left,4.400000095367432,0.8560891998023298,5198,4975,223,49729
1847,person water beach sun set,person surfboard water,3.0,0.33750067025189,1642,3070,-1428,2039184
1848,dog jump impair catch frisbee,brown dog jump pink frisbee,4.0,0.5098284180857192,2724,4644,-1920,3686400
1849,dog return play toy master,dog race snow,1.0,0.12494581110009209,676,998,-322,103684
1850,female jump swing,girl jump swing,4.599999904632568,0.6716107390038817,3930,5206,-1276,1628176
1851,woman young girl pose bear statue store,man jersey stand large crowd,0.6000000238418579,0.0,117,723,-606,367236
1852,shortness man play football lawn,shortness man catch football,4.400000095367432,0.6594032659715217,3847,5015,-1168,1364224
1853,girl wear green twist hand,young boy wear green short pose awkwardly brick background,0.800000011920929,0.23025498459064678,1089,765,324,104976
1854,man red jacket hold bike picture,woman red jacket video take natural landscape,0.4000000059604645,0.3275581980234601,1579,575,1004,1008016
1855,boy jump crowded public pool,man jump snowboard,0.800000011920929,0.18684658203527377,936,763,173,29929
1856,clown strike pose camera,child orange brodie board wave,0.6000000238418579,0.0,144,700,-556,309136
1857,kiss hold hand jump swimming pool,dog play snow,0.0,0.0,116,16,100,10000
1858,boy push wagon tompkin,child squat wagon tompkin,2.799999952316284,0.6338801532368452,3663,2704,959,919681
1859,soccer player battle ball intense match,little orange white dog snow,0.0,0.0,92,10,82,6724
1860,black dog walk tall grass,black dog run grass,3.799999952316284,0.570854684820641,3186,4111,-925,855625
1861,black dog play snow,black dog dig snow,3.400000095367432,0.6338652393791377,3662,3428,234,54756
1862,dog jump chain,dog leap chain,5.0,0.6140257507541133,3518,5511,-1993,3972049
1863,girl black purse sit wooden bench,young woman black purse sit wooden bench,4.599999904632568,0.864103491078846,5242,5207,35,1225
1864,black yellow dog,black dog brown white dog play field,2.200000047683716,0.44983941589899235,2302,2053,249,62001
1865,child ball pit,child play ball pit,3.400000095367432,0.9282923996245398,5508,3465,2043,4173849
1866,large white grey dog run yellow tunnel obstacle course,white black dog run yellow orange tube,3.5999999046325684,0.3370744371173472,1639,3940,-2301,5294601
1867,swimmer backstroke swimming pool,person stroke swimming pool,4.800000190734863,0.42117801623333856,2132,5369,-3237,10478169
1868,man stand astride bike rocky trail lake,woman wear white headband purple tank black glove,0.0,0.0,90,9,81,6561
1869,brown dog run green grass,brown dog run river,2.400000095367432,0.5480394170162085,3011,2289,722,521284
1870,small white dog large brown dog play grass,small light dog run past large brown dog stand grass,3.400000095367432,0.6869799884623655,4039,3475,564,318096
1871,woman hold dog dog stand nearby field,lady hold dog dog play yard,3.400000095367432,0.4079482588116625,2052,3474,-1422,2022084
1872,black dog walk water,black dog walk snow,2.400000095367432,0.6896785249905831,4066,2288,1778,3161284
1873,black dog run snow,black dog swim ball mouth,1.7999999523162842,0.3122428304857231,1494,1684,-190,36100
1874,woman dress green play dog,dog lick girl hand lay,1.600000023841858,0.10905849751438967,585,1580,-995,990025
1875,homeless man stand outside cardboard sign,homeless young man hold cardboard sign,4.599999904632568,0.7702498070651631,4657,5210,-553,305809
1876,brown dog wage water,dog splash murky water,3.5999999046325684,0.2657790579887213,1262,3939,-2677,7166329
1877,man orange shirt wear white helmet ride bike,man wear blue helmet ride molar,2.799999952316284,0.4923337464707803,2600,2709,-109,11881
1878,little boy stand wedding party laugh,person stand stage seated crowd,1.7999999523162842,0.09767251032652292,518,1715,-1197,1432809
1879,person snowmobile,person snowmobile mid jump,3.5999999046325684,0.7400068111362739,4454,3938,516,266256
1880,man stand shore hit ball paddle,teenage girl stand beach listen good,0.800000011920929,0.09337293844657886,501,760,-259,67081
1881,photo show man take break,person swim cap gorge take breath,0.4000000059604645,0.0,86,586,-500,250000
1882,brown dog run sand,brown dog run sand,4.599999904632568,1.0,5601,5211,390,152100
1883,black dog chase red frisbee,black people run snow,1.399999976158142,0.15782573917464712,810,1275,-465,216225
1884,girl ponytail ride amusement park ride,young girl ride amusement park,3.0,0.7635268315435461,4621,3036,1585,2512225
1885,dog dig sand,brown dog dig sand,4.199999809265137,0.9078360408650942,5437,4775,662,438244
1886,man sit sidewalk store,woman bathing suit walk dog beach,0.0,0.0,95,6,89,7921
1887,black white spot dog jump stream,black white spot dog jump small stream water,4.599999904632568,0.8902908433355868,5364,5213,151,22801
1888,person box bike,man bike mid air,3.0,0.3163561060816466,1518,3033,-1515,2295225
1889,dog run tall grass,dog run grassy area,4.599999904632568,0.29410866156423315,1392,5214,-3822,14607684
1890,little white dog wear leash jump red ball,black white dog return stick snow,1.0,0.1743077337778965,890,1037,-147,21609
1891,group people stand outside building,large group people form line outside,3.200000047683716,0.5149124836038801,2760,3175,-415,172225
1892,group child dance backward,group child stretch colored mat,1.600000023841858,0.27451863807429777,1304,1575,-271,73441
1893,group teenager jump air beach,group young people jump air beach,4.800000190734863,0.6982106327885346,4120,5439,-1319,1739761
1894,boy wave sparkle,young boy twist sparkle air,4.400000095367432,0.5417946407965535,2969,5088,-2119,4490161
1895,people sit fire night,group people stand sit ground night,2.5999999046325684,0.690587467050759,4070,2444,1626,2643876
1896,different breed brown white dog play beach,dog play sand beach,4.0,0.4001844924225293,2005,4631,-2626,6895876
1897,man woman dress empire costume,man woman dress costume,3.400000095367432,0.8251717618120282,5015,3638,1377,1896129
1898,boy wear hat playground,boy hat laugh sit near playground equipment,2.400000095367432,0.6085454703708195,3474,2227,1247,1555009
1899,dog play snow,dog play snow,5.0,1.0000000000000002,5722,5525,197,38809
1900,woman hold baby man look man hold child watch,woman stand arm store woman hold camera,0.4000000059604645,0.31405172548377575,1505,464,1041,1083681
1901,white fluffy dog run pure white snow,fluffy white dog run snow,4.599999904632568,0.8261684983256565,5018,5218,-200,40000
1902,woman hold newspaper,man rollerblade metal bar,0.0,0.0,112,31,81,6561
1903,group man play brass instrument,group gun play instrument outside,3.400000095367432,0.5343563792470261,2909,3643,-734,538756
1904,girl shore watch people boat fish,male red white play basketball game,0.0,0.0,111,32,79,6241
1905,snowboarder jump air,snowboarder fly air,4.0,0.7490354686513094,4519,4667,-148,21904
1906,white dog red ear run snow,wet black dog red collar river,0.6000000238418579,0.20806859402071887,1012,714,298,88804
1907,little girl little boy hold hand shiny slide,little girl aisle dress run sandy playground,0.4000000059604645,0.26762251316783936,1271,469,802,643204
1908,lid play soccer field,boy play soccer field,4.199999809265137,0.6725586318083249,3936,4723,-787,619369
1909,man jump rooftop,young man jump balcony,2.799999952316284,0.29292068772850643,1382,2718,-1336,1784896
1910,child pull sit red wagon sand,young boy pull boy wear silly hat radio ulcer wagon,3.400000095367432,0.31794325162642734,1528,3646,-2118,4485924
1911,owl wing widespread day,bird wing spread fly,2.400000095367432,0.26613430290801676,1263,2242,-979,958441
1912,man blue cap sit stool tree,dog stand beach ball nearby,0.0,0.0,110,64,46,2116
1913,woman sing microphone guy play guitar,woman sing microphone guitar player background,4.400000095367432,0.6706199203344131,3925,5081,-1156,1336336
1914,sheep graze grassy field dog walk,small group goat grass black white dog background,2.799999952316284,0.06812938713794074,425,2713,-2288,5234944
1915,cycling make bike jump rock,man jump bicycle air rock,4.400000095367432,0.37243188918816766,1827,5080,-3253,10582009
1916,young girl pink hat yellow building background,young girl pink dress hand,1.7999999523162842,0.4760676970234398,2494,1686,808,652864
1917,girl pink dress ride bike white picket fence,girl red dress ride bike white fence,4.0,0.7208543154173107,4302,4678,-376,141376
1918,brown furry animal stand plant,dog part stand wood,1.399999976158142,0.16477936306155153,841,1282,-441,194481
1919,child red shirt black wake board splash beach wave,man rowboat row blue water,1.0,0.0,102,929,-827,683929
1920,white dog run field,brown white dog run field,3.400000095367432,0.8714398177854505,5280,3632,1648,2715904
1921,teenage girl smile,little girl kid swing,0.800000011920929,0.1595904814690132,817,882,-65,4225
1922,bird interesting grass,dog play outdoor,0.2000000029802322,0.0,100,434,-334,111556
1923,stand snowy mountain,mountain limber stand mountain look,3.400000095367432,0.5793560727806197,3244,3623,-379,143641
1924,child field red flower,kiss play field red flower,4.800000190734863,0.710668391437505,4224,5444,-1220,1488400
1925,young man jump rock lake,young man red swimming trunk jump large rock water,4.0,0.49761127484779594,2646,4684,-2038,4153444
1926,small black dog grass,black dog run grass,3.5999999046325684,0.730870241589788,4378,3956,422,178084
1927,lady dress simon look camera,girl dress black sit room make suggestive pose camera,1.0,0.26320802325827297,1245,1035,210,44100
1928,group people fire hot air balloon,large group people ride brown white horse,0.0,0.2572237603813968,1210,61,1149,1320201
1929,child play fight sword,child parent pet horse,0.0,0.17665148059248564,898,60,838,702244
1930,man wind sail ocean,dog run ocean,1.399999976158142,0.40433648425679114,2035,1290,745,555025
1931,dog race dirt track,war race dirt track,1.399999976158142,0.8346286548683473,5076,1314,3762,14152644
1932,people hold hand walk field,man walk past murat car,1.2000000476837158,0.15923219744525324,816,1144,-328,107584
1933,brown dog case frisbee,brown dog squat grass,1.600000023841858,0.3066427705264858,1464,1520,-56,3136
1934,woman red overall stand sidewalk,woman red overall stand sidewalk,5.0,1.0,5591,5521,70,4900
1935,dog run backward leave,dog run field,2.799999952316284,0.3943813778652889,1963,2733,-770,592900
1936,supply play grass,supply play grass,5.0,1.0,5595,5518,77,5929
1937,black white dog play outside,child black dog play snow,1.0,0.4905890680765497,2590,1048,1542,2377764
1938,dog run water,black dog run water,1.0,0.8667954324426628,5250,1049,4201,17648401
1939,woman sit brick wall,woman walk red bag,1.2000000476837158,0.10753353130501893,573,1138,-565,319225
1940,brown dog carry stick mouth,dog swim stick mouth,2.5999999046325684,0.646954170531313,3764,2510,1254,1572516
1941,young woman mean plate meal,young woman hopeless paint mud,0.800000011920929,0.18514669581577575,930,837,93,8649
1942,person limb snowy hill dog follow,person limb snowy hill black dog follow,3.799999952316284,0.9604443372943131,5570,4119,1451,2105401
1943,brown dog sit beach,dog run beach,2.0,0.5948709073206998,3373,1786,1587,2518569
1944,cuba river submerge water,cuba river underwater,5.0,0.5002199777046026,2658,5516,-2858,8168164
1945,man ride bike dirt hill,trick bicycling grind handrail,1.7999999523162842,0.0,380,1712,-1332,1774224
1946,large gray dog play deep snow,dog play snow,2.5999999046325684,0.5719852673372774,3195,2525,670,448900
1947,man ride bike beach ocean,man walk cow road,0.800000011920929,0.08565027870580981,468,835,-367,134689
1948,dog car,dog bite mop,1.0,0.18997998862596113,947,1026,-79,6241
1949,dog floppy ear walk camera wood,child reflection turn camera smile,1.2000000476837158,0.13608078631714307,724,1128,-404,163216
1950,brown dog splash water shake water,white dog stand river shake dry,2.400000095367432,0.3095284758410573,1478,2236,-758,574564
1951,black white dog run beach,black brown dog run snow,1.7999999523162842,0.5017781755011558,2671,1699,972,944784
1952,middle eastern people sit blue truck,group people ride truck,3.400000095367432,0.41576846603202205,2105,3657,-1552,2408704
1953,person ski pole skin snowy hill,person skin snowy hill,4.199999809265137,0.7684297308442325,4648,4727,-79,6241
1954,woman eat fish restaurant,woman eat large fish restaurant,4.599999904632568,0.9143347132945918,5461,5195,266,70756
1955,child dog play water,child red blue float look water,2.200000047683716,0.40822957117474323,2053,2126,-73,5329
1956,skateboarder trick stone wall,skateboarder ride slope,2.200000047683716,0.3199710195177411,1539,2138,-599,358801
1957,people stand escalator move,people ride escalator,4.599999904632568,0.8003186099670292,4866,5176,-310,96100
1958,lady run dog agility course,trainer run dog training course green pipe,4.199999809265137,0.34326687952421436,1675,4714,-3039,9235521
1959,white brown dog shake ear,brown dog run sand,1.399999976158142,0.3062883931758044,1462,1311,151,22801
1960,child raise hand clapping,child play soccer sand,0.2000000029802322,0.16703671407733886,852,391,461,212521
1961,man blow large bubble,man walk large black horse,0.0,0.28279787032400017,1340,54,1286,1653796
1962,people sit dock near water,people sit end dock middle water,3.799999952316284,0.7072022439242875,4192,4120,72,5184
1963,jockey goal keeper lay ice net,hockey player lay ice goal,4.599999904632568,0.4840567457621764,2535,5179,-2644,6990736
1964,sky wear blue snow part fly air near jump,sky stand hand snow movie camera,1.399999976158142,0.3227664538883005,1555,1309,246,60516
1965,brown dog run grassy pathway,brown dog run grassy stretch divide string,3.400000095367432,0.4456891540779856,2288,3565,-1277,1630729
1966,girl wear blue stripe shirt rollerblades,man wear black white shirt jump dog,0.0,0.32805438481419547,1581,51,1530,2340900
1967,tattooed man black play white guitar singing,woman black white coat earmuff,0.0,0.17790030459171685,904,270,634,401956
1968,dog run beach,boy girl run beach,1.399999976158142,0.6552694244263522,3820,1304,2516,6330256
1969,young man woman sit bench outside kiss,man woman sit bench kiss,4.599999904632568,0.8342804937612587,5072,5182,-110,12100
1970,brown dog jump catch green strap mouth,grey dog jump bite green leash,3.200000047683716,0.3021814983826433,1436,3134,-1698,2883204
1971,black dog run grass,black brown dog run grass,3.200000047683716,0.875026346538985,5304,3136,2168,4700224
1972,woman sit sidewalk cell phone ear,woman ride bicycle,0.5,0.10055642157640503,531,608,-77,5929
1973,dog play grassy field,kiss play field,1.2000000476837158,0.4938068993208384,2617,1125,1492,2226064
1974,young boy play red ball pit,laugh boy lie pit blue ball,3.0,0.5527233997448778,3056,2799,257,66049
1975,suffer wave,suffer ride wave,4.400000095367432,0.8853303630475242,5347,5108,239,57121
1976,skateboarder get camp,skateboarder ride pipe wall slater park,2.400000095367432,0.32589862557834587,1569,2229,-660,435600
1977,man running contest,dog race,1.0,0.0,322,1086,-764,583696
1978,kiss walk path wood,child walk path wood,5.0,0.7754448098505698,4690,5507,-817,667489
1979,brown white dog run grass,black dog run grass,3.400000095367432,0.6781550306582702,3979,3572,407,165649
1980,dog run grass,dog run grass,4.400000095367432,1.0,5639,5107,532,283024
1981,dog see red fire tyrant,dog print red fire tyrant,5.0,0.7881261690076277,4781,5506,-725,525625
1982,rugby player dark gear carry light colored rugby ball arm outstretche,brown dog splash water carry ball mouth,0.4000000059604645,0.1617535231836077,824,505,319,101761
1983,people walk water,girl walk tree brick building,1.2000000476837158,0.2315003417379461,1098,1132,-34,1156
1984,dog splash water,dog splash murky water,4.0,0.7497521747031298,4527,4382,145,21025
1985,group people walk sidewalk big city,group people ride truck,1.0,0.32044854076358464,1541,1087,454,206116
1986,dog air grass,dog lay bed blue sheet,1.0,0.12395845273133517,672,1066,-394,155236
1987,black dog run water,man football uniform run football game,0.0,0.12241727460147073,662,48,614,376996
1988,girl stand subway wait,girl stand dimly light area,2.0,0.2500385230730637,1171,1863,-692,478864
1989,man sit little girl park,man play shaggy little dog,0.6000000238418579,0.30413170691585056,1443,689,754,568516
1990,large dog run green item mouth,dog carry green squeaky toy mouth,4.400000095367432,0.3998900683732571,2003,5105,-3102,9622404
1991,group people boat race shore,classroom student watch presentation,0.0,0.0,360,47,313,97969
1992,person ride skateboard air camp,baker ride track element locate wooded area,0.6000000238418579,0.10265502849007743,544,682,-138,19044
1993,boy skateboard metal handrail night,brown dog run sand hold stick,0.0,0.0,355,46,309,95481
1994,person squeeze opening rock face,medium sized brown dog run open white wooded area,0.0,0.0,350,45,305,93025
1995,dog run camera ball mouth,black white dog swim brown object mouth,2.0,0.3107890988429002,1486,1870,-384,147456
1996,young girl run beach,little girl run shore beach,4.199999809265137,0.5952242718345495,3377,4793,-1416,2005056
1997,baseball player throw ball,basketball player hold ball,1.600000023841858,0.44211688716693204,2266,1545,721,519841
1998,man swinge rope water,man maroon bathing suit swing rope lake,3.0,0.2563402076980215,1206,2767,-1561,2436721
1999,young girl dress minnie mouse outfit old woman walk sidewalk,man wear white suit hold newspaper walk street,1.0,0.0805975716032136,451,973,-522,272484
2000,testimonial real health expert,testimonial real health expert,3.0,1.0,5636,2769,2867,8219689
2001,captain go,captain come,0.800000011920929,0.796274447803634,4838,869,3969,15752961
2002,problem simple,problem simple,3.799999952316284,1.0,5633,4125,1508,2274064
2003,negative reconnaissance requirement,pacific requirement,1.0,0.39463387715975073,1967,917,1050,1102500
2004,drop ask question s marx,move ask question s beef,0.4000000059604645,0.45811634997321016,2358,494,1864,3474496
2005,figure ask prove negative,ask prove negative,4.599999904632568,0.8706008312534016,5274,5187,87,7569
2006,medical use,medical use,5.0,1.0,5632,5530,102,10404
2007,price need go inflation,price asset go,2.0,0.38208809192670573,1895,1814,81,6561
2008,war middle east,war middle east,5.0,1.0,5630,5531,99,9801
2009,originally post vienna authoritarian,originally post zat,0.6000000238418579,0.45219026735884454,2317,688,1629,2653641
2010,imagine place white black,imagine place man woman,1.0,0.7813856902592304,4730,968,3762,14152644
2011,chance fair trial,chance fair trial,5.0,1.0000000000000002,5743,5559,184,33856
2012,nirvana different oblivion,nirvana oblivion,3.5999999046325684,0.8522675294666264,5174,3878,1296,1679616
2013,britain think differently americans,originally post zat britain think differently americans,4.0,0.7578367789639251,4581,4400,181,32761
2014,answer yes probably straight,answer yes probably straight,3.0999999046325684,1.0,5627,3075,2552,6512704
2015,earth combine produce food billion people,produce billion,2.200000047683716,0.5681522812393824,3169,2077,1092,1192464
2016,btw appropriate ferment time,appropriate ferment time eh,3.200000047683716,0.6991347461582138,4124,3203,921,848241
2017,key blue eyes thing london,smooth key blue eyes thing london,4.400000095367432,0.851891700425917,5169,5074,95,9025
2018,news broadcast see white,impact white,2.200000047683716,0.17762173915823465,902,2080,-1178,1387684
2019,accord girlfriend zimmerman,accord zimmerman,2.400000095367432,0.7449154549225075,4496,2258,2238,5008644
2020,parent tell bad,teacher tell bad,2.799999952316284,0.5831530975235125,3270,2727,543,294849
2021,slang term nswp,originally post veins eye slang term nswp,4.599999904632568,0.6967080414357324,4110,5194,-1084,1175056
2022,oppose death penalty,support death penalty,1.0,0.6380420217623167,3700,969,2731,7458361
2023,,aware,2.200000047683716,0.0,348,2084,-1736,3013696
2024,produce eat wear live,think thing eat wear live,2.200000047683716,0.6166581035055532,3540,2085,1455,2117025
2025,dickshot watt holiday own,watt holiday own,3.799999952316284,0.7729826494970771,4671,4127,544,295936
2026,people exploit law,people bent law,2.799999952316284,0.41751241944440787,2108,2705,-597,356409
2027,funny think thing path,think know path,2.200000047683716,0.5628869725538757,3124,2087,1037,1075369
2028,year keener keener right use lecture,year keener keener right wiggie,2.5999999046325684,0.762668555260539,4617,2485,2132,4545424
2029,prefix suffer hate news,stop refixe suffer hate news,3.0,0.5924927241632196,3355,2885,470,220900
2030,wood ask tiresome,wood ask tiresome question,4.800000190734863,0.8911726068528564,5376,5462,-86,7396
2031,make sense,make sense,1.399999976158142,1.0,5618,1293,4325,18705625
2032,expensive home,expensive car,1.2000000476837158,0.6814922980733885,3998,1146,2852,8133904
2033,martin say follow,zimmerman reply,0.800000011920929,0.0,352,838,-486,236196
2034,satellite intensity estimate tafb sab,subjective dvorak intensity estimate tafb sab increased,2.0,0.6694390621197569,3912,1824,2088,4359744
2035,fairy exist fine,water exist fine,1.2000000476837158,0.6517296467568866,3791,1135,2656,7054336
2036,anna know find curious,find curious,2.799999952316284,0.6616507940073185,3862,2661,1201,1442401
2037,compare home sexuality developmental disorder,compare home phobia developmental disorder,2.5999999046325684,0.7601984996745952,4606,2479,2127,4524129
2038,ask conservative number sew right,ask progressive number sew left,2.5999999046325684,0.5609057047133225,3106,2487,619,383161
2039,mention pfa post,mention restrain order,0.800000011920929,0.3865470588183304,1920,885,1035,1071225
2040,gambling rise king sole vessel fill wonder,eye tiger vessel fill wonder,2.400000095367432,0.38801374721939197,1928,2257,-329,108241
2041,year prior,warm c year prior,3.0,0.7249559550074489,4322,2882,1440,2073600
2042,love,holy,1.0,0.0,357,957,-600,360000
2043,vast property protect got,great wealth protect got,3.200000047683716,0.47439526834173146,2478,3174,-696,484416
2044,fundamental difference,fundamental difference,4.599999904632568,1.0,5612,5196,416,173056
2045,exactly germany punish stupidity,exactly punish,1.399999976158142,0.734386161549504,4414,1403,3011,9066121
2046,z stalk shoot,claim zimmerman talk shoot,3.0,0.2674533478755747,1269,2878,-1609,2588881
2047,outraged disappointed,god bless outraged disappointed,5.0,0.7582375759326989,4585,5556,-971,942841
2048,get place,money come place,0.800000011920929,0.6172099658876831,3547,876,2671,7134241
2049,freedom speech consequence,freedom speech consequence free,2.1111111640930176,0.8944263676866987,5389,1968,3421,11703241
2050,parent tell bad,teacher tell bad,2.799999952316284,0.5831530975235125,3269,2673,596,355216
2051,kill person save,kill person save idea,2.0,0.771889719202488,4663,1831,2832,8020224
2052,impose moral,impose law,1.100000023841858,0.5305930634004578,2868,1105,1763,3108169
2053,depend define extreme,depend define extreme,5.0,1.0,5615,5553,62,3844
2054,mexico presence california,mexico zero claim california,1.2000000476837158,0.5267247161559161,2834,1116,1718,2951524
2055,yes read bible learn christianity,personally read bible learn christianity,3.0,0.8016221588112219,4875,2918,1957,3829849
2056,oh ha ha ha ha ha,ha ha ha ha ha,4.5,0.9859198945714056,5579,5141,438,191844
2057,yell refuse answer question,refuse answer question,3.400000095367432,0.7874266178172433,4777,3583,1194,1425636
2058,regulation little,intervention free market little,3.799999952316284,0.2702047971890672,1283,4130,-2847,8105409
2059,human element sign dance german end year guess,sign dance german end year guess,4.0,0.8074461710176267,4909,4350,559,312481
2060,took thomas leave canon,addition jesus word leave canon,2.5999999046325684,0.41022903915696873,2069,2473,-404,163216
2061,mean believe word mainstream medium,mean believe word springhallconvert,1.7999999523162842,0.5338175813592805,2904,1641,1263,1595169
2062,mean explore,mean,2.400000095367432,0.5900282291819535,3324,2252,1072,1149184
2063,israel accept,israel anybody think,3.400000095367432,0.21745984021976497,1038,3602,-2564,6574096
2064,vessel fill wonder,want lock toll miss vessel fill wonder,3.400000095367432,0.604195092491618,3438,3598,-160,25600
2065,slutstamp dear friend ohio send,dear friend ohio send,3.5999999046325684,0.8426752212097772,5122,3861,1261,1590121
2066,titanic story hold scrutiny evidence,new study show titanic story stand scrutiny mio,1.600000023841858,0.618007260445747,3552,1540,2012,4048144
2067,goose ad sense,make money goose ad sense,3.200000047683716,0.8627527056316198,5234,3188,2046,4186116
2068,know video gas chamber,line video clip gas chamber,4.599999904632568,0.6820716516934395,4004,5254,-1250,1562500
2069,arm maybe record,farmer certainly record,4.400000095367432,0.2282780826094307,1082,5035,-3953,15626209
2070,right scatterbrained treat drug,opinionated stubborn treat drug,2.200000047683716,0.3852586631049334,1908,1994,-86,7396
2071,definition life,definition nature,1.2000000476837158,0.553270613691542,3058,1126,1932,3732624
2072,lot thing,simple mistake,2.200000047683716,0.0,359,1995,-1636,2676496
2073,extortion bribery money involve ask money vote,extortion bribery money involve class e felony,3.799999952316284,0.6689560650660095,3910,4132,-222,49284
2074,tender revise version,tender revised version,4.0,0.5846315054048199,3281,4358,-1077,1159929
2075,tell feel,wait go,2.200000047683716,0.0,361,1998,-1637,2679769
2076,atlantic requirement,pacific requirement,0.800000011920929,0.47987971264709434,2513,884,1629,2653641
2077,remain missile pentagon,witness missile pentagon,2.5999999046325684,0.6770498758509089,3967,2463,1504,2262016
2078,lane want ask helpful party guest pay,believe ask ask helpful party guest money,2.200000047683716,0.6769096846486922,3966,2000,1966,3865156
2079,woman want birth control,woman want abortion,1.600000023841858,0.4073034952316909,2047,1544,503,253009
2080,legal grow,yes legal grow,2.5999999046325684,0.8031773471990917,4883,2491,2392,5721664
2081,press english,dress send tone,1.7999999523162842,0.0,362,1754,-1392,1937664
2082,opinion series,opinion briefly interim,2.799999952316284,0.41020559389105826,2067,2692,-625,390625
2083,vessel fill wonder,chuck close vessel fill wonder,3.5999999046325684,0.6889521582085983,4060,3863,197,38809
2084,supporter,eminently supporter,2.0,0.6069514783187911,3458,1829,1629,2653641
2085,okay ultimate sovereignty,ultimate sovereignty,2.200000047683716,0.8175995053040228,4972,2003,2969,8814961
2086,answer,answer,4.800000190734863,1.0,5640,5347,293,85849
2087,paris increase longevity handful permit year,paris lower minimum age buy forearm,2.200000047683716,0.15982103325969188,818,2004,-1186,1406596
2088,help,,3.5999999046325684,0.0,363,3865,-3502,12264004
2089,healthy person need gambling,healthy person need sex,1.399999976158142,0.7113825111408234,4232,1422,2810,7896100
2090,say person legal sense,person wtf,2.0,0.20052285663350167,987,1826,-839,703921
2091,drama call regulation reform,drama call cap balance,1.7999999523162842,0.18777413762100903,940,1771,-831,690561
2092,leprechaun exist fine,slave exist fine,3.0,0.534910421628604,2914,2913,1,1
2093,seine door light start night hand,start night hand,2.0,0.6425480656363874,3730,1823,1907,3636649
2094,ran signed npt iaea,aorta love factor ran signed npt iaea,4.199999809265137,0.7257024531169869,4331,4776,-445,198025
2095,organs exist fine,water exist fine,2.0,0.6517296467568866,3792,1820,1972,3888784
2096,west way money rid lobby,west way turn head money,3.0,0.5045565008434876,2689,2858,-169,28561
2097,year keener keener right usually pretty decent care,year keener keener right crack,3.400000095367432,0.6770698969143178,3969,3568,401,160801
2098,dutch hear dutch,hear dutch,3.5999999046325684,0.9537663246764676,5562,3877,1685,2839225
2099,commodity expanded value form,elementary commodity capital value form,3.5999999046325684,0.6438301283259942,3740,3868,-128,16384
2100,christian,christian,1.399999976158142,1.0,5594,1400,4194,17589636
2101,simple fact today,repeat simple fact today,4.0,0.8727828921976855,5287,4483,804,646416
2102,moral absolutely,moral honesty,2.0,0.47659602911220167,2500,1842,658,432964
2103,oh good person,bad person,1.7999999523162842,0.2662914538333444,1265,1749,-484,234256
2104,think story like stupid,wolf think story like stupid,3.5999999046325684,0.8705686978949506,5273,3869,1404,1971216
2105,cyclone formation expect hours,tropical cyclone formation expect,3.400000095367432,0.7146715045013825,4252,3454,798,636804
2106,understand string word mean,understand word lead implie,1.2000000476837158,0.4664565850694985,2423,1115,1308,1710864
2107,freedom religion,freedom speech,1.2000000476837158,0.4889929397488185,2576,1122,1454,2114116
2108,originally post solinvictus message scripture fondness,originally post solinvictus oh,2.400000095367432,0.5522771453257151,3051,2264,787,619369
2109,long obliteration kid return school,long obliteration long bother kid,3.0,0.6842002311259483,4020,2835,1185,1404225
2110,man woman different yes,man woman different yes,3.400000095367432,1.0000000000000002,5712,3519,2193,4809249
2111,double jeopardy actually enforce jury nullification,far reality go use jury nullification,2.200000047683716,0.3480850644659966,1701,1977,-276,76176
2112,facilitator smart child,facilitator dumb child,1.0,0.5547597576519874,3070,955,2115,4473225
2113,religious fiction redundant repetetive,redundant repetetive,3.200000047683716,0.7425309235531355,4476,3107,1369,1874161
2114,originally post anabelle wrong,originally post vienna,0.0,0.4755927775561401,2488,235,2253,5076009
2115,franklin rise veil diamond vessel fill wonder,single lock hobby helm vessel fill wonder,1.600000023841858,0.2779433518142208,1319,1552,-233,54289
2116,people complete confidence people run institution,people confidence people run institution,1.600000023841858,0.8950772374407738,5395,1533,3862,14915044
2117,loose change start work fiction,finish work fiction,2.200000047683716,0.48205946412052486,2523,1978,545,297025
2118,life able bear,alive miscarriage,3.0,0.0,337,2830,-2493,6215049
2119,verbal absolutely amazing,lie absolutely amazing,2.400000095367432,0.7095578529070864,4214,2315,1899,3606201
2120,let assume white black,imagine place white black,3.777777671813965,0.25916512730725993,1221,4061,-2840,8065600
2121,freedom speech consequence,freedom speech consequence free,2.1111111640930176,0.8944263676866987,5390,1969,3421,11703241
2122,fairy exist fine,leprechaun exist fine,1.0,0.534910421628604,2916,946,1970,3880900
2123,state true,true,3.200000047683716,0.8650635585314156,5246,3120,2126,4519876
2124,talk,bad talk,2.799999952316284,0.5801095034260157,3251,2675,576,331776
2125,duke mean want use duke,duke mean want use duke,1.399999976158142,1.0,5600,1388,4212,17740944
2126,niece marry black man,great niece half black,1.399999976158142,0.5302658844277973,2863,1389,1474,2172676
2127,population million,japanese population nearly million,1.0,0.6703593660219299,3921,937,2984,8904256
2128,hot sheriff vessel fill wonder,vessel fill wonder,3.400000095367432,0.6548845358662522,3816,3489,327,106929
2129,hope,hope ok,2.0,0.5533218392074273,3060,1859,1201,1442401
2130,money spend adopt velociraptor,money spend adopt velociraptor,4.199999809265137,1.0,5603,4748,855,731025
2131,actually believe word verbal write,verbal wear actually believe word verbal write,4.199999809265137,0.9140997708106943,5459,4746,713,508369
2132,sell,sell,1.600000023841858,1.0,5662,1515,4147,17197609
2133,know hate,hate,4.400000095367432,0.7977733253998223,4849,5067,-218,47524
2134,weapon,course weapon,4.599999904632568,0.602021559361592,3419,5256,-1837,3374569
2135,stupid true,amusing think true,3.0,0.4095189213936101,2063,2823,-760,577600
2136,personal responsibility,personal responsibility,4.400000095367432,1.0000000000000002,5705,5066,639,408321
2137,notice nonsensical thing say,fair notice nonsensical thing say,4.5714287757873535,0.8730378893491889,5291,5150,141,19881
2138,guess pull census rear end hat,census rear end hat,2.5999999046325684,0.8077324144730562,4911,2476,2435,5929225
2139,plant rush,plant rush,4.400000095367432,1.0,5631,5064,567,321489
2140,block homeopath,simple logic block homeopath,4.800000190734863,0.6899247095976251,4067,5367,-1300,1690000
2141,accuse milligraming,accuse doctrine baseball,0.4000000059604645,0.26928342404789435,1276,485,791,625681
2142,ballot big tarp bloomberg news,ballot big tarp title misleading,3.799999952316284,0.5605417557982066,3101,4137,-1036,1073296
2143,parent tell bad,officer tell bad,2.0,0.6243060707614669,3584,1851,1733,3003289
2144,position individual risk assume,position way currently,1.0,0.3000445948539522,1426,933,493,243049
2145,atlantic requirement,pacific requirement,0.800000011920929,0.47987971264709434,2512,850,1662,2762244
2146,head meet fro abortion,meet fro abortion,4.800000190734863,0.9017166402030774,5417,5366,51,2601
2147,problem money,problem man way state,0.2000000029802322,0.4697147382356422,2449,428,2021,4084441
2148,dixon word garter shut oilfield,shut oil field,2.0,0.26213894436643725,1239,1783,-544,295936
2149,want president care,want president charasmatic,1.0,0.48722871047119254,2559,967,1592,2534464
2150,brand,propose model,0.0,0.0,318,227,91,8281
2151,missile evidence,missile witness,3.200000047683716,0.4195813596120455,2121,3121,-1000,1000000
2152,teacher tell bad,officer tell bad,2.200000047683716,0.6347740785576588,3671,2057,1614,2604996
2153,gash pregnancy ticket,pregnancy ticket,4.199999809265137,0.7754847597975579,4691,4789,-98,9604
2154,omnipotence,malevolent,1.399999976158142,0.0,321,1413,-1092,1192464
2155,tin foil hat dog face size u wear,tin foil hat sang size u wear,3.0,0.8345944773753129,5075,2866,2209,4879681
2156,like year old shoot dead marijuana relate crime,year old boy shoot dead automatic weapon marijuana dealer,4.199999809265137,0.5275998097150167,2841,4788,-1947,3790809
2157,leap hit get penalty,stick hit guy face get penalty,2.5999999046325684,0.4663172349839837,2419,2466,-47,2209
2158,electrical energy come battery,electrical energy ultimately come alternate,2.400000095367432,0.5983132580330213,3394,2319,1075,1155625
2159,know passenger testify say,passenger say see iceberg,2.400000095367432,0.40841255900925016,2054,2310,-256,65536
2160,imagine place man woman,imagine place white black,1.600000023841858,0.7813856902592304,4731,1529,3202,10252804
2161,scenario assume growth rate accelerate,assume methode growth rate accelerate,1.75,0.7386163281819768,4444,1606,2838,8054244
2162,actually show cool trend recent decline,cool trend recent decline,4.599999904632568,0.8994059706087196,5407,5260,147,21609
2163,vessel fill wonder,tendon memory cats vessel fill wonder,3.0,0.5510640556745083,3041,2871,170,28900
2164,repeat sovereign,sovereign,4.5,0.7439091137443742,4487,5139,-652,425104
2165,touch completely untrustworthy,touch untrustworthy,4.25,0.8292383478680547,5042,4943,99,9801
2166,dutch,fact dutch,3.5999999046325684,0.6836133253038212,4014,3866,148,21904
2167,talk angel common pin right,andrew talk angel common pin right,4.800000190734863,0.8948793162039028,5394,5362,32,1024
2168,claim trayvon character,plant blow,2.5999999046325684,0.0,324,2509,-2185,4774225
2169,money abortion service,spend abortion service,2.5999999046325684,0.6765688522954608,3963,2505,1458,2125764
2170,transaction place,transaction place,2.400000095367432,1.0,5680,2321,3359,11282881
2171,egg cell post fertilization,speak cell,2.400000095367432,0.3398732415553861,1655,2314,-659,434281
2172,face welcome,welcome,4.0,0.797804697553497,4851,4467,384,147456
2173,factchecke know make fuss bet,know make fuss bet,4.400000095367432,0.8434390117039494,5125,5052,73,5329
2174,claim,claim,2.400000095367432,1.0,5683,2318,3365,11323225
2175,thatcherite librarian,offend thatcherites librarian,2.400000095367432,0.37281545185665,1830,2307,-477,227529
2176,problem money,problem money,2.4666666984558105,1.0000000000000002,5745,2325,3420,11696400
2177,actually believe iceberg water,believe iceberg near titanic,2.799999952316284,0.5504559219975258,3038,2716,322,103684
2178,gastro trifle bad someday trifles game freeze,someday trifles game freeze,3.0,0.7529106553426446,4546,2850,1696,2876416
2179,clot corp prescription drug,clot inventor writer prescription drug,2.400000095367432,0.61737656786371,3549,2323,1226,1503076
2180,charge,yes charge,4.0,0.6051573273970984,3443,4433,-990,980100
2181,partial psychopath,red funds partial psychopath,1.7999999523162842,0.7714691656262915,4660,1719,2941,8649481
2182,ignore history doom repeat,strike ignore history doom repeat,4.199999809265137,0.9490697033767956,5551,4769,782,611524
2183,war employment,official employment,2.400000095367432,0.6375108516828364,3697,2312,1385,1918225
2184,outran plural anecdote datum gentleman need chaperone,outran plural anecdote datum,3.5999999046325684,0.765251152763286,4634,3855,779,606841
2185,alright get,alright get,4.0,1.0,5666,4427,1239,1535121
2186,h read book think movie move quickly,read book see movie today,3.0,0.706588265388686,4182,2928,1254,1572516
2187,kolocha scene,kolocha scene,2.400000095367432,1.0,5667,2309,3358,11276164
2188,andrew tendon johnson john penned compatible,tendon johnson john penned compatible,4.400000095367432,0.912786932800271,5452,5055,397,157609
2189,need mind,need polish logic skill,0.6000000238418579,0.23789608181629712,1117,654,463,214369
2190,walk home go sleep,walk home beat wife,1.399999976158142,0.46405686356078363,2396,1414,982,964324
2191,admit drpizza forget shiny little bed letter,forget shiny little bed letter,3.799999952316284,0.8194917083609286,4981,4209,772,595984
2192,argument albert einstein college,omg einstein college,4.199999809265137,0.5452058655288189,2993,4778,-1785,3186225
2193,capital gain rate percent,income tax rate percent,2.400000095367432,0.40203393018455935,2018,2322,-304,92416
2194,singing unacceptable,drunk unacceptable,1.0,0.47659602911220167,2499,893,1606,2579236
2195,funny year,funny carry mud german,3.400000095367432,0.47717433419001853,2502,3668,-1166,1359556
2196,universe explanation existence explanation god,universe explanation existence,2.400000095367432,0.8918661674518806,5381,2316,3065,9394225
2197,return fighting,return fighting,5.0,1.0,5672,5549,123,15129
2198,stop joke marriage,fight marriage,1.2000000476837158,0.40739057573486454,2049,1127,922,850084
2199,news news,catholics catholics,2.200000047683716,0.0,325,2038,-1713,2934369
2200,great lady,nice lady,4.0,0.41885652445689886,2120,4421,-2301,5294601
2201,wealthy successful,hate people successful,0.800000011920929,0.4732539590063444,2468,849,1619,2621161
2202,irritated,irritated henry,1.75,0.72717360271953,4337,1619,2718,7387524
2203,common sense deductive reasoning thing,limit common sense deductive reasoning thing,2.5,0.9226073031769485,5489,2351,3138,9847044
2204,slim office right,christian office right,0.800000011920929,0.5858713304917451,3290,865,2425,5880625
2205,say workforce,inn money workforce,3.400000095367432,0.6135986870220439,3516,3460,56,3136
2206,dreamtech ejaculate far know,ejaculate far know,3.0,0.8111580643217557,4935,2864,2071,4289041
2207,get soft,say get soft,1.2000000476837158,0.9198795717293533,5483,1142,4341,18844281
2208,believe get expect,time time get expect,3.799999952316284,0.3078496990089559,1469,4211,-2742,7518564
2209,despicable man stop try find excuse man,man stop try find excuse man,4.400000095367432,0.8371695194562219,5090,5034,56,3136
2210,different different country,short form yes probably different different country,3.5999999046325684,0.7521114691541014,4542,3837,705,497025
2211,new study support claim,physical evidence support claim,2.200000047683716,0.4356971802619628,2219,2052,167,27889
2212,say level,say level,4.599999904632568,1.0000000000000002,5706,5267,439,192721
2213,moral exist technically morally wrong,ask god exist morally wrong,2.200000047683716,0.5953739932027806,3379,2051,1328,1763584
2214,think dutch,dutch,4.0,0.7943049045495126,4827,4416,411,168921
2215,poland johnny vessel fill wonder,eye tiger vessel fill wonder,3.200000047683716,0.4434175853479464,2270,3325,-1055,1113025
2216,met let play court,stop thing play court,3.799999952316284,0.33964986148122644,1654,4212,-2558,6543364
2217,gang isn crime,vomit crime gang crime,1.7999999523162842,0.5908121353054413,3332,1761,1571,2468041
2218,offer ran deal,chuck offer ran deal,4.199999809265137,0.7443866579012813,4493,4733,-240,57600
2219,yes different,opinion different,1.2000000476837158,0.5256586399688513,2829,1133,1696,2876416
2220,impose moral,impose law,1.100000023841858,0.5305930634004578,2867,1104,1763,3108169
2221,sexuality like,word hobby sexuality like,3.799999952316284,0.7002659202213517,4132,4215,-83,6889
2222,pure communism cow,libertarian anarcho capitalism cow,2.400000095367432,0.1566276406638911,801,2317,-1516,2298256
2223,scientist pedestal,people like scientist pedestal,3.400000095367432,0.8382985919498899,5094,3492,1602,2566404
2224,try hide,ask try hide,3.5999999046325684,0.8446411452408896,5132,3841,1291,1666681
2225,partially responsible death,sort accessory think,3.0,0.0,335,2843,-2508,6290064
2226,like pay health care,like wear seatbelt,0.0,0.22801327358431628,1080,215,865,748225
2227,sovereign,repeat sovereign,4.400000095367432,0.7439091137443742,4488,5110,-622,386884
2228,drama less evil,evil,2.0,0.8468573983509001,5144,1788,3356,11262736
2229,rose vessel fill wonder,vessel fill wonder,3.200000047683716,0.7501407394104991,4530,3307,1223,1495729
2230,point unarmed child murder,point unarmed child murder black,3.400000095367432,0.9454909168353276,5546,3510,2036,4145296
2231,zimmerman reply,martin say follow,0.8999999761581421,0.0,336,890,-554,306916
2232,religion problem,religion problem,1.600000023841858,1.0000000000000002,5714,1588,4126,17023876
2233,angry scar,hyper active scar,3.200000047683716,0.3660398550056702,1786,3233,-1447,2093809
2234,want buy billion xyz common stock care,want buy house suv care,1.399999976158142,0.4747933015789493,2483,1412,1071,1147041
2235,billion world mexico current prosperity level,world current prosperity level northwest africa,1.5333333015441897,0.7082319112548865,4203,1452,2751,7568001
2236,answer yes probably straight,answer yes probably straight,3.0999999046325684,1.0,5644,3074,2570,6604900
2237,fantasize have power,fantasise bend people demand,4.199999809265137,0.0,338,4719,-4381,19193161
2238,parent tell bad,sheriff tell bad,2.799999952316284,0.5649381595467358,3142,2676,466,217156
2239,atlas shrug cellar performer term glitter idiocy,cellar performer term glitter idiocy,3.5999999046325684,0.8268897186978611,5022,3843,1179,1390041
2240,martin know case,martin know intention base action,2.400000095367432,0.5389660280586626,2946,2177,769,591361
2241,regulation government,met government,2.400000095367432,0.3329571435037696,1614,2174,-560,313600
2242,common sense deductive reasoning thing,limit common sense deductive reasoning thing,2.5,0.9226073031769485,5490,2341,3149,9916201
2243,yes assume packing recyclable argument,assume argument,2.799999952316284,0.602770877143821,3424,2666,758,574564
2244,jury nullification mean law unconstitutional,jury nullification mean law constitutional,3.5999999046325684,0.7367215206892949,4428,3853,575,330625
2245,bunch cell,bunch cell,2.200000047683716,1.0000000000000002,5726,2033,3693,13638249
2246,kann work path,kann work free ring,1.600000023841858,0.5800290005894844,3248,1591,1657,2745649
2247,sorry hear belly,sorry belly,4.0,0.8528023984990865,5178,4437,741,549081
2248,like favor bee,like favor drink,3.0,0.6344848782345647,3669,2836,833,693889
2249,hope ok,hope ok,1.600000023841858,1.0,5608,1592,4016,16128256
2250,woman want birth control,woman want abortion,1.600000023841858,0.4073034952316909,2046,1577,469,219961
2251,s wish kill news,kill news,4.599999904632568,0.6524348656231869,3795,5270,-1475,2175625
2252,friend pitt,good friend pitt,4.0,0.8701836644481407,5270,4458,812,659344
2253,mean option,doesn mean bad option,1.600000023841858,0.6772885295657007,3971,1576,2395,5736025
2254,think need reread write,need reread write,5.0,0.9038456130144557,5428,5542,-114,12996
2255,let assume white black,imagine place white black,3.777777671813965,0.25916512730725993,1222,4060,-2838,8054244
2256,tom dust say noise,kiss dust say,1.7999999523162842,0.4724400377887936,2461,1723,738,544644
2257,good butte ex fiance use navy doctor,ex fiance use navy doctor,3.5999999046325684,0.8286806282804732,5040,3844,1196,1430416
2258,old file page letter,judges order page letter file,2.799999952316284,0.694405318163171,4097,2698,1399,1957201
2259,andrew dusting agree,andrew thank dusting,2.200000047683716,0.7481109864552983,4513,2022,2491,6205081
2260,eclipse old record set,break daily record set,4.800000190734863,0.38772010568664483,1927,5401,-3474,12068676
2261,zimmerman reply,martin say follow,0.8999999761581421,0.0,405,889,-484,234256
2262,know legitimate hear kind suicidal,know legitimate yeah,1.600000023841858,0.45025170109872115,2306,1557,749,561001
2263,council tax council tax freeze people,council tax freeze people,4.800000190734863,0.9507997988359098,5554,5405,149,22201
2264,stick get stale,misogyny get mess,0.4000000059604645,0.0,398,498,-100,10000
2265,work,ah work,1.600000023841858,0.5071016220015696,2707,1561,1146,1313316
2266,breathe breathe love,buwhahahaha breathe breathe love,4.400000095367432,0.8980821472233794,5403,5082,321,103041
2267,wait consistent close,wait contraction strong close,3.799999952316284,0.42983337975215985,2181,4218,-2037,4149369
2268,drama extreme let,drama extreme letting,4.800000190734863,0.5659004503289735,3150,5406,-2256,5089536
2269,isa want,want,2.5,0.5765303802851484,3222,2361,861,741321
2270,jury nullification constitutionality law,jury nullification mean law constitutional,2.5999999046325684,0.5992947162088003,3399,2511,888,788544
2271,conviction talk,conviction,4.400000095367432,0.8492021356321439,5160,5090,70,4900
2272,actually read guess find,furthermore find actually read guess find,4.599999904632568,0.8198445172864759,4987,5276,-289,83521
2273,government determine married,government doesn declare married marry,3.5999999046325684,0.47140765438396515,2456,3845,-1389,1929321
2274,democracy threat liberty,democracy liberty,1.7999999523162842,0.8662307593592231,5248,1743,3505,12285025
2275,fro wear thread plan make,thread plan make,4.0,0.7890564813450764,4794,4443,351,123201
2276,exactly system work right,system work,4.0,0.4658413925968426,2413,4442,-2029,4116841
2277,oh assert marriage fundamental human right,particularly state marriage fundamental human right,4.0,0.6386574700496659,3704,4629,-925,855625
2278,russians damascus,russians damascus,4.199999809265137,1.0,5684,4795,889,790321
2279,yes solution,solution work,1.7999999523162842,0.6099520793852751,3488,1747,1741,3031081
2280,yeah think controversial,think say controversial,3.799999952316284,0.6972283957755545,4114,4223,-109,11881
2281,operation chaos merely people vote,chaos merely people vote,4.0,0.903301955048915,5422,4446,976,952576
2282,originally post doubtful,originally post,1.2000000476837158,0.7027619041399997,4160,1112,3048,9290304
2283,classical vessel fill wonder,theme song cheer vessel fill wonder,3.0,0.3920688478132044,1946,2926,-980,960400
2284,repeat sovereign,sovereign,4.5,0.7439091137443742,4489,5123,-634,401956
2285,moral absolutely,moral honesty,2.0,0.47659602911220167,2498,1848,650,422500
2286,have conversation cornell west dear brother,have conversation cornell west hell,3.0,0.6577628753209296,3836,2919,917,840889
2287,war middle east,war middle east,4.599999904632568,1.0,5658,5251,407,165649
2288,intention apprehend,didn plan apprehend,2.400000095367432,0.42907298486506784,2176,2222,-46,2116
2289,vessel fill wonder,little love heart vessel fill wonder,3.5999999046325684,0.60614627333341,3454,3849,-395,156025
2290,bunch cell,bunch cell,2.400000095367432,1.0000000000000002,5709,2223,3486,12152196
2291,girl fouche,girl fouche,1.399999976158142,1.0,5663,1378,4285,18361225
2292,jury nullification mean law constitutional,jury nullification mean law unconstitutional,2.0,0.7367215206892949,4427,1854,2573,6620329
2293,definitely,vote voted definitely,4.0,0.6119045840193426,3504,4454,-950,902500
2294,one manufacturer product convince consumer safe,manufacturer convince government safe,3.400000095367432,0.7589369629923683,4591,3595,996,992016
2295,think miss point entrepreneur,think miss point swain quote,0.800000011920929,0.5031745388062207,2682,859,1823,3323329
2296,cyclops exist fine,collin exist fine,1.600000023841858,0.534910421628604,2915,1574,1341,1798281
2297,mental illness teach,state mental illness bigotry,1.600000023841858,0.6473833187506001,3766,1570,2196,4822416
2298,tendon christmas vessel fill wonder,lie fire vessel fill wonder,1.7999999523162842,0.5522186195373883,3049,1732,1317,1734489
2299,rush get zero credit budget,drama get zero credit budget,1.7999999523162842,0.8409635745566862,5108,1728,3380,11424400
2300,sinful people heaven,sin remove entry heaven,1.7999999523162842,0.3377253227346542,1644,1727,-83,6889
2301,long obliteration kid return school,long obliteration long bother kid,3.0,0.6842002311259483,4021,2900,1121,1256641
2302,folly holy vessel fill wonder,vessel fill wonder,3.799999952316284,0.6152027883718063,3525,4228,-703,494209
2303,answer chicago,response california,1.2000000476837158,0.0,402,1129,-727,528529
2304,entire thing make sense,make sense,4.199999809265137,0.674816364247693,3949,4891,-942,887364
2305,supposedly operate homicidal gas chamber,refresh memory supposedly operate homicidal gas chamber,4.800000190734863,0.8269204962859318,5023,5387,-364,132496
2306,explanation existence universe god,universe explanation existence explanation god,3.5999999046325684,0.9438325108037462,5540,3852,1688,2849344
2307,genetic predisposition cancer resistance superior genetic,genetic predisposition alzheimer inferior genetic,1.399999976158142,0.6811701676720311,3994,1415,2579,6651241
2308,notice nonsensical thing say,fair notice nonsensical thing say,4.5714287757873535,0.8730378893491889,5290,5151,139,19321
2309,use force defense,use force aggressor,1.2000000476837158,0.5372807380004739,2934,1130,1804,3254416
2310,datum available show,historical record show,3.5999999046325684,0.0,401,3854,-3453,11923209
2311,boy world vessel fill wonder,theme song cheer vessel fill wonder,3.0,0.43083614093889666,2188,2877,-689,474721
2312,think dutch,fact dutch,2.5999999046325684,0.5429974171042267,2975,2493,482,232324
2313,ve watch kiss play,like watch kiss play,2.200000047683716,0.648682191674129,3772,2014,1758,3090564
2314,david think antrum likely gingrich,think antrum likely gingrich,4.800000190734863,0.9096531591205804,5444,5377,67,4489
2315,look,look like,2.799999952316284,0.6857601837869279,4029,2681,1348,1817104
2316,drive,drive fucking bolt,2.5999999046325684,0.45656821571238887,2346,2523,-177,31329
2317,religion problem,religion problem,1.399999976158142,1.0000000000000002,5730,1410,4320,18662400
2318,think well american business interest overall,well american society,1.600000023841858,0.2930035691651848,1384,1513,-129,16641
2319,constitutional issue,constitutional issue,4.400000095367432,1.0000000000000002,5727,5116,611,373321
2320,fools buy cover hook,lot fools buy cover hook,4.199999809265137,0.8980984447191481,5404,4876,528,278784
2321,press number,dress number english,1.600000023841858,0.37258214472990286,1829,1530,299,89401
2322,conviction,conviction talk,4.400000095367432,0.8492021356321439,5159,5103,56,3136
2323,originally post spikdboy wistful thinking realistic,originally post objective wistful thinking realistic,3.799999952316284,0.8003616116873724,4867,4230,637,405769
2324,trillion time say rehabilitation work,point quote say rehabilitation work,3.400000095367432,0.5309619772396136,2876,3610,-734,538756
2325,charlie angel censured forage,forage,3.0,0.49268469557599615,2605,2884,-279,77841
2326,red october stand,red box stand,2.0,0.4901148373964964,2585,1840,745,555025
2327,legal brief write,legal reasoning work,3.200000047683716,0.30855444678082516,1472,3278,-1806,3261636
2328,factor account recent warming,know factor account warming,3.0,0.8172997213339509,4970,2887,2083,4338889
2329,tone notify captain word,notify captain word,3.400000095367432,0.8515795857434194,5166,3601,1565,2449225
2330,primary focus systematic dialectics son chronic chronic,beta system attic dialectic diachronico synchronic dialectic,2.200000047683716,0.0,394,2131,-1737,3017169
2331,drive,drive fucking bolt,2.5999999046325684,0.45656821571238887,2347,2475,-128,16384
2332,happen gop control state,michigan gop control state,0.800000011920929,0.6958278526563281,4105,836,3269,10686361
2333,basin freeze,frozen,4.199999809265137,0.0,370,4884,-4514,20376196
2334,isa rank observe perceive,impostor rank observe perceive,4.199999809265137,0.7269286872594564,4335,4890,-555,308025
2335,government decide pregnancy need carry term fine,government spy citizen fine,1.2000000476837158,0.31060250274743006,1484,1143,341,116281
2336,little love heart vessel fill wonder,tendon christmas vessel fill wonder,2.799999952316284,0.39823350706710936,1992,2706,-714,509796
2337,high cent high,power cent low,1.0,0.25290449798940734,1189,1047,142,20164
2338,sell,sell,1.600000023841858,1.0,5609,1461,4148,17205904
2339,god definitely exist,god probably exist,2.5999999046325684,0.59964136289708,3403,2462,941,885481
2340,breathe breathe love,buwhahahaha breathe breathe love,4.400000095367432,0.8980821472233794,5402,5043,359,128881
2341,excellent indicator climate change,think agree nature change,2.0,0.18217926668263879,919,1830,-911,829921
2342,great thing live space,bad thing space,1.7999999523162842,0.565579619530576,3146,1644,1502,2256004
2343,oh ha ha ha ha ha,ha ha ha ha ha,4.5,0.9859198945714056,5581,5124,457,208849
2344,understand freedom speech prohibit,freedom speech prohibit today,3.799999952316284,0.7586077314876954,4589,4232,357,127449
2345,question need ask,question need answer,3.200000047683716,0.643067455976355,3733,3234,499,249001
2346,purport value life heavily,purport value human life highly,2.799999952316284,0.6337200596640749,3661,2695,966,933156
2347,infestation post,mosquito post,1.7999999523162842,0.30347770731066315,1441,1645,-204,41616
2348,want president care,want president compassionate,4.599999904632568,0.48722871047119254,2560,5228,-2668,7118224
2349,compelling,compelling,2.400000095367432,1.0,5620,2198,3422,11710084
2350,trillion time say rehabilitation work,point quote say rehabilitation work,3.400000095367432,0.5309619772396136,2875,3555,-680,462400
2351,classical vessel fill wonder,time reason hobbies vessel fill wonder,2.400000095367432,0.43071525007068956,2185,2196,-11,121
2352,nerve agree come essentially freewill,agree come essentially freewill,4.0,0.8633679109183853,5237,4419,818,669124
2353,fro life people want woman able choose abortion,fro choice people try force abortion,1.0,0.4094209298673532,2061,1034,1027,1054729
2354,answer question,stop avoid question,3.400000095367432,0.34975493369243543,1710,3554,-1844,3400336
2355,haiti shithole,haiti shithole,4.199999809265137,1.0,5606,4893,713,508369
2356,absolutely believe iceberg water,believe iceberg near titanic,1.2000000476837158,0.5403193772532728,2958,1117,1841,3389281
2357,face franchise bad years fan,bad years fan,4.400000095367432,0.788766575017958,4789,5069,-280,78400
2358,agree completely hope second term office,hope second term office,4.0,0.7805490611055341,4724,4422,302,91204
2359,assist,horace goal,0.4000000059604645,0.0,373,468,-95,9025
2360,possible home affect school,sure possible home affect school,3.200000047683716,0.8425955404045893,5120,3224,1896,3594816
2361,people awaken,people awaken,4.199999809265137,1.0000000000000002,5707,4877,830,688900
2362,mmm california cargo ship not care article say,california cargo ship,4.0,0.6383765097695088,3702,4425,-723,522729
2363,mmm pretty clearly state statute resume constitutional,decide statute resume constitutional,2.5999999046325684,0.5887169430509317,3308,2467,841,707281
2364,florida ignorance,ignorance,3.400000095367432,0.7859472539122838,4758,3550,1208,1459264
2365,go shout justice trayvon,people shout justice trayvon hypocrite,1.600000023841858,0.7960897963735334,4835,1467,3368,11343424
2366,know right wrong,know story right,2.200000047683716,0.5663423000984795,3153,2076,1077,1159929
2367,ha ha ha ha ha,oh ha ha ha ha ha,5.0,0.9859198945714056,5580,5535,45,2025
2368,agent complete fool say,natalie complete fool insult fan base,0.6000000238418579,0.4682657057613434,2437,621,1816,3297856
2369,rush fault,drama rush fault,1.2000000476837158,0.8917127235847415,5379,1118,4261,18156121
2370,stop refixe suffer hate news,prefix suffer hate news,2.400000095367432,0.5924927241632196,3356,2219,1137,1292769
2371,miss point say black people go riot,black go riot,2.400000095367432,0.6374015636983672,3696,2218,1478,2184484
2372,met declare,,2.0,0.0,375,1875,-1500,2250000
2373,proverb john baptist nazarite birth,john baptist nazarite birth,4.599999904632568,0.8679175181056119,5255,5229,26,676
2374,james say faith work dead,paul preach faith work,2.200000047683716,0.47342127673316825,2471,2111,360,129600
2375,billion world mexico current prosperity level,world current prosperity level northwest africa,1.5333333015441897,0.7082319112548865,4204,1453,2751,7568001
2376,video seismic datum equal duration collapse,seismic datum equal duration collapse,4.599999904632568,0.9349308228930481,5520,5232,288,82944
2377,originally post box say multiple time,originally post box cranial relate,2.200000047683716,0.5242477342320248,2819,2109,710,504100
2378,like dramas view,like position hold,2.5999999046325684,0.26031240247618453,1231,2465,-1234,1522756
2379,actually believe iceberg water,absolutely believe iceberg water,3.0,0.6974876893830417,4115,2773,1342,1800964
2380,simply winning drama conservative,rich come conservative,1.399999976158142,0.3324945276755229,1612,1396,216,46656
2381,satan represent indulgence instead abstinence,satan represent vengeance instead turn cheek,1.600000023841858,0.5045661718034273,2690,1459,1231,1515361
2382,long tax sale pay,long tax pay,3.799999952316284,0.8712177562242218,5278,4236,1042,1085764
2383,fix slam political,slam political,1.2000000476837158,0.7999175433106696,4862,1141,3721,13845841
2384,march date uprising china,originally post vitchilo march date uprising china,4.0,0.733897851855541,4412,4431,-19,361
2385,hope,hope okay,5.0,0.5823735147521822,3265,5484,-2219,4923961
2386,understand absurd limit question resident,understand non resident relevant statistic,3.200000047683716,0.40105592871250006,2014,3248,-1234,1522756
2387,see ufo warsaw past,respectfully submit steve see ufo warsaw past,4.0,0.6783031568895885,3982,4432,-450,202500
2388,depend action long tune agenda moment,depend action bonny tune agenda,4.599999904632568,0.7000952773378969,4128,5236,-1108,1227664
2389,agree claim,admit verify claim,3.799999952316284,0.31407509347620477,1506,4207,-2701,7295401
2390,zimmerman say suck punch car,friend confront car,2.400000095367432,0.15196561500641836,791,2210,-1419,2013561
2391,war middle east,war middle east,4.599999904632568,1.0,5625,5238,387,149769
2392,pro life opposition legalize abortion,fro life refer opposition abortion,3.799999952316284,0.5070826507575676,2706,4206,-1500,2250000
2393,capital gain rate percent,income rate percent,2.799999952316284,0.4700712270277815,2451,2688,-237,56169
2394,time reason hobbies vessel fill wonder,theme song cheer vessel fill wonder,2.799999952316284,0.32150085371354276,1545,2693,-1148,1317904
2395,willfully ignorant,lol ignorant,4.0,0.48901407237897243,2577,4466,-1889,3568321
2396,vessel fill wonder,single lock hobby helm vessel fill wonder,3.0,0.5183777665555409,2783,2772,11,121
2397,problem money,problem money,2.4666666984558105,1.0000000000000002,5731,2327,3404,11587216
2398,badly word accept taxpayer money,word accept taxpayer money save company,2.799999952316284,0.7014544531424709,4143,2696,1447,2093809
2399,muslims thing,sinus thing bhagavad white,1.0,0.30614252773849093,1461,1055,406,164836
2400,confusion liar,confusion liar,3.799999952316284,1.0,5621,4205,1416,2005056
2401,christians extreme simply religion,muslims extreme terrorist,1.600000023841858,0.3138582258985068,1503,1496,7,49
2402,believe right important,believe slaughter unborn important,1.2000000476837158,0.5314630019456532,2884,1136,1748,3055504
2403,evolution opinion belief,atomic theory opinion belief,1.600000023841858,0.5340379435064324,2906,1500,1406,1976836
2404,claim right decide woman body,want decide woman body,2.799999952316284,0.6529465552293259,3800,2702,1098,1205604
2405,world paul,world medium,0.800000011920929,0.37211253605690975,1826,762,1064,1132096
2406,remain missile pentagon,remain pentagon,2.400000095367432,0.8546537280298274,5185,2182,3003,9018009
2407,point quote say rehabilitation work,trillion time say rehabilitation work,3.400000095367432,0.5309619772396136,2877,3681,-804,646416
2408,billion world mexico current prosperity level,world current prosperity level northwest africa,1.5333333015441897,0.7082319112548865,4202,1451,2751,7568001
2409,hair pretty thing quote,hair pretty thing wood,3.799999952316284,0.746806059192342,4508,4176,332,110224
2410,stop joke marriage,fight marriage,1.2000000476837158,0.40739057573486454,2048,1123,925,855625
2411,think poor people responsible action,people responsible action,1.600000023841858,0.7307270128016592,4375,1501,2874,8259876
2412,transaction place,transaction place,2.400000095367432,1.0,5619,2180,3439,11826721
2413,baggage attach,thing,0.0,0.0,379,245,134,17956
2414,vessel fill wonder,little love heart vessel fill wonder,3.5999999046325684,0.60614627333341,3453,3906,-453,205209
2415,problem money,problem money,2.4666666984558105,1.0000000000000002,5734,2326,3408,11614464
2416,make think owl participate,participate,1.600000023841858,0.5192576542223347,2793,1477,1316,1731856
2417,ll look forward see build,take forward see,1.7999999523162842,0.6020123442802316,3418,1704,1714,2937796
2418,originally post jack,originally post izzy,1.2000000476837158,0.5046266406303117,2693,1148,1545,2387025
2419,thank bandy start thread,bandy thank start today,4.800000190734863,0.7225128183696308,4310,5389,-1079,1164241
2420,,,1.0,0.0,382,1061,-679,461041
2421,owe dollar problem,owe trillion dollar problem,2.200000047683716,0.8142660627905705,4946,2121,2825,7980625
2422,evidence provide support position reject,position unverifiable reject,4.800000190734863,0.479874114815608,2511,5355,-2844,8088336
2423,current prosperity level mexico,world current prosperity level northwest africa,1.399999976158142,0.6937647063130559,4091,1421,2670,7128900
2424,rush get zero credit budget,drama get zero credit budget,1.7999999523162842,0.8409635745566862,5107,1689,3418,11682724
2425,lol test drive vehicle,test forearm,0.800000011920929,0.25054587977871656,1175,793,382,145924
2426,think movie good find confuse way,think good find confusing,3.200000047683716,0.37083028887149916,1812,3255,-1443,2082249
2427,god exist morally wrong,ask god exist morally wrong,5.0,0.9207627440759298,5485,5492,-7,49
2428,law constitutional conflict constitution,unconstitutional mean violate constitution,3.5999999046325684,0.24926539335880113,1166,3907,-2741,7513081
2429,originally post muslin girl loop sorry,originally post muslin girl complete impossibility,1.2000000476837158,0.5565237730710285,3081,1134,1947,3790809
2430,country,country,1.399999976158142,1.0,5611,1289,4322,18679684
2431,originally post zat suppose water middle make difference,originally post zat long term yes,1.0,0.450861470271707,2309,1067,1242,1542564
2432,throw game,die loss throw game,4.199999809265137,0.7475381800309289,4510,4899,-389,151321
2433,edit wash edit properly mask profundity,edit wash edit properly mask profundity quote post,4.800000190734863,0.9284026941897265,5509,5409,100,10000
2434,jury tell jury nullification,quote provide jury nullification,1.600000023841858,0.6375308812217346,3698,1484,2214,4901796
2435,run victim proof,paranoid proof,1.0,0.517837533134757,2774,1076,1698,2883204
2436,use search button,use search button,4.199999809265137,1.0,5614,4897,717,514089
2437,think paul shot,paul shot,3.5999999046325684,0.853092702072422,5180,3908,1272,1617984
2438,time reason hobbies vessel fill wonder,boy world vessel fill wonder,3.200000047683716,0.47330385267538216,2469,3262,-793,628849
2439,notice nonsensical thing say,fair notice nonsensical thing say,4.5714287757873535,0.8730378893491889,5289,5149,140,19600
2440,miss study,personal bias,1.0,0.0,384,1077,-693,480249
2441,specifically baptist,specifically gnostic,1.2000000476837158,0.5028916908358049,2677,1109,1568,2458624
2442,large east coast,part west coast,0.800000011920929,0.45871190404829265,2362,833,1529,2337841
2443,talk woman hebrew tribe,talk woman war bounty,1.399999976158142,0.21445145877929261,1030,1385,-355,126025
2444,night japanese force attack long long,night japanese force attack philippine islands,2.5999999046325684,0.5409801847669798,2960,2447,513,263169
2445,definition life force,definition soul,3.5999999046325684,0.4799412955169268,2514,3832,-1318,1737124
2446,direct responsibility constituent,eye responsible constituent,2.5999999046325684,0.40744198820691935,2050,2424,-374,139876
2447,ideology build violent expansion yes violent expansion,ideology build violent expansion race superiority,4.0,0.7410664282301223,4464,4509,-45,2025
2448,enema,enema,4.599999904632568,1.0,5622,5244,378,142884
2449,final word ignore effect normalizing,take advantage effect enforce,0.4000000059604645,0.22625732432899287,1068,519,549,301401
2450,problem likely mean corrective change scuttle fleet start fly,say problem need correct space scuttle fleet clear fly,4.400000095367432,0.4768192367990062,2501,5058,-2557,6538249
2451,sec chairman william donaldson say build confidence cop beat,think building confidence cop beat,3.400000095367432,0.5015380862410983,2668,3480,-812,659344
2452,myanmar pro democracy leader hung return home late friday remain detention recover surgery cannon hospital personal physician say,myanmar pro democracy leader hung keep house arrest follow release hospital undergo surgery personal physician say friday,4.599999904632568,0.6456892676056636,3754,5245,-1491,2223081
2453,warren pp spitzer spokesman decline comment late thursday,john seine spokesman commission washington decline comment spitzer criticism,1.399999976158142,0.4456514124460831,2287,1411,876,767376
2454,afternoon trading europe france advanced britain ftse gain percent germany dax index rise percent,europe france rise percent britain ftse decline percent germany dax index gain percent,2.0,0.8350602241501864,5079,1779,3300,10890000
2455,ten john merry mob graham decline invitation speak,show ten john merry massachusetts mob graham florida,3.5999999046325684,0.6014381077074138,3412,3910,-498,248004
2456,age say possible genet y chromosome influence gender specific difference disease susceptibility,add genet y play role influence gender specific difference disease susceptibility,4.400000095367432,0.7620441445053087,4612,5072,-460,211600
2457,study face temperament people respond novelty,defining study characteristic temperament people react novelty,4.800000190734863,0.5833764733005545,3272,5411,-2139,4575321
2458,butterfly expose early light cycle pm orientate south east,butterfly house early light cycle fly southeast,4.599999904632568,0.5056234031653758,2699,5247,-2548,6492304
2459,dunlap win swimsuit competition talent portion competition singe,win talent portion singe win evening wear,2.799999952316284,0.48774598753615356,2566,2738,-172,29584
2460,south asia follow million youth infect percent female,million infect south asia female,4.0,0.7891508091726409,4795,4519,276,76176
2461,hour later israel helicopter fire missile car papa city kill james official people,hour later israel attack helicopter raise missile car papa city kill seven people palestinian source say,4.25,0.7095602395327084,4215,4939,-724,524176
2462,aaa spokesman merry say price affect plan cheap hotel deal mitigate effect,aaa spokesman merry say price affect plan cheap hotel deal,5.0,0.873728607831478,5298,5489,-191,36481
2463,counter million say turner war break contract cut key editorial decision,counter million say break contract cut key editorial decision manipulate magazine financial figure,3.5,0.6989319268471439,4123,3714,409,167281
2464,standard edition processor name user,standard edition single processor version oracle standard edition database,2.5,0.6699949381783176,3919,2357,1562,2439844
2465,microsoft acquire virtual buy asset connectix early year,microsoft acquire virtual developer connectix early year,4.400000095367432,0.7813998119249703,4732,5068,-336,112896
2466,leon williams body find inside floor apartment tompkinsville,dead man leon williams find floor apartment,3.400000095367432,0.7118221118938604,4234,3425,809,654481
2467,drill september terrorist attack new work washington,nation large scale counterterrorism exercise kept terrorist attack,4.0,0.18424217845905355,927,4479,-3552,12616704
2468,cruel risen confirm operate coach give detail passenger mixed age,cruel risen confirm operate coach decline detail passenger mixed age,4.800000190734863,0.9589567250455073,5568,5441,127,16129
2469,total case confirm southern city mavra organization say,total confirm case cholera report yesterday world health organisation southern iraqi city mavra,3.5999999046325684,0.5996162280858012,3401,3912,-511,261121
2470,expect visit semen bahrain tour region,khatami arrive beirut monday visit syria semen bahrain,3.400000095367432,0.4196480035448186,2122,3423,-1301,1692601
2471,general eyes tell reporter blush look like rule break,blush look like rule break say men richard eyes chairman joint chiefs staff,3.5999999046325684,0.5620516982142423,3116,3915,-799,638401
2472,prove millville son sacrifice mayor james ruin order city flag fly half mast day,millville yesterday mayor james ruin order city flag fly half staff day,3.400000095367432,0.7133785927652959,4246,3433,813,660969
2473,tom kraynak manager operation resource wanton ohio base central area reliability council say scenario investigator consider,tom kraynak manager operation resource wanton ohio base central area reliability council say investigator consider scenario,4.25,1.0000000000000002,5746,4946,800,640000
2474,find molecule produce ozone break cholestrol,sample contain molecule produce cholestrol interact ozone,4.25,0.7034365735221078,4164,4934,-770,592900
2475,store gigabyte information equivalent hour music cubic centimetre,store gigabyte information equivalent high quality image hour music cubic centimetre,3.845999956130981,0.8693426367959203,5265,4332,933,870489
2476,early month rim say expect report second quarter earning cent cent share,exclude legal fee charge expect loss cent share,1.2000000476837158,0.3050571594171769,1453,1107,346,119716
2477,lewinsky imbroglio like vicious scandal manufacture political opponent accord extract release yesterday,lewinsky imbroglio like vicious scandal manufacture political opponent mrs clinton write,3.200000047683716,0.725431065513608,4327,3245,1082,1170724
2478,wire transfer company account total billion prospector say,fire transfer account open deacon total billion morgenthau say,3.799999952316284,0.5417150293986707,2967,4182,-1215,1476225
2479,stony rook university launch study early study indicate possible connection electromagnetic field cancer,state university stony rook launch study early study indicate possible connection,3.200000047683716,0.8774382607831451,5313,3244,2069,4280761
2480,early defy police order cry allah bar god greatest astir walk seat tightly guard courtroom,early astir supporter defy police order cry allah bar god great walk seat,4.0,0.7285981775685975,4352,4473,-121,14641
2481,metropolitan ambulance spokesman james owe say people take hospital treat scene yesterday incident,spokesman james owe say child age take hospital neck chest injury treat scene,3.3329999446868896,0.5208854914543251,2801,3406,-605,366025
2482,clear joint intelligence committee involve,report clear joint intelligence committee,2.0,0.8383750528744014,5095,1959,3136,9834496
2483,twentysomething obese roughly pound healthy weight,percent americans obese roughly pound healthy weight,2.5999999046325684,0.8098434866885793,4928,2381,2547,6487209
2484,doubling american version hit british comedy valuable thursday time slot,doubling american version hit british comedy couple friends thursdays,3.0,0.5765238398251066,3221,3068,153,23409
2485,body find week later green river,dug remain shopman kinds hills find green river,2.5999999046325684,0.28282564937482013,1341,2376,-1035,1071225
2486,fighting continue midnight western rebel commander humane coulibaly tell letters satellite phone sunday,ransack burn village completely rebel commander humane coulibaly tell letters satellite phone bush,2.799999952316284,0.5944843353923166,3367,2679,688,473344
2487,reading august july well see survey begin august,high reading index create august,3.0,0.5385461956622491,2942,3058,-116,13456
2488,special forces troop train colombian soldier military basis region protect pipeline transport crude colombia second big oil field,special forces troop train colombian soldier military basis region protect pipeline,3.200000047683716,0.7795299671429124,4718,3219,1499,2247001
2489,need certifiable pay budget mid july school will not open september strayhorn say,texas lawmaker close million budget gap middle july school will not open september comptroller parole newton strayhorn say thursday,2.5999999046325684,0.4550763405641966,2340,2374,-34,1156
2490,share hartford rise new work stock exchange composite trading,share hartford percent midday trading,2.5,0.532210503233624,2890,2358,532,283024
2491,dvd cca appeal state supreme court,dvd cca appeal decision supreme court,4.5,0.896872668217321,5399,5146,253,64009
2492,country music station kkcs suspend disc jockey play song pirie thick violation ban impose group member criticize president george rush,radio station suspend disc jockey lock studio continuously play pirie thick song violate station month old ban group music,3.25,0.5534930050647336,3062,3368,-306,93636
2493,sovereign share lose cent,sovereign share close new work stock exchange cent percent,4.0,0.5790538781781237,3240,4521,-1281,1640961
2494,aspen technology share drop cent percent close nasdaq,afternoon trading aspen share cent percent share,2.200000047683716,0.5741240993288763,3206,2134,1072,1149184
2495,new law require library school use filter lose federal financing,ruling reinstate law tell library install filter surrender federal money,2.799999952316284,0.39227936596467267,1949,2680,-731,534361
2496,addition offer united states israel way work draft,prime minister position establish spring offer united states israel way work draft,3.5999999046325684,0.6382475645550308,3701,3925,-224,50176
2497,yes warily monroe definitely story title arthur miller lie kazan blacklist,note subheading terrible payable american masters series arthur miller lie kazan blacklist,2.5999999046325684,0.4116016644529284,2076,2420,-344,118336
2498,gilroy police fbi agent describe hear cooperative say saturday reveal happen child,saturday official california describe hearing cooperative say reveal happen child,3.799999952316284,0.5945624541428941,3369,4183,-814,662596
2499,scribner body find float city mortgage live wife houseboat,kayaker find scribner body float near doctor houseboat mortgage eat lunch wife ethel leave appointment,3.200000047683716,0.6033422125728747,3429,3226,203,41209
2500,protest rush stage twice cut power microphone edge draw speech early close,protest rush stage twice cut power microphone edge cut speech short,5.0,0.81316601239545,4943,5501,-558,311364
2501,pass find man hide dirt road spanish work canyon hand tap foot free,pass find boy hide dirt road spanish work canyon thursday foot free hand tap,4.0,0.9347789896313186,5519,4478,1041,1083681
2502,doctor boy die brain damage possible survive,doctor say boy die survive brain damage possible,5.0,0.9773695857915555,5577,5487,90,8100
2503,miss ll garden sort north texas vehicle sweep turnpike,victim recover tuesday morning ll garden sort north texas,2.200000047683716,0.532459330338127,2894,2069,825,680625
2504,british base glaxosmithkline say early year cut supply canadian drugstore ship united states,glaxosmithkline drugmaker say cut supply canadian store ship drug,4.199999809265137,0.549778080835117,3032,4824,-1792,3211264
2505,festival kick yesterday day competition commission deliver final verdict government propose billion merger,competition commission deliver verdict yesterday propose merger big itv player carlton canada,2.818000078201294,0.5877126058916462,3302,2751,551,303601
2506,say persist eventually allow fix bike sit seat car,say eventually allow fix bike sit car chat,3.875,0.7308367799556497,4377,4336,41,1681
2507,daniel say know rush tonight person presidential fund raise,daniel say know rush tonight person reception raise fund presidential election bid,4.400000095367432,0.8445461214850903,5130,5070,60,3600
2508,judge panel circuit court appeals rule late friday small size limited use secular purpose image legitimate,judge panel th circuit court appeals louis overturn ruling issue year support ordinance,2.799999952316284,0.35819132531146963,1745,2707,-962,925444
2509,family frog know identify describe,family frog know name,3.799999952316284,0.8561712519671526,5199,4184,1015,1030225
2510,official grandees say extremely heartrende time camp,extremely heartrende time entire grandees university community,4.400000095367432,0.6745443037735688,3948,5046,-1098,1205604
2511,value total million include convertible security accord morel,include convertible security total estimate value deal million accord morel,5.0,0.9040407846887861,5429,5681,-252,63504
2512,start super bowl diam lose washington,play season diam include dolphin loss washington super bowl,3.0,0.5746590464656206,3210,2952,258,66564
2513,enterprise sinus services expect available end year,beta version enterprise sinus services expect available certain proliant serve july,2.6670000553131104,0.591503876590463,3344,2531,813,660969
2514,exclude time item company enjoy profit cent share,exclude time item expect profit cent cent share,2.3329999446868896,0.7720078319816758,4665,2169,2496,6230016
2515,question motive deskbound president assume garb warrior purpose speech,word speak senate floor say question motive deskbound president assume garb warrior purpose speech,3.0,0.8581683012057821,5213,2953,2260,5107600
2516,broad standard door index fall point percent,technology lace nasdaq composite index add point percent,1.3329999446868896,0.3164845040181748,1519,1264,255,65025
2517,instead ticket jersey jam go sale night ticketmaster,ricket available ticketmaster go sale yesterday,3.799999952316284,0.34434473847760483,1681,4185,-2504,6270016
2518,early monday grant thornton repeat previous statement victim fraudulent action,grant thornton claim victim fraud,3.400000095367432,0.4603962514310287,2373,3490,-1117,1247689
2519,peter man pal marian berkeley school information management systems information production increase percent year,task appeal master megabyte peter man pal marian professor university california berkeley school information management systems,2.0,0.6236424965113897,3582,1902,1680,2822400
2520,judgment percent information classify uncensored american people know,judgment percent information classify uncensored american people know shelby say nbc feet dress,3.400000095367432,0.759528188969673,4597,3501,1096,1201216
2521,research find cavity scar tissue tumour,tumour detect cavity scar tissue find place,4.0,0.7912998170879155,4808,4488,320,102400
2522,washington say need prevent complaint file place,insist want prevent complaint file place preferably repeat entire law,2.799999952316284,0.49755869530764163,2645,2737,-92,8464
2523,hour surgery year anticipation boy separate sunday children medical enter dallas,year old egyptian twin boy bear head conjoin separate hour surgery children medical centre dallas,3.200000047683716,0.5965816902308377,3386,3239,147,21609
2524,line say convene relevant party body day discuss new election hold temporary leader appoint,mitzna party secretary pair lines agree convene party organization day discuss new primary hold temporary leader appoint,3.5999999046325684,0.5846626317102186,3282,3917,-635,403225
2525,neuro soar sign trading slip slightly trading open europe,neuro soar sign trading slip late european trading late monday,3.5999999046325684,0.6812878737328814,3995,3918,77,5929
2526,bias tell summit end armed intefadeh renounce terrorist israelis allude discarding militant,wednesday summit bias pledge end armed intefadeh renounce terrorist israelis allude discarding militant,4.199999809265137,0.916649799493878,5472,4828,644,414736
2527,god ribbons academy spokesman say academy shock sadden,naval academy spokesman god ribbons say today announcement come surprise,3.25,0.5451214947001217,2992,3360,-368,135424
2528,share lendingtree rise percent hit early,lendingtree share rise percent double month,2.75,0.6650376385942789,3889,2567,1322,1747684
2529,week lawyer ask earner grant clemency condition lead new sentencing hearing,week lawyer ask sov dark earner grant clemency governor decline intervene,2.5,0.5570575454523841,3085,2334,751,564001
2530,think release year ago say brian rohrbough son daniel kill columbine,brian rohrbough son daniel kill columbine say tape raise disturbing issue,1.75,0.6553839747716053,3821,1618,2203,4853209
2531,cia director george genet say man define education courage,define education courage say cia director george genet,4.25,0.987347335254688,5582,4932,650,422500
2532,software license revenue measure financial analysis watch closely decrease percent million,license sale key measure demand fall percent million,5.0,0.3798442965058556,1879,5682,-3803,14462809
2533,watson arrest charge july reportedly tell authority shoot dennehy dennehy try shoot,watson arrest july tell fbi agent shoot dennehy dennehy try shoot accord arrest warrant affidavit,4.25,0.7555327132079008,4564,4930,-366,133956
2534,prosecutor contend burst plot murder assume black identity,prosecutor maintain burst murder black try assume black identity,4.75,0.7285270448488098,4350,5335,-985,970225
2535,objection cite peoplesoft board reject oracle offer,peoplesoft board recommend stockholder reject offer,2.75,0.5060991373390737,2703,2565,138,19044
2536,black democratic leader attempt arrange meeting dnc chairman merry mcauliffe discuss layoff,black democratic leader try arrange meeting democratic national committee chairman merry mcauliffe discuss layoff minority suffer party headquarters,3.25,0.6967891482796048,4111,3349,762,580644
2537,dark day industry giovanni bisignani director general geneva base organization say statement,dark day industry geneva base international air transport association director general giovanni bisignani say,3.5,0.7872031446285096,4776,3743,1033,1067089
2538,seven nation initiative britain germany italy netherlands poland portugal pain,nation involve psi include germany italy netherlands poland portugal pain britain,3.5999999046325684,0.7518335093077647,4539,3919,620,384400
2539,average american make trip day percent shopping errand,early half percent shopping run errand,3.3329999446868896,0.5098238595459429,2723,3419,-696,484416
2540,strategic win overture give night bidder option sign google service,strategic win overture give night bidder google advertising service,4.0,0.8073601946877744,4908,4410,498,248004
2541,week lead execution florida official receive anonymous threaten letter,florida official connect case receive threaten letter accompany rifle bullet,3.5,0.46465124795819246,2399,3734,-1335,1782225
2542,boy confirm woman age tuesday say leave vacation family,boy confirm woman age tuesday say vacation family expect return week,3.400000095367432,0.8108676644891535,4933,3434,1499,2247001
2543,boston catholic archdiocese boston offer million settle clergy sex abuse lawsuit accord document obtain associated dress,american woman catholic archdiocese boston offer million settle sex abuse lawsuit involve priest,3.5999999046325684,0.6608350295304574,3858,3920,-62,3844
2544,hour recording include conversation police firefighter emergency worker medium inquiry,conversation police firefighter emergency worker medium inquiry,3.5999999046325684,0.8316301375554964,5057,3921,1136,1290496
2545,year bond jump take yield percent percent,year bond dip yield percent percent,2.0,0.8189562390111689,4978,1886,3092,9560464
2546,candidate win national labor endorsement far pick union tuesday united steelworkers america endorse,candidate win national labor endorsement far pick tuesday,3.5999999046325684,0.756571468767866,4568,3922,646,417316
2547,oracle share fall cent percent,oracle share rise news cent nasdaq,1.600000023841858,0.6079078491211742,3468,1578,1890,3572100
2548,north american future point sub par start trading tuesday investor ready taste quarterly earning,north american stock market get slow start tuesday investor ready taste quarterly earning,4.599999904632568,0.6998661411725079,4127,5248,-1121,1256641
2549,market broad gauge post big gain having climb high consecutive week,broad market retreat having climb high consecutive week,3.5999999046325684,0.722757460073346,4311,3923,388,150544
2550,jury celebrate father father win major golf championship,father dad major champion,3.0,0.4131669073378241,2089,2939,-850,722500
2551,pass emerson medical educational research foundation limited partnership india,say patient allegedly assign india emerson medical educational research foundation limited partnership,2.400000095367432,0.7974995805383981,4846,2191,2655,7049025
2552,sia say dram market expect grow percent billion percent billion,american market decline percent billion grow percent billion,1.2000000476837158,0.7006911160150417,4136,1137,2999,8994001
2553,morrill wife lie sob hug bondeson sister law service,service morrill widow lie sob hug bondeson sister law people console,3.400000095367432,0.8040582865543701,4886,3440,1446,2090916
2554,grassley caucus reject disparity drug benefit,grassley caucus say reject approach plan,3.0,0.5380572419244385,2939,2944,-5,25
2555,year ago quarter steelmaker record profit million cent share sale billion,second quarter year steel report profit million cent share,3.400000095367432,0.5101523945276188,2727,3542,-815,664225
2556,nasdaq weekly gain percent close friday,teach lace nasdaq composite rally point percent,1.7999999523162842,0.22211520136531493,1056,1647,-591,349281
2557,brazen intimidation people reservation say republican attend want name,brazen attempt intimidation say republican legislator attend meeting,3.5,0.6300468566677982,3628,3695,-67,4489
2558,charge announce statement say legal proceeding expect monday,fbi statement say legal proceeding expect monday federal court baltimore,2.75,0.6444252755360311,3743,2539,1204,1449616
2559,dead woman wear ring cartier watch,blood haired woman wear cartier watch wrist source say,2.5999999046325684,0.49967680010862103,2655,2406,249,62001
2560,teach heavy nasdaq stock markets composite index add point cent,nasdaq composite index technology stock lately point,2.200000047683716,0.48142207927558395,2520,2127,393,154449
2561,fbi keep tabe al bayoumi receive information maude agent document say,bureau keep tabe al bayoumi despite receive prior information secret maude agent report say,4.75,0.7037381215473283,4168,5321,-1153,1329409
2562,go happen say santangelo president teamster joint council ll,affect company big time say santangelo president teamster joint council ll,1.5,0.7691438756012154,4651,1426,3225,10400625
2563,release million bail immediately return begin fill video,post million bail jackson fly begin work video,3.75,0.5336928704983253,2902,4018,-1116,1245456
2564,partner analysis say business feel confident upgrade corporate,company feel confident replace old analyst firm say,3.5,0.3047901728393584,1447,3699,-2252,5071504
2565,tuesday health care worker quarante,addition people quarante thousand health care worker working quarante,1.5,0.7300258502021146,4364,1428,2936,8620096
2566,brian brabazon say son upset turn befriend hunter,son upset mon say turn befriend hunter,3.200000047683716,0.7455397952173766,4500,3317,1183,1399489
2567,teach heavy nasdaq stock markets composite index add point,nasdaq composite index technology stock lately point,2.200000047683716,0.5018363262106195,2672,2066,606,367236
2568,technology lace nasdaq composite index dip point,technology lace nasdaq composite index add point percent,2.400000095367432,0.7821811478327758,4737,2204,2533,6416089
2569,tell jury tubes cold calculate killer,district attorney lupus remind rumor tubes cold calculate killer,3.0,0.5888474238869017,3312,2997,315,99225
2570,likewise year bond slide yield percent percent,year bond jump take yield percent percent,1.7999999523162842,0.7599429478765567,4603,1637,2966,8797156
2571,seventh victim woman die tuesday night burn unit child hospital medical enter akron,seventh person year old woman critical condition burn unit akron children hospital,2.400000095367432,0.5442906824183537,2985,2203,782,611524
2572,man immediately fly nearby botswana charter air kalaw flight kalaw intelligence official say condition anonymity,man fly nearby botswana air kalaw flight official say,3.532999992370605,0.7729079857426346,4669,3745,924,853776
2573,exchange north require end nuclear weapon program,return expect north nuclear weapon,4.75,0.41761916194251414,2110,5331,-3221,10374841
2574,condemn denounce governing council head united states moqtada al say,condemn governing council head united states say fiery sermon sofa mosque near ajar,3.3329999446868896,0.48957905682474745,2582,3404,-822,675684
2575,sendmail say system set permit business usage,product instruct permit business use accord sendmail,5.0,0.520721605148167,2800,5691,-2891,8357881
2576,exploit work snatch windows machine service,counterpaned defense contend exploit work effectively windows system run service,3.0,0.4977448008722588,2647,3004,-357,127449
2577,curve benchmark year note shed price take yield percent percent,early wednesday benchmark year lose price drive yield percent percent late tuesday,3.0,0.5728382158454629,3202,2977,225,50625
2578,lech stock hurt sour forecast run microsystems view bad oman come quarterly earning season,sour forecast run microsystems pressure street quarterly earning season,3.0,0.668340752505847,3907,2970,937,877969
2579,share joke cent afternoon trading wednesday new work stock exchange,share joke cent close new work stock exchange,1.8459999561309808,0.7646069028619207,4631,1773,2858,8168164
2580,rest young deny wrongdoing plan fight allegation,rest young deny sec claim call recommendation irresponsible,3.0,0.3446012651431769,1683,2974,-1291,1666681
2581,military action large scale bribery solve north organ problem wolfowitz say,wolfowitz admit saturday military action large scale bribery solve issue,3.0,0.7427527725456101,4477,2976,1501,2253001
2582,driver eugene rogers help remove child bus good say,accident scene driver cover blood help remove child good say,3.200000047683716,0.5354333525553349,2921,3320,-399,159201
2583,broad standard door index point percent,teach lace nasdaq composite index gain point percent,1.0,0.3293422260921617,1591,915,676,456976
2584,share guidant plummet trading new work stock exchange news halt impose midday,share guidant percent afternoon trading new work stock exchange,2.6470000743865967,0.6034757678310367,3430,2527,903,815409
2585,week october go sale monday nearly year washington supper shooting start,loose book go sale monday nearly year supper shooting start washington area,3.25,0.7301093295211568,4366,3345,1021,1042441
2586,base separate survey household unemployment rate fall august percent percent,labor department analysis dismount slight improvement national unemployment rate fall august percent percent,3.75,0.4596686763594561,2364,4017,-1653,2732409
2587,rate skin cancer triple norway sweden accord study,study find skin cancer nearly triple norway sweden,4.75,0.8491939622244581,5158,5323,-165,27225
2588,judge refuse postpone trial date kept,bus deny defense motion postpone kept trial date,3.928999900817871,0.6216168189822461,3572,4339,-767,588289
2589,opposition party welcome cabinet decision anti retroviral treatment say health minister santo tshabalala msimang fit preside roylott plan,health minister santo tshabalala msimang fit preside anti retroviral treatment roylott plan accord opposition party,3.400000095367432,0.8918030339454331,5380,3478,1902,3617604
2590,chief merchandising officer overseer buying development merchandise decide merchandising direction company basically stand,decide merchandising direction company basically stand,3.200000047683716,0.7325388214111906,4394,3322,1072,1149184
2591,christopher spokesman archdiocese comment friday,christopher spokesman archdiocese immediately return call seek comment,3.799999952316284,0.7328486920710249,4399,4186,213,45369
2592,relative australian victim attack court witness proceeding balinese attend trial,relative australian victim attack sit row court balinese attend trial,4.599999904632568,0.783702186612081,4743,5246,-503,253009
2593,july team singaporean police officer send baghdad,july singaporean police officer send baghdad help train iraqi police force return home month,3.200000047683716,0.6754912440317999,3954,3318,636,404496
2594,neuro percent dollar rise month high early session,early trading neuro percent rise month high,2.200000047683716,0.7432919684020918,4483,1990,2493,6215049
2595,previously report profit million cent share period,previously report small profit million break share basis period,4.400000095367432,0.7583129473984109,4586,5039,-453,205209
2596,coalition campaign group include militant national student body back protest nlc call defiance court order bank,coalition campaign group include militant national student body back action mobilize protest,3.3329999446868896,0.6510347308490925,3785,3402,383,146689
2597,company highlight addition support enterprise application environment eae new mainframe,company add support enterprise application environment development tool rapp say,4.0,0.48479060473158553,2538,4352,-1814,3290596
2598,draft service rack record accident death,conquered safety record include accident result death,1.3329999446868896,0.3556357200436532,1737,1261,476,226576
2599,harvey outfielder dunedin high school florida select sixth pick chicago tubs,harvey high school outfielder florida choose sixth tubs,4.199999809265137,0.7269374809088072,4336,4801,-465,216225
2600,lover speak news conference include relative victim,family member victim invite news conference,3.200000047683716,0.4040916573441987,2031,3304,-1273,1620529
2601,man charge june plead guilty,defendant plead guilty weapon charge count,3.200000047683716,0.5721584444179864,3197,3282,-85,7225
2602,federal local government remained largely shut aftermath hurricane isabel school region transportation network slow,aftermath hurricane isabel federal local government remained shut school business,3.25,0.754593690666403,4559,3347,1212,1468944
2603,give surprisingly impassione speech united steelworkers america announce endorsement yesterday,tuesday pick endorsement united steelworkers america,2.25,0.5686106850230699,3174,2161,1013,1026169
2604,million phone number register list effect act,ftc sign million phone number list effect october,3.5,0.6126544479138724,3511,3693,-182,33124
2605,second hit,water second,2.200000047683716,0.5673983372369844,3163,1982,1181,1394761
2606,dora naacp state president say state try prove conclusion suicide consider possibility murder,dora naacp state president say state refuse consider possibility murder,3.400000095367432,0.7806099081786685,4725,3670,1055,1113025
2607,activist fear gathering attempt corporate farming push big engineer crop starve country,instead fear conference attempt corporate farming bitch interest push new market,3.0,0.4648041701825589,2403,2938,-535,286225
2608,contract expire wednesday instead sunday say organize director united good commercial workers local,outrage membership say organize director united good commercial workers local,2.5,0.6639952605784298,3884,2355,1529,2337841
2609,technology lace nasdaq composite index rise point percent lose percent tuesday,blue chip bones industrial average jump point percent sink percent day early,1.75,0.26376938269680833,1250,1603,-353,124609
2610,customer power area oklahoma electric say,oge energy customer power company say web site,2.75,0.34173324122561843,1665,2557,-892,795664
2611,glance american husband year old roger lawrence trunk face murder indictment issue february philippine government say lead suspect,glance husband year old roger lawrence trunk gray face murder indictment issue philippine government february,4.25,0.8874885209015477,5355,4929,426,181476
2612,prince replace afford bandy remain citigroup chairman,prince head citigroup global corporate investment bank replace afford ceo,3.0,0.5583708893125683,3089,2934,155,24025
2613,operating revenue billion increase year result billion,operating revenue rise billion billion year,5.0,0.8329490635287236,5068,5701,-633,400689
2614,spot gold quote ounce gmt having march level see february,spot gold quote ounce gmt having dart high level see february,3.25,0.8624009262324017,5233,3350,1883,3545689
2615,canada booming dollar focus try stay cent mark,canada surge dollar focus struggle fail stay cent mark,4.0,0.6474507234097786,3768,4344,-576,331776
2616,justice rule police supervisor repeatedly question martinet violate fifth amendment right,justice rule police supervisor repeatedly question martinet scream pain violate fifth amendment right,3.75,0.9133346059255754,5455,4014,1441,2076481
2617,blue chip bones industrial average cease point percent score consecutive session,bones industrial average rise point percent,2.0,0.5626793754538566,3122,1934,1188,1411344
2618,center president joseph torsella strike head able walk ambulance,national constitution enter president joseph torsella hit head knock knee,3.3329999446868896,0.4295574187579126,2180,3408,-1228,1507984
2619,report range large company base employment marketing procurement community investment charitable donation,millard respond survey range large company employment marketing procurement community investment charitable donation,3.0,0.832651877190411,5066,2958,2108,4443664
2620,know person talk end time follow rule parish say,know person talk end parish say,3.400000095367432,0.786811853180875,4767,3574,1193,1423249
2621,suffer attorney murder charge authority say,suffer lawyer murder charge authority say,5.0,0.7992206118314062,4859,5692,-833,693889
2622,pass effect law illegal bar restaurant patron light,pass effect smoking law prevent bar restaurant patron light exempt private club regulation,3.400000095367432,0.6415461374573869,3722,3578,144,20736
2623,trial suspect year ali nightclub coming kill people open indonesia today sky news report,key suspect october nightclub coming kill people ali go trial monday amid tight security,3.75,0.49353541561809133,2612,4013,-1401,1962801
2624,french retire increase fifth population,retire account population fifth today,4.0,0.6639851122743579,3883,4368,-485,235225
2625,iraqi police open fire downtown baghdad today demonstrator storm police station demand give job claim pay bribe,iraqi police open fire downtown baghdad wednesday demonstrator demand job storm police station throw stone officer police say,3.25,0.7406801092351175,4460,3357,1103,1216609
2626,bones industrial average add point percent hit high level month,bones industrial average rise point percent,2.25,0.6720904531804403,3935,2144,1791,3207681
2627,quarter year eds declare profit million cent share,eds report quarter loss million cent share,1.5,0.687600656766659,4048,1434,2614,6832996
2628,microsoft fall percent open thursday close,share microsoft slip percent hour trade nasdaq close,3.0,0.3857601875901332,1913,3057,-1144,1308736
2629,extraordinarily fast say watt seller analyst cibc world markets,actually go record sale decade year say watt seller analyst cibc world markets,2.25,0.6745155519789425,3947,2149,1798,3232804
2630,rebel government force accuse pillaging village siberia countryside despite peace agreement,rebel government force include loyal taylor accuse pillaging village siberia countryside despite peace deal,4.0,0.7869089671015022,4769,4391,378,142884
2631,microsoft award patent feature instant essay alert user person communicate put message,microsoft award patent popular instant essay feature show user person end conversation tie message,4.75,0.7567009177600198,4569,5320,-751,564001
2632,arrest reveal new detail month investigation selenski count live road home,kerkowski bassett body unearth selenski count live road home june,1.5,0.48249647692181863,2526,1450,1076,1157776
2633,intend appeal vigorously expect vindicate ultimately,think bad law expect vindicate ultimately,3.066999912261963,0.5438890629135997,2983,3073,-90,8100
2634,kansas law illegal child age sexual relation,opinion line note illegal child young sexual relation,2.75,0.5605439414670712,3102,2538,564,318096
2635,transaction expand callebaut sale revenue consumer product business percent percent,transaction expand callebaut sale revenue consumer product business percent total sale,3.5,0.9095099779578482,5442,3696,1746,3048516
2636,indonesia army accuse human right abuse gam battle independence charge generally deny accuse separatist commit right violation,indonesia army accuse human right abuse early battle gam charge generally deny,3.25,0.7870932044245006,4774,3353,1421,2019241
2637,ran economy ravage year sanction ex president madam russen occupation wait war end april,ran economy shatter president madam russen war end april,3.75,0.6528134775255918,3797,4012,-215,46225
2638,point word refugee english turkish dictionary,man banish english turkish dictionary point word refugee,3.799999952316284,0.8720952856855734,5285,4188,1097,1203409
2639,bulk fund billion military operation ran afghanistan,bulk bill billion go military operation primarily ran afghanistan,4.0,0.7814557175637584,4733,4396,337,113569
2640,colored hoy colorado springs solo help legislation pende congress,colored hoy colorado springs type person help legislation pende congress,4.800000190734863,0.8557610974496839,5197,5450,-253,64009
2641,advance issue outnumber decline new work stock exchange,decline issue outnumber advance slightly new work stock exchange,2.200000047683716,0.9151603962157198,5465,2016,3449,11895601
2642,beauty contest hold italy week fix perfect pin,new beauty contest kick italy week fix perfect pin chance steal sultry sophia sex symbol status,3.25,0.6258114108757779,3601,3355,246,60516
2643,analysis consensus estimate thomson loss share exclude time item,estimate analysis survey thomson loss share,2.5,0.6446445071959167,3746,2344,1402,1965604
2644,board expect decide december meeting offer airplane sale airline,widely expect hair formal approval offer plane sale airline,2.25,0.3732216416099948,1834,2155,-321,103041
2645,rush say resistance force hostile presence feel like condition attack,feel like condition attack,2.75,0.5820692464206721,3261,2551,710,504100
2646,defense lawyer say change venue need massive arterial publicity paint jury pool client,defense lawyer request change venue reason argue massive arterial publicity paint jury pool client,4.75,0.8476081353229801,5150,5328,-178,31684
2647,wound lendingtree exchange consist bank lender broker,lendingtree match borrower internet mortgage broker bank lender,3.5,0.5391864349542663,2950,3700,-750,562500
2648,taxpayer surprise tax cut week july,australia million income taxpayer receive surprise tax cut week treasurer peter costello night,3.25,0.5463174098912835,3002,3356,-354,125316
2649,gyorgy leisler head local disaster unit say coach carry passenger,head local disaster unit gyorgy leisler say coach driver fail heed red stop light,3.0,0.7054698854856667,4176,3042,1134,1285956
2650,suction year private college average year percent,current academic year suction public college average year,1.5,0.6671990818644491,3901,1436,2465,6076225
2651,statewide unemployment rate fall percent revise percent august,unemployment rate joaquin county dip month percent nearly percentage point august,2.0,0.3915423535100243,1944,1862,82,6724
2652,security light instal police sweep ground booby trap,security light instal barn near gate,3.0,0.3954988295351244,1979,2860,-881,776161
2653,troop shrink mount maid attack foe location pinpoint,american troop shrink mount maid location foe pinpoint,4.75,0.9359772157133776,5523,5322,201,40401
2654,moore immediate comment tuesday,moore immediate response tuesday,4.777999877929688,0.7883313018312909,4784,5343,-559,312481
2655,judge order child place state custody dug,dug juvenile court judge robert states order parker place protective custody,3.200000047683716,0.588569003647595,3307,3301,6,36
2656,white house spokesman ri fleischer say yesterday step iranians claim take term capture al insufficient,step iranians claim take term capture al said insufficient,3.200000047683716,0.6929080816632108,4087,3300,787,619369
2657,result release tuesday meeting seattle american thoracic society publish thursday new england journal medicine,study result release meeting seattle american thoracic society publish tomorrow issue new england journal medicine,4.363999843597412,0.8473390143686899,5148,4958,190,36100
2658,dissent join chief justice william rehnquist justice lawrence thomas,chief justice william rehnquist justices antonio scala lawrence thomas dissent,3.799999952316284,0.7444035729422898,4494,4204,290,84100
2659,united pay city million penalty meet round employment target,united pay million penalty fail meet employment target,4.400000095367432,0.8243593545558145,5007,5075,-68,4624
2660,shelled office report friday signature report,shelled office release signature count late friday say county report count signature far,4.5,0.665746513624532,3891,5129,-1238,1532644
2661,rush want aircraft land way pilot see aircraft landing white house press secretary ri fleischer say yesterday,tuesday word speech fleischer say rush want aircraft land way pilot see aircraft landing,4.0,0.7545620599038143,4558,4370,188,35344
2662,stand reporter photographer yard prison gate rent newbury president auckland county patrolmen benevolent association,thing brave fume rent newbury president auckland county patrolmen benevolent association,1.5,0.6549231326341305,3817,1449,2368,5607424
2663,brutally beat wonder porchia deceased case,wonder porchia deceased case tax add,3.0,0.6883391913517785,4054,3030,1024,1048576
2664,glove say unifi official mob,knife official mob say glove,5.0,0.7157694822405565,4262,5694,-1432,2050624
2665,rate whitney say cent engine equipment outsource europe final assembly germany,rate whitney say win contract cent engine equipment outsource european supplier final assembly germany,3.5999999046325684,0.8119253710072158,4939,3914,1025,1050625
2666,staff writer selwyn crawford pollen chain elson brian anderson contribute report,staff writer brandon formby pollen chain elson contribute report,2.799999952316284,0.6195855605556215,3560,2578,982,964324
2667,commerce commission significant hardly deal,new zealand commerce commission give westpac indication approve deal,1.7999999523162842,0.426333241525929,2160,1762,398,158404
2668,prosecutor file motion inform intend seek death penalty,add prospector seek death penalty,3.400000095367432,0.3857171319734858,1912,3589,-1677,2812329
2669,american masters arthur miller lie kazan blacklist red,note subheading terrible payable american masters series arthur miller lie kazan blacklist,3.0,0.7163874983145361,4268,3018,1250,1562500
2670,package include increase city sale income taxis,object sale personal income tax increase package,2.0,0.5495205972610937,3028,1924,1104,1218816
2671,song offer cent album,company offer song cent album,3.3329999446868896,0.9269091227953931,5502,3416,2086,4351396
2672,certainly know suggest say seriously add,know know suggest say seriously say,4.25,0.7494352323877387,4524,4911,-387,149769
2673,follette share rise percent afternoon new work stock exchange trading,share follette close cent trading wednesday new work stock exchange,2.0,0.7202997951047427,4298,1923,2375,5640625
2674,share diego base box close cent percent new work stock exchange,share camp base outback steakhouse close percent new work stock exchange,1.600000023841858,0.56231468419744,3119,1542,1577,2486929
2675,bones industrial climb point mark time december,bones industrial briefly surpass mark time december,3.5999999046325684,0.677050727010893,3968,3903,65,4225
2676,government choose company develop plan protect commercial aircraft shoulder fire missile attack holland security official announce tuesday,department copeland security announce tuesday select company continue research way thwart shoulder fire missile attack commercial aircraft,4.75,0.5182695520108653,2779,5329,-2550,6502500
2677,family party blame liberation tigers family delay ltte killing,government want revive talk liberation tigers family delay ltte discuss interim structure,1.75,0.5660642448522594,3151,1612,1539,2368521
2678,prisons bandy mitchell glasgow glasgow bear william sampson face death penalty,bandy mitchell kirkintilloch glasgow william sampson british citizen bear glasgow face head public,3.25,0.7447039946885871,4495,3352,1143,1306449
2679,urge patience americans eager service intend block percent telemarketing call,free service originally intend block percent telemarketer call,3.0,0.4318364118389108,2198,3052,-854,729316
2680,jordan green relate private lawyer say comment,attorney jordan green decline comment,3.5999999046325684,0.48723730367917284,2561,3882,-1321,1745041
2681,valley new partner child say absolutely delighted,statement issue solicitor valley say absolutely delighted outcome proceeding,3.400000095367432,0.5281369577015708,2845,3606,-761,579121
2682,loss occur overnight pillow canyon area santa natalia mountains threaten week old fire blacken acre,loss occur overnight pillow canyon area santa natalia mountains threaten recurrent aspen fire,3.25,0.7593773053415648,4596,3351,1245,1550025
2683,want stand let credit card lunching place declare major wens d brooklyn,want stand credit card lunching place say,3.5,0.6768581199505543,3965,3697,268,71824
2684,commercial use keener month customer,commercial release keener major sinus distributor remain month away,3.78600001335144,0.4686562480639942,2439,4062,-1623,2634129
2685,broad standard door index advance point percent,nasdaq composite index point percent,0.800000011920929,0.4144765269151821,2096,810,1286,1653796
2686,official initially say worker arrest store state,official later revise number say arrest store,2.400000095367432,0.4515844100910311,2311,2213,98,9604
2687,deal make sense company say prepared statement,brian ceo natsemi claim deal sense company,3.200000047683716,0.3806977827504456,1886,3294,-1408,1982464
2688,seven senator include republicans sign letter,sign letter senator include republicans,4.922999858856201,0.908997530387484,5440,5483,-43,1849
2689,human case west mile virus report yes county health department wednesday,week human west mile case county report health department,2.5999999046325684,0.7952190395954725,4830,2450,2380,5664400
2690,daniel group enter united states walk bridge link matamoros brownsville,daniel group enter way thousand people day walk bridge matamoros brownsville,4.0,0.7394137468968065,4451,4384,67,4489
2691,nasd regulation young file response request hearing nasd panel,analyst let merrily request hearing nasd panel,3.0,0.5910600562505242,3335,3010,325,105625
2692,president begin speech acknowledge terrorist attack maude arabia kill people include seven americans,rush lash terrorist coming maude arabia kill people include number americans,3.200000047683716,0.542893060664342,2973,3292,-319,101761
2693,proud citizen state sov john baldacci say vote referendum count,proud citizen state say sov john baldacci causing foe,3.200000047683716,0.6820385380064461,4003,3291,712,506944
2694,major candidate schwarzenegger dine battle independent crossover voter,schwarzenegger pick independent crossover voter bustamante,3.400000095367432,0.6225040049465593,3576,3558,18,324
2695,replace dittemore announce resignation april,dittemore announce plan resign april,2.5999999046325684,0.5996284574477266,3402,2515,887,786769
2696,selenski previously spend seven year prison bank robbery conviction,selenski serve seven year prison bank robbery,4.571000099182129,0.7188307952414053,4290,5148,-858,736164
2697,maddox crack rib fall day ago assisted living home recover intestinal surgery virginia varies say,maddox battle cancer crack rib early month fall assisted living home recover surgery,3.400000095367432,0.6896030888778462,4065,3552,513,263169
2698,graham presidential candidate criticize republicans politicize report,graham co haired inquiry presidential candidate,2.25,0.4747007821641303,2481,2142,339,114921
2699,linksys overtake disco systems lead tireless equipment vendor account percent revenue,wolfe say linksys overtake disco systems year lead supplier wlan equipment,3.5,0.5670046124311932,3159,3694,-535,286225
2700,school fail meet state goal year row offer tutoring addition transfer,school meet testing goal year row offer transfer,2.75,0.6916547038724243,4081,2547,1534,2353156
2701,hamper medicine lucrative arrest live million dollar home,hamper medicine apparently lucrative investigator say suspect live million dollar home,4.75,0.7864465508638836,4764,5333,-569,323761
2702,say faith system licks try,say yesterday licks fairly treat say faith justice system,4.5,0.5865101321402832,3295,5138,-1843,3396649
2703,smuggler van chase picked suv carry smuggler illegal immigrant say final county sheriff roger vanderpool,people van open fire picked suv believe transport illegal immigrant say final county sheriff roger vanderpool,3.1670000553131104,0.7102758323528378,4222,3077,1145,1311025
2704,trial fear witness continue start,trial early expect hear witness friday,4.5,0.39832432994544825,1993,5136,-3143,9878449
2705,computer reportedly locate canada south,scatter united states canada south,4.75,0.3101982770911934,1482,5336,-3854,14853316
2706,vulnerability affect windows terminal services edition windows server,microsoft issue patch vulnerability affect windows windows terminal services edition windows windows windows server,2.75,0.8762313355499475,5308,2559,2749,7557001
2707,additional contribution bring total food aid north year tone,donation ton bring total contribution year,3.200000047683716,0.5070606588264098,2705,3288,-583,339889
2708,european union banner import genetically modify food united states demand end ban,union banner import genetically modify food consumer fear health risk,2.5999999046325684,0.6283235619478937,3615,2507,1108,1227664
2709,project vanderpool available year,product fear vanderpool release year say,4.400000095367432,0.4187467038077625,2119,5115,-2996,8976016
2710,annika sorenstam get opportunity test objective week mcdonald lpga championship,appetite devour annika sorenstam move entree week mcdonald lpga championship,3.0,0.6355867976450827,3680,2933,747,558009
2711,broad standard door index gain point percent,technology lace nasdaq composite index rise point percent,0.944000005722046,0.31712419610109954,1523,891,632,399424
2712,disco sign similar deal sbc communications print,disco similar relationship bellsouth competitor sbc communications print communications,4.0,0.7290036898947635,4356,4389,-33,1089
2713,harris klebold kill student teacher take life april,harris klebold kill student teacher school,3.799999952316284,0.8155245357236274,4954,4194,760,577600
2714,condemn governing council head united states muqtada al say sermon mosque,condemn denounce governing council head united states moqtada al say,4.199999809265137,0.6289869135681598,3622,4862,-1240,1537600
2715,statement distribute friday chechen non governmental organization say boycott vote,statement distribute today chechen non governmental organization say boycott vote warn voter expect fraud,4.199999809265137,0.7887856665768972,4790,4865,-75,5625
2716,state population accord census,state population grow percent,2.5999999046325684,0.46702591504361257,2427,2388,39,1521
2717,july hulbert file single count felony sexual assault bryant,bryant charge felony sexual assault,3.055999994277954,0.6511456085815409,3789,3071,718,515524
2718,paul chairman chief executive wiseman ceo combine company,wiseman chairman chief executive paul chief executive combine company,4.75,0.8781707872254723,5316,5339,-23,529
2719,instead media decide webster case charge rape sooty indecent assault provide alcohol minor proceed court martial,douglas webster charge rape sooty indecent assault provide alcohol minor,3.25,0.718556679383075,4285,3348,937,877969
2720,similar discovery houston aircraft dallas base southwest say statement,airline say similar discovery plane houston,3.400000095367432,0.5753057876219966,3212,3635,-423,178929
2721,rosenthal decline comment garrett situation tuesday say statement big contract negotiation,creator executive producer phil rosenthal equip statement big contract negotiation,3.75,0.46050988893919487,2375,4001,-1626,2643876
2722,power state worker head job friday morning,pataki say power restore state worker job friday morning,2.5999999046325684,0.7245817819994033,4319,2383,1936,3748096
2723,nasdaq fall month snap seven month winning streak,nasdaq roughly percent month track snap month streak gain,2.400000095367432,0.6586745527765077,3842,2193,1649,2719201
2724,report find act tuck inside old ring binder relate investigation,report find week tuck inside training manual belong licks,3.200000047683716,0.32179945906467855,1548,3281,-1733,3003289
2725,saturday international committee red cross say temporarily close office baghdad mavra,international committee red cross fearful safety staff operate ran announce temporarily shut office baghdad mavra,3.400000095367432,0.6443144022242215,3741,3641,100,10000
2726,ireland palestine solidarity campaign o muireagáin member welcome release,ireland palestine solidarity campaign member say search school exchange project,2.400000095367432,0.6309594900550768,3641,2194,1447,2093809
2727,lover say killer peculiar slipknot ligature strangle victim,lover say killer peculiar slipknot include cordial cable extension cord strangle victim,3.400000095367432,0.6873881396237335,4045,3545,500,250000
2728,say lane toe lawyer ask horizon withhold plan challenge subpoena,lane toe decide fight subpoena ask horizon withhold,3.5999999046325684,0.7645959043581475,4630,3886,744,553536
2729,september year old singapore researcher contract sars work laboratory,case august year old laboratory worker singapore develop sars,3.400000095367432,0.537795667493635,2937,3455,-518,268324
2730,number suggest contraction manufacturing sector number indicate expansion,reading suggest growth sector number level indicate contraction,4.817999839782715,0.6729653655850415,3937,5479,-1542,2377764
2731,lawsuit file attempt block removal men commandments monument building,supporter ask federal court monday block removal men commandments monument alabama judicial building,3.200000047683716,0.5958701423535465,3382,3277,105,11025
2732,fritz earn million salary bonus compensation dinner earn million,johnston million salary bonus president time adviser earn million,1.399999976158142,0.6254058009222919,3599,1299,2300,5290000
2733,truck spot campbell greek area fit description morris say,black pick truck see campbell greek area morris say,3.0,0.6914867090957872,4078,2978,1100,1210000
2734,chairman michael lowell fcc colleague wednesday hearing,fcc chief michael lowell preside hear monday,3.200000047683716,0.4867091798070404,2553,3303,-750,562500
2735,bones industrial average cent nasdaq composite index cent high,street bones industrial average rise cent nasdaq composite add cent,1.7999999523162842,0.8107337400732346,4932,1722,3210,10304100
2736,tehran clear sign additional protocol introduce inspection ban import civilian western nuclear technology lift,tehran clear sign protocol ban import peaceful western nuclear technology lift,3.799999952316284,0.7779902067340067,4709,4196,513,263169
2737,congress twice pass similar restriction president clinton veto,congress twice pass similar bill president clinton veto time,4.599999904632568,0.8617455337498051,5229,5243,-14,196
2738,talk high standard low standard,talk positive number negative,2.799999952316284,0.10940348277883664,591,2580,-1989,3956121
2739,program official work foreign port authority identify target search high risk cargo,program official work foreign port authority seek high risk cargo reach united states,4.25,0.7232331749915234,4313,4919,-606,367236
2740,field tell interview think old outlive year,year death neilsen tell interview think rock face outlive year,3.0,0.6750118315270428,3951,2983,968,937024
2741,apt mcdonald remained hospitalize critical condition thursday,year old sister allison severely burn remained hospitalize critical condition,0.75,0.4679153397413081,2436,744,1692,2862864
2742,wednesday total national guard reserve member call active duty worldwide stand,yesterday total number national guard reserve troop call duty worldwide stand,4.0,0.7376506615296192,4436,4395,41,1681
2743,period nearly decade telemarketing associates raise million,telemarketing associates hire vietnow raise million,3.5999999046325684,0.5475438684005947,3006,3887,-881,776161
2744,body invercargill man warren campbell climb companion jonathan smith recover late yesterday morning,warren david campbell climb companion jonathan smith return expect tuesday climb mckenzie district,2.200000047683716,0.571953910314315,3194,2007,1187,1408969
2745,geoghan live protective custody unit transfer prison april,protective custody transfer souza baranowski april official say,2.799999952316284,0.4982334371208756,2649,2581,68,4624
2746,democratic platform support inclusion gay lesion family life nation,democrat platform explicitly support gay marriage back inclusion gay lesion family life nation,3.200000047683716,0.7937360092130098,4823,3326,1497,2241009
2747,share fall cent percent hour trading,stock rise cent percent close regular session nasdaq trading,1.25,0.3645623259700281,1774,1257,517,267289
2748,hundred reporter photographer swamp courthouse ground hearing carry live national cable network,hundred reporter photographer swamp town short hearing involve time star carry live national cable network,3.0,0.7209813161541556,4303,2975,1328,1763584
2749,amd chip sale jump percent year year million,second quarter sale grow percent million million,2.200000047683716,0.3702403895695664,1809,2067,-258,66564
2750,myelia haney wilson agitated come help prepare turner monumental church come anniversary celebration worshiper say,congregant turner monumental ame church say myelia haney wilson agitated come church firewood neighborhood city east,3.5999999046325684,0.6118767215397616,3503,3889,-386,148996
2751,ice diamonds pack card depict iraqi fugitive issue troop,ace diamond deck card show picture want iraqi leader,4.0,0.21307883715560064,1024,4366,-3342,11168964
2752,miodrag zivkovic liberal alliance montenegro win percent vote independent organ hajdukovic get percent,pro independence radical miodrag zivkovic liberal alliance come second percent vote,3.0,0.5655176015055468,3145,2971,174,30276
2753,far georgia return money wire,georgia receive money help fbi,3.75,0.37568120626366963,1853,4004,-2151,4626801
2754,island nation report new case day record new case make taiwan epidemic fattest grow world,taiwan report new case day record new case make epidemic world fattest grow,5.0,0.9239150708282433,5494,5696,-202,40804
2755,tub outfielder army rosa suspend game major league baseball friday cork bat,army rosa suspend game major league baseball friday cork bat immediately appeal decision,3.200000047683716,0.8030334375820433,4882,3328,1554,2414916
2756,half woman give daily dose drug half take place,half woman receive daily tablet combination oestrogen plus protest rest give place,3.200000047683716,0.4275427091317233,2164,3329,-1165,1357225
2757,police remove home weigh pound combine,boy weigh pound remove home act,3.0,0.7187622996246767,4287,2989,1298,1684804
2758,ibrahims separation operation goodrich david staffenberg plan aguirres week,instead long operation separate twin goodrich david staffenberg plan week,3.5999999046325684,0.5666474158890065,3157,3893,-736,541696
2759,company expand provide service buyer include payment service,company expand basic service offer payment finance,4.199999809265137,0.5717802110134569,3192,4851,-1659,2752281
2760,blast kill people injure,atlanta olympic james attack kill woman injure people,1.7999999523162842,0.41549103269078463,2102,1740,362,131044
2761,president rush name path egg student moan marketing association board director,president rush name student moan marketing association large lender student,3.2309999465942383,0.6827680290496103,4009,3331,678,459684
2762,boston archdiocese face wave scandal anger victim advocate parishioner priest,wave scandal anger victim advocate parishioner priest point saw long run archdiocese,3.0,0.805007687311851,4894,3002,1892,3579664
2763,federal magistrate sort lauderdale order hold bail,zuccarini order hold bail wednesday federal judge sort lauderdale,3.0,0.7075782275975808,4197,3001,1196,1430416
2764,department position threaten alienate social conservative provide strong political support ashcroft president rush,department stance disappoint abortion opponent threaten alienated social conservative provide strong political support ashcroft president rush,3.75,0.70785677152319,4199,4009,190,36100
2765,south africa world high cartload million people infect hiv aids,million people infect hiv aids south africa world high aids cartload,5.0,0.9526671070856562,5557,5697,-140,19600
2766,position elias report toe cocci president ceo emc,executive vice president new venture elias report toe cocci emc president chief executive,3.400000095367432,0.6208973742485108,3568,3512,56,3136
2767,new army commander vaska humoured brigade commanding officer brigadier ronde nyakairima promote major general,president power museveni promote brigadier ronde nyakairima major general name army commander,3.200000047683716,0.6456158818064996,3753,3319,434,188356
2768,mailblock found year webtv acquire microsoft million,webtv sell microsoft million today call msn,2.799999952316284,0.4792661095240825,2507,2635,-128,16384
2769,metropolitan transportation authority give week restore fare old computer railroad rate work declare,metropolitan transportation authority plan appeal give restore old subway bus fare old computer railroad rate,2.799999952316284,0.7771267426926437,4702,2584,2118,4485924
2770,today try convey problem russian president vladimir ruin president george w rush,today try convey problem russian president vladimir ruin news web site president rush news web site,4.599999904632568,0.6490692106924707,3775,5241,-1466,2149156
2771,state want kill wolf approximately square mile area near village mcgrath,state want kill wolf approximately square mile area near mcgrath establish loose nursery sort,3.200000047683716,0.7522710971446803,4543,3315,1228,1507984
2772,peterson tell police fish francisco christmas ve return house,peterson tell police leave wife fish francisco,3.0,0.6111980416931091,3498,2995,503,253009
2773,red empire state survey far exceed expectation jump june record high,price pull offshore high empire state survey far exceed expectation jump june record high,3.799999952316284,0.8279799724019076,5035,4200,835,697225
2774,met chief snap norman mckinlay say evidence body body area,detective chief inspector norman mckinlay lead investigation say evidence body body area,4.5,0.7256705884762517,4330,5135,-805,648025
2775,board chancellor robert bennett decline comment personnel matter tuesday hills,hills decline comment yesterday say discuss personnel matter,3.0,0.5633717587098933,3129,2992,137,18769
2776,general geoffrey say donate military pension charity period office yarralumla,men neffer say military pension charity serve yarralumla,4.727000236511231,0.5298802869959698,2859,5318,-2459,6046681
2777,camp manager piniella bench coach john mclaren right wielder surrey puff eject argue puff call strike end ninth,camp manager piniella bench coach john mclaren puff eject middle ninth,3.799999952316284,0.7889373563311401,4791,4201,590,348100
2778,venture own oil refinery filling station russia ukraine,tnk oil produce unit refinery filling station,3.0,0.5790877916044366,3241,2990,251,63001
2779,change plan refine original vision libeskind say,change improvement original plan libeskind say,4.599999904632568,0.6624624375778244,3869,5240,-1371,1879641
2780,peter deutsch d criticize fda effort florida,peter deutsch d say want congratulate fda,2.0,0.5757327909849679,3215,1890,1325,1755625
2781,active probable case gta compare case june,locally number active probable case decline,1.5,0.5164296906705499,2769,1442,1327,1760929
2782,sars kill people china mainland infect,china mainland disease kill people infect,3.200000047683716,0.7541158494350166,4555,3311,1244,1547536
2783,design hinder feature search colour label customized organization document project dynamic browsing network sac windows unix file serve,support coloured label well organise document dynamic browsing network sac windows file serve,3.0,0.5985924663884306,3395,2947,448,200704
2784,lawyer represent porch concepts rich garden respond repeat phone call,official porch jetblue respond repeat phone call mercury news seek comment,2.75,0.42578941636044376,2156,2537,-381,145161
2785,voluntarily castrate operation content remove ability sexually arouse,series voluntarily castrate august say surgery take away ability sexually arouse,4.5,0.657769546435774,3837,5134,-1297,1682209
2786,tsx composite rise point week tsx venture exchange composite gain point,week bones industrial average rise point nasdaq stock market gain point,1.0,0.36608660816955385,1787,896,891,793881
2787,turn suse license cava standard edition formalise exist agreement distribute run cava virtual machine run cava application,nuremberg germany base suse license run cava standard edition ship run cava virtual machine sinus software line,3.75,0.6879088635135828,4050,4020,30,900
2788,long line form outside gas station people rush money cash machine sunday israelis prepare weather strike threaten paralyze country,long line form sunday outside gas station people rush money cash machine israelis brace strike effect,4.5,0.7373719040926381,4433,5133,-700,490000
2789,teach heavy nasdaq composite index fall percent follow day win,technology lace nasdaq composite index cease point percent,1.5,0.370662668336845,1811,1447,364,132496
2790,know sars say james young ontario commissioner public safety,hyper vigilant say james young ontario commissioner public safety,2.0,0.7124173676220502,4237,1884,2353,5536609
2791,tale quarter beat expectation rise percent year year billion europe,tale rise cent year year beat expectation,4.0,0.785787919675952,4755,4671,84,7056
2792,company say issue revise guidance fiscal year month release result,company say renew guidance announce second quarter result mid july,3.200000047683716,0.39356735664088566,1958,3308,-1350,1822500
2793,decide use unbroken dotted white line experiment worth introduce say david richardson icc cricket manager,decide use unbroken dotted white line say richardson icc cricket manager,4.0,0.8361435721317225,5084,4668,416,173056
2794,shinseki retire wednesday year career include combat vietnam head peacekeeping effort bosnia,shinseki career include combat vietnam head peacekeeping effort bosnia,3.0,0.9037742071142498,5426,2946,2480,6150400
2795,department send water soil sample state health laboratory,late sample send state health department analysis,3.25,0.6405418599361721,3717,3344,373,139129
2796,clear obligation possible protect civilian see,clear responsibility possible minimize civilian harm,3.400000095367432,0.4601693798468406,2372,3446,-1074,1153476
2797,loss barber poland lawyer say tuesday attend meeting ask speak issue,loss barber poland legal counsel say governor comment conde deal,2.0,0.37968981610984526,1878,1895,-17,289
2798,previously see grinning mechanic east cava television,hughes see amrozi face television infamous image grinning mechanic east cava,3.400000095367432,0.6429435218311068,3732,3438,294,86436
2799,year later insurance coverage begin,agreement dedicate coverage drug benefit begin,2.799999952316284,0.3880692524041992,1929,2634,-705,497025
2800,nasa satellite image arctic ice shrink rate nearly percent decade,research find sea ice arctic disappear rate percent decade,3.200000047683716,0.5221261614724131,2809,3279,-470,220900
2801,biotech product safe conventional product testing rally say add country adopt biotechnology,biotech product safe conventional product testing say robert rally monsanto executive vice president,3.200000047683716,0.6892063029195841,4062,3274,788,620944
2802,nationally board terrify teacher master degree valley make salary year,nationally board terrify teacher master degree valley year teaching make,4.75,0.8717602383717116,5283,5326,-43,1849
2803,vienna iaea say elbaradei accept invitation date set,vienna international atomic energy agency say monday elbaradei accept ran invitation say date set,3.25,0.7196722201648105,4295,3343,952,906304
2804,epidemic begin november mainland guangdong province people republic china refuse report truthfully spread month,prc epidemic begin guandong province november communist party government refuse report truthfully spread month,4.25,0.6193543996617669,3558,4921,-1363,1857769
2805,truce face murder charge say,say truce charge murder,5.0,0.9033539745331869,5423,5680,-257,66049
2806,compare million cent share year ago period,earning affect non recur million tax benefit year ago period,1.600000023841858,0.4178499719148071,2112,1524,588,345744
2807,sick markakis left handed young harris junior college georgia go trifles seventh pick,baltimore take sick markakis left handed pitcher outfielder young harris junior college georgia,3.799999952316284,0.7334215341246904,4406,4239,167,27889
2808,remain hopeful city agree work engage good faith discussion issue,hart say governor remain hopeful city continue work engage good faith discussion,3.5,0.7554884330218185,4563,3727,836,698896
2809,woman concerned woman turn cosmetic surgery quest bodily perfection,woman express concern society people turn cosmetic surgery quest bodily perfection,4.75,0.7544152871555125,4556,5319,-763,582169
2810,ratification report friday msnbc,report cia request friday,3.0,0.3056480178665216,1457,2930,-1473,2169729
2811,photo peter hollingworth june issue examine herald yesterday,photograph hollingworth june issue magazine examine age yesterday,3.0,0.5915078971498601,3345,2937,408,166464
2812,continue work audit time tragic event provide additional security request,time particular tragic event provide security request jordan say,3.25,0.6389260530729878,3706,3359,347,120409
2813,statement release dei say green begin drive car interim basis begin week winston open owe motor speedway,announce green replace dark pale earnhardt chevrolet begin winston open owe motor speedway week,3.25,0.5331011315049804,2900,3367,-467,218089
2814,costa seminal opponent spaniard juan parlor ferrero beat year final,costa play juan parlor ferrero reach year final,3.75,0.6820270651395608,4001,3997,4,16
2815,doctor sacculate body nitrogen protect cell damage improve blood flow,belief base speculation nitrogen prevent cell damage improve blood flow,4.25,0.6105736317208176,3494,4924,-1430,2044900
2816,technology lace nasdaq composite index add point percent,broad standard door index creep point percent,1.2000000476837158,0.2898877066080867,1371,1106,265,70225
2817,americans report casualty accord apt michael alert spokesman regiment,casualty americans say apt michael alert regiment spokesman,5.0,0.9144290976549485,5462,5679,-217,47089
2818,think right choose,think peoplesoft customer deserve right choose allison say,3.0,0.5620010841718266,3114,2964,150,22500
2819,find smoking gun investigation board member scott hubbard say,find smoking gun say hubbard director nasa research enter california,3.5999999046325684,0.4650783568144747,2405,3900,-1495,2235025
2820,child literally neglect death armstrong county district attorney scott andreassi say,armstrong county district attorney scott andreassi say family photo home include written,1.7999999523162842,0.6045601245281157,3440,1700,1740,3027600
2821,microsoft say friday halt development future farintosh version internet explorer brother bite competition apple computer afar brother,microsoft stop develop version internet explorer brother software farintosh computer say apple afar apple need,4.0,0.6765828417011756,3964,4638,-674,454276
2822,shopman immediately arrest expect appear arrangement july,shopman arrest expect appear arrangement thursday prospector say,3.799999952316284,0.7181345861037877,4282,4173,109,11881
2823,president rush raise record break million election campaign month contribution americans president campaign chairman say tuesday,president rush raise million begin election campaign million leave spend campaign say tuesday,2.400000095367432,0.6703720457092879,3922,2206,1716,2944656
2824,authority ohio indiana michigan search body,far authority search area pennsylvania ohio indiana michigan,2.799999952316284,0.7407688624130696,4461,2623,1838,3378244
2825,say european government block new big crop unfounded scientific fear,block new big crop unfounded scientific fear rush say,3.200000047683716,0.8697605456118119,5267,3238,2029,4116841
2826,question france infuriate washington lead charge authorization war vote yes abstain,france infuriate washington lead charge approval war seek change,3.0,0.5457684641345739,2998,2966,32,1024
2827,luzerne county district attorney david lupus tell news conference monday authority continue significant progress case,charge file death luzerne county district attorney david lupus say authority continue significant progress case,3.400000095367432,0.8072911338635645,4906,3504,1402,1965604
2828,conference board say late measure business confidence hit fall quarter survey,conference board say measure business confidence fall quarter improve recent second quarter,3.799999952316284,0.7200889056123593,4296,4063,233,54289
2829,legal representative begin meet plaintiff attorney week discuss settlement,attorney archdiocese plaintiff begin meet week reach court settlement,3.25,0.6522194623464019,3793,3374,419,175561
2830,senior pay percent drug cost,dedicate pay percent drug cost,1.5,0.7285917113401997,4351,1429,2922,8538084
2831,flamboyant entrepreneur flag plan meeting london australian tourism minister toe jockey,air richard speak meeting london australian tourism minister toe jockey,2.799999952316284,0.6554341950751073,3823,2622,1201,1442401
2832,government bond sell sharply greenspan tell congress tuesday economy embrace period extended growth,greenspan tell congress tuesday economy embrace period sustained growth,3.200000047683716,0.7115614870127138,4233,3236,997,994009
2833,path nicolo jennifer connelly house mean stability family,path nicolo jennifer connelly desperate family find life fall apart,2.0,0.6244651740174081,3586,1901,1685,2839225
2834,institute supply management index nonmanufacture activity rise unexpectedly april report say,institute supply management say index non manufacturing activity rise march,3.400000095367432,0.6100582297480603,3489,3485,4,16
2835,spokesman maria agree say look like isolated event,look like isolated event world health organization spokesman maria say,4.599999904632568,0.7994863105126677,4861,5239,-378,142884
2836,police say small child apartment day,police say small child day lie dead,3.25,0.6735149921770238,3939,3372,567,321489
2837,priest john johnston avenue jackson heights charge aggravated harassment criminal possession weapon,john johnston charge aggravated harassment phone case criminal possession weapon accord police statement,3.75,0.6640664752770632,3885,3991,-106,11236
2838,settlement include million attorney fee expense,plaintiff attorney million settlement,4.5,0.5096215782429733,2721,5131,-2410,5808100
2839,vote kill,vote kill acc expansion,3.6670000553131104,0.5027199564801281,2676,3984,-1308,1710864
2840,prisoner country include canada hold capture war afghanistan al said network,prisoner country hold naval base guantanamo capture war ll qaeda afghanistan,3.3329999446868896,0.46110641090794047,2378,3412,-1034,1069156
2841,reach john dvorak cover kansas send e mail,reach cooper johnson county municipal reporter send e mail,1.0,0.3329925017094075,1615,914,701,491401
2842,prosecutor garden call decision victory kathleen peterson family,member kathleen peterson family present,1.0,0.5433389423471988,2980,964,2016,4064256
2843,want alesha bagley tone county nursing rehabilitation enter social director say week,want confirm tone county nursing rehabilitation enter social director alesha bagley,5.0,0.931940060262174,5515,5678,-163,26569
2844,national denomination episcopal church million member branch million member anglican communion,episcopal church million member american branch worldwide anglican communion million adherent,5.0,0.745518460234051,4499,5658,-1159,1343281
2845,feel confident say long integration story irina say,lot feel confident long integration story,3.400000095367432,0.7332211082627124,4402,3541,861,741321
2846,british police arrest people early tuesday connection suspect ritual murder african boy tarso find thames river,police arrest people connection murder young iberian child heedless listless tarso find float river thames,3.5,0.5392083977998676,2951,3739,-788,620944
2847,late afternoon bones industrial average percent having gain point monday high level july,morning trading bones industrial average percent having gain point monday,1.25,0.6943638678559112,4096,1255,2841,8071281
2848,uric age pitch perfect ninth word save opportunity,age strike perfect ninth winning word save,3.25,0.6635165969308056,3879,3370,509,259081
2849,share close nasdaq week high,trading echostar stock close tuesday week high,3.25,0.43711119222832995,2229,3369,-1140,1299600
2850,nice belly say husband receive assurance senior official public,tell inquiry husband receive assurance line manager senior ministry official come forward public,3.75,0.5665167135123952,3156,4010,-854,729316
2851,convict face year prison fine count,convict face year prison fine base gain involve,3.25,0.6926690841451708,4085,3375,710,504100
2852,corporate bond yield spread tighten spot trading friday street labor foot large power outrage north america,stock rise slightly feather light volume friday street group big power outrage north america,3.5999999046325684,0.3595089908702766,1750,3892,-2142,4588164
2853,evacuation go smoothly passenger tell go aunt say,passenger evacuate smoothly tell go say,4.400000095367432,0.6495320129861837,3780,5093,-1313,1723969
2854,allegation sexual assault report,report sexual assault academy,3.5999999046325684,0.6936972046115655,4090,3891,199,39601
2855,smith say simply oh god second afterward accord weinshall,second crash add captain smith say simply oh god,3.75,0.6318710127624058,3653,4019,-366,133956
2856,woolen say expect muhammad similarly call witness arterial hearing,old call witness wednesday arterial hearing fellow supper suspect john ellen muhammad,2.5,0.4693767149803556,2445,2333,112,12544
2857,leave smile face word daughter mind hope say,leave smile face word give kiss say,3.25,0.6294113705659997,3624,3376,248,61504
2858,bar permanently security industry,young face fine suspension permanently bar security industry,3.3329999446868896,0.7322206795815414,4391,3403,988,976144
2859,inspiration couple helpless courageous say scar win film director,say inspiration couple helpless courageous,3.0,0.7734853325963148,4676,3065,1611,2595321
2860,second victim michael walker strike tarso bullet perforate lung,victim michael walker barley street strike neck,2.200000047683716,0.44588677822746037,2289,2101,188,35344
2861,interview criminologist acknowledge sentiment legislator country weariness capital punishment,interview criminologist say lawmaker country share weariness capital punishment,4.599999904632568,0.6987195590936345,4122,5237,-1115,1243225
2862,franklin county judge executive versa barton say firefighter strike lightning take frankfort regional medical enter,county firefighter strike lightning stable condition frankfort regional medical enter,3.200000047683716,0.6626549823231909,3871,3223,648,419904
2863,police spokesman brig men edward aritonang confirm saturday arrest makarka magelang central cava,brigadier general edward aritonang police spokesman confirm yesterday arrest makarka magelang central cava,5.0,0.7607844943456239,4608,5659,-1051,1104601
2864,federal judge william harbour say tuesday impose maximum sentence event show remorse brutal slaying,district judge william harbour say impose maximum event show remorse,3.5999999046325684,0.732723312929316,4398,3885,513,263169
2865,potential rumor ask complete lengthy questionnaire,rumor take courtroom group ask fill questionnaire,3.200000047683716,0.5658063999054809,3147,3220,-73,5329
2866,alternate rumor choose final set select friday morning panel,alternate rumor select sixth alternate pick friday,4.599999904632568,0.6074115746486485,3463,5235,-1772,3139984
2867,california arm bureau immediately return call seek comment,california arm bureau immediately official response tuesday ruling,3.799999952316284,0.5647756046864013,3140,4101,-961,923521
2868,prime minister tell bbc gather poll continue believe right,say gather poll continue believe right foreign domestic policy,3.400000095367432,0.5413497739960657,2965,3528,-563,316969
2869,man battle head combined joint ask force base ship gulf den indian ocean,general battle head combined joint ask force aboard command ship count whitney,3.5999999046325684,0.5268478374278617,2835,3904,-1069,1142761
2870,street analysis expect cent share accord thomson,result cent share low forecast analysis survey thomson,2.200000047683716,0.5361495186337714,2926,1974,952,906304
2871,legal ruling follow day intense speculation hewlett backward bid company,legal ruling follow day wild volatility rim stock speculation giant hewlett backward bid company,3.5999999046325684,0.7168561609526319,4272,3924,348,121104
2872,finding publish july issue annals internal medicine,finding publish today annals internal medicine,3.799999952316284,0.8424985901921667,5118,4097,1021,1042441
2873,measure take senate early friday,bailiff say hope bring measure senate friday,4.0,0.5615603201409697,3110,4664,-1554,2414916
2874,union spokesman uric rhode decline comment mediation order,think great news say union spokesman uric rhode,1.7330000400543213,0.5574425162749141,3087,1600,1487,2211169
2875,labor department analysis think patrol statistic survey business provide accurate picture economy survey figure base large sample,analysis say believe patrol statistic provide accurate picture economy base large sample,4.0,0.7075838576319509,4198,4666,-468,219024
2876,parent want keep alive husband say want keep alive artificially,michael schiavo argue wife want keep alive artificially,2.799999952316284,0.5574417351513204,3086,2651,435,189225
2877,early tell france enter radio think qualify happen genuine epidemic,think qualify happen genuine epidemic health minister mean francis matter say france enter radio,3.200000047683716,0.7391645818503991,4448,3218,1230,1512900
2878,ferri schiavo expect die week camp area hostile spend past year,ferri schiavo undergo procedure camp area hostile live year say father mob schindler,1.7999999523162842,0.5303420860922938,2864,1675,1189,1413721
2879,prior join today lumbo work trotter gamble manage product holders canteen shampoo,prior join batman today lumbo hold senior marketing position trotter gamble,3.75,0.5352789540183653,2920,4016,-1096,1201216
2880,mcdevitt grant control crucial aspect policy solomon,mcdevitt grant control aspect policy commissioner william sorrel,3.75,0.6396470931211016,3708,4022,-314,98596
2881,official north carolina speedway rockingham reach,nascar official reach comment tuesday,2.9089999198913574,0.24429619349071108,1144,2754,-1610,2592100
2882,say child take vassar county medical enter observation,boy take vassar university medical enter staff say okay,3.400000095367432,0.5114295419685569,2739,3445,-706,498436
2883,misha dresser spokesman global crossing decline comment,global crossing representative immediate comment,3.5999999046325684,0.5013781803422909,2666,3916,-1250,1562500
2884,union stage day strike march force pale dining hall close,union stage day strike march strike precede contract,2.5999999046325684,0.5060783520638701,2701,2379,322,103684
2885,sov sick merry say oppose gambling expansion reluctant veto continuation pottery commission,sov sick merry oppose expansion gambling say hard press veto lottery sunset bill,3.799999952316284,0.6031096519503596,3426,4091,-665,442225
2886,midafternoon trading nasdaq composite index percent,nasdaq composite index dip point percent,1.600000023841858,0.5364467635850279,2931,1553,1378,1898884
2887,kentucky democratic attorney general men handle face urine fletcher,kentucky republican urine fletcher term house member rattle democratic state attorney general men handle,3.799999952316284,0.7754195129425745,4689,4098,591,349281
2888,bones industrial average fall percent,bones industrial average finish day point,3.400000095367432,0.6109803753663393,3497,3422,75,5625
2889,union plan cover worker retire beneficiary,union stock comprise worker portfolio,2.5,0.2776690961762498,1318,2346,-1028,1056784
2890,senate judiciary committee overcome significant hardly yesterday battle create trust fund pay victim asbestos exposure,senate judiciary committee tuesday overcome significant hardly battle create trust fund pay victim asbestos exposure difficult obstacle remain,3.75,0.8798509502247873,5325,3988,1337,1787569
2891,certify year billion budget,say know certify budget,3.1670000553131104,0.6945510839414063,4098,3078,1020,1040400
2892,difficult overestimated potential danger remote procedure rpc vulnerability,flaw involve remote procedure rpc protocol deal inter computer communication,2.5,0.3663330877939929,1791,2364,-573,328329
2893,obesity increase risk health problem skeptic argue smoking high cholestrol,obesity increase risk host health problem skeptic argue smoking high cholestrol consider disease,4.25,0.873633580690088,5297,4927,370,136900
2894,michelle lie chip sunday victory virada nirapathpongporn women amateur public links championship,trophy victory women amateur public links sunday,2.75,0.627097234900627,3610,2550,1060,1123600
2895,bony say psp feature inch lcd screen memory stick expansion shot,feature light lcd screen memory expansion facility,2.75,0.6195475662473466,3559,2553,1006,1012036
2896,smile site huntington bacteria reading come june june,reading come june june smile site huntington,3.25,0.9192303325556753,5479,3365,2114,4468996
2897,long line catch fish hook past decade lucky catch study find,long line catch fish hook lucky catch eye say,4.199999809265137,0.8088415198219046,4918,4871,47,2209
2898,carnival stock trade midday trading wednesday cent percent,carnival stock percent cent new work stock exchange,3.200000047683716,0.5606020673613736,3103,3269,-166,27556
2899,senate criticism house plan tuesday come front,senate republicans crank house map,2.75,0.2870497114906331,1359,2560,-1201,1442401
2900,result murphy seek substitute tried sister ethel celnik trustee,murphy say tried sister ethel celnik courtroom time tried,1.75,0.664768408578793,3887,1616,2271,5157441
2901,rule bar group fire promote support attack oppose candidate time,uphold fallacy rule bar group fire promote support attack oppose candidate time,3.75,0.8420798324288653,5114,3989,1125,1265625
2902,disco pare spending compensate sluggish sale,response sluggish sale disco pare spending,4.800000190734863,0.8334476598648249,5069,5449,-380,144400
2903,kansas city draft outfielder chris lubanski penned enrich high school pennsylvania fifth pick,royal choose chris lubanski high school outfielder pennsylvania hit fifth pick,3.400000095367432,0.6698763813799555,3916,3477,439,192721
2904,sterling percent dollar,dollar rise percent japanese currency man,0.800000011920929,0.3768447702284864,1863,814,1049,1100401
2905,bones industrial average rise point percent,bones rise point friday gain day week,4.0,0.4539498898716642,2332,4640,-2308,5326864
2906,right beginning want cut pay,rosy tell associated dress right beginning want cut pay,4.0,0.7025357502239025,4158,4641,-483,233289
2907,number bureaucratic administrative miss signal person responsible german say,turn nima offer german say number bureaucratic administrative miss signal,3.75,0.728847547897542,4353,3995,358,128164
2908,series stop town wednesday registering sex offender soledad police department,convict child molest brian series speak response community outrage wednesday afternoon register sex offender soledad police department,3.25,0.50732570776611,2709,3363,-654,427716
2909,edt race center near latitude north longitude west mile east southeast corpus christ,edt cabin center near latitude north longitude west mile east rewards,1.25,0.6843636244685295,4022,1256,2766,7650756
2910,saturday mph serve agassi equal rusedski world record,saturday roddick equal world record serve beat andre agassi,3.5,0.6190795092336949,3556,3723,-167,27889
2911,broad standard door index climb point percent,nasdaq composite index jump point percent,1.0,0.38270520372408107,1897,988,909,826281
2912,october heating oil future settle cent low cent gallon,october heating oil end cent cent gallon,2.5,0.8075334666465928,4910,2352,2558,6543364
2913,divine confirm try sell story world,lawyer donald divine confirm try sell story february,3.437999963760376,0.7241285058371718,4318,3683,635,403225
2914,bankhead say crime scene indicate killer methodical,gbi spokesman john bankhead say murder scene show killer methodical,4.0,0.6587744476275976,3843,4669,-826,682276
2915,move lot close say foam kind damage say hubbard member columbia accident investigation board,think move lot close say foam kind damage hubbard say,3.5999999046325684,0.7489699503410434,4517,3880,637,405769
2916,internal personnel decision microsoft spokesman mean unwell say,microsoft absolutely atstake internal personnel decision sundwall say,4.199999809265137,0.5438229106016266,2982,4844,-1862,3467044
2917,egyptologist cast doubt tuesday expedition claim find mummy queen nefertiti well know ancient egyptians,egyptologist think identify long seek mummy queen nefertiti ancient world legendary beauty,2.5999999046325684,0.4905616280896352,2589,2369,220,48400
2918,long range plan provide retail buyer treasury security ability manage holding online single account,treasury say want retail buyer treasury security ability eventually manage holding online single account,4.400000095367432,0.7972722521739033,4845,4973,-128,16384
2919,list night critical stable condition kings county hospital enter police say,victim new jersey resident critical stable condition hospital,3.25,0.4577943276426138,2356,3362,-1006,1012036
2920,year bond grow yield percent percent late wednesday,gmt year note yield percent percent wednesday,2.0,0.6149083128801551,3521,1792,1729,2989441
2921,iac stock close yesterday percent,interactivecorp share close percent nasdaq stock market,4.5,0.3282874369735849,1583,5130,-3547,12581209
2922,word speak senate floor say question motive deskbound president assume garb warrior purpose speech,question motive desk bind president assume garb warrior purpose speech,3.400000095367432,0.6964583217581071,4109,3458,651,423801
2923,ministry defence face compensation claim hundred demyan woman claim rapid british soldier,hundred demyan woman claim attack rapid british soldier grant government legal aid wednesday pursue case ministry defense,3.0,0.5337264052776691,2903,3035,-132,17424
2924,share usa interactive rise percent friday nasdaq stock market composite trading gain percent year,share lendingtree rise percent close nasdaq stock market yesterday,1.0,0.4653634562289577,2408,962,1446,2090916
2925,similar bill pass house twice die senate,year ago house pass similar version flounder senate,2.75,0.5525031836416451,3055,2544,511,261121
2926,closure affect quarter earning share penny,company say impact earning penny share,3.25,0.5031121221767569,2680,3361,-681,463761
2927,woman hospitalize june kansas health official say,missouri health official say hospitalize recover,1.0,0.5384980209024184,2941,932,2009,4036081
2928,blue chip edge lower midday wednesday wave profit warning drain optimism drive rally past month,stock fall early morning trade wednesday wave profit warning drain optimism drive rally past month,3.5999999046325684,0.6975324432354219,4116,3902,214,45796
2929,technology lace nasdaq composite index tack point percent,technology focus nasdaq composite index advance point percent ease early loss,3.200000047683716,0.5203961378881776,2799,3266,-467,218089
2930,kuwaitis palestinians jordanian passport suspect official say,include kuwaitis palestinians jordanian passport remainder iraqis audit official say,3.0,0.691685522056626,4082,2883,1199,1437601
2931,birthday april declare public holiday attend reception ball,grandmother princess elizabeth turn day declare public holiday attend reception ball,3.200000047683716,0.6073413868756411,3462,3265,197,38809
2932,working face charge conspiracy obstruct justice lie grand jury try separately,working try separately charge conspiracy lie grand jury,4.599999904632568,0.8573090082167597,5204,5233,-29,841
2933,man enter post office lakeside shortly give deputy,man enter post office roadside avenue maine avenue shortly,2.799999952316284,0.43156643801723055,2196,2638,-442,195364
2934,few fbi office conduct investigation involve visit mosque justice department say,addition justice department say fbi conduct few investigation involve visit mosque,4.199999809265137,0.8908316657552718,5372,4837,535,286225
2935,outside court sriyanto face year jail deny wrong,outside court sriyanto deny age wrong,3.200000047683716,0.7745737122284276,4682,3264,1418,2010724
2936,university michigan president mary solemn say statement university web site fundamental value change,fundamental value change mary solemn president university say statement inn labor,4.0,0.759213718504323,4594,4697,-103,10609
2937,comcast glass share cent morning trading nasdaq stock market,stock rise cent yesterday nasdaq stock market trading,2.200000047683716,0.5758612797213812,3218,1971,1247,1555009
2938,thomas join rehnquist part scala,join chief justice william rehnquist justices andre antonio scala,2.799999952316284,0.510999880141812,2734,2618,116,13456
2939,cross line violate constitutional right say charles weisselberg berkeley law professor,cross line violate constitutional right say charles weisselberg reach law university california berkeley,5.0,0.8279869300906195,5036,5662,-626,391876
2940,preliminary report man see airport source say,man pakistani passport reportedly see airport early evening law enforcement source say,2.0,0.37128195367642014,1819,1774,45,2025
2941,toronto yesterday probable case sars suspect case,wednesday probable sars case toronto region,3.25,0.7360778450111849,4423,3341,1082,1170724
2942,nasdaq composite index rise cent,technology lace nasdaq composite index gain point percent finish,3.75,0.4390621759060136,2240,4057,-1817,3301489
2943,toll australia second large transport company week offer share franz nail,toll week offer buy company share million,3.5,0.4937165947543593,2616,3726,-1110,1232100
2944,messagelabs run outsourced e mail serve customer world say filter infected e mail country thursday morning,messagelabs run outsourced e mail serve customer world label worm high risk report infection country,2.75,0.6001871941920062,3404,2555,849,720801
2945,carlton tuesday say refuse case,service official say carlton refuse refuse case,4.0,0.7723179543235615,4666,4688,-22,484
2946,oracle share high trade cent,share redwood shores base oracle rise cent,2.0,0.46518622985606606,2406,1809,597,356409
2947,precinct report fletcher term congressman lexington overwhelming percent vote,precinct report fletcher vote percent total,3.0,0.5922372931128499,3351,2783,568,322624
2948,long long patient quarantine wednesday seven public hospital worker develop fly like symptom,seven health care worker public hospital fall ill fly like symptom,3.0,0.5256965790449047,2830,2782,48,2304
2949,upside local old nose news people report high profit quarter early thursday help european demand,local old report high profit quarter help european demand early thursday,4.599999904632568,0.8359163240632125,5083,5231,-148,21904
2950,unemployment rate rise tenth percentage point high level july,unemployment rate predict pick percentage point,3.200000047683716,0.5367108898490294,2932,3254,-322,103684
2951,deal delainey agree cooperate continue investigation,delainey agree cooperate federal prospector exchange plea,4.400000095367432,0.5441631393711162,2984,4960,-1976,3904576
2952,source close sale say vivendi keep door open bid hope bidder interested individual asset team,source close sale say vivendi keep door open bid day,4.0,0.6635115124679696,3878,4674,-796,633616
2953,iron declare quarterly profit year,iron number mark quarterly profit year dram manufacturer,3.75,0.6081736108038449,3470,4024,-554,306916
2954,fine fail republican effort force entice democrats return,merry say back senate effort include fine force democrats return,2.799999952316284,0.588760557675836,3309,2586,723,522729
2955,teach load nasdaq composite rise point end high level month,technology lace nasdaq composite index climb point percent,2.400000095367432,0.30482661415615947,1449,2184,-735,540225
2956,prospector arrest individual seize million continue crackdown internet fraud abuse,people arrest million worth property seize internet fraud sweep announce friday government agency,4.599999904632568,0.4241200422980127,2150,5230,-3080,9486400
2957,say investigator feel confident get fire resolve regard,albuquerque mayor martin say investigator feel confident arrest fire resolve,3.799999952316284,0.6252645518232502,3597,4095,-498,248004
2958,man accuse face grenade commander cuban plane land key west april sentence friday year prison,cuban architect sentence year prison friday face grenade jack passenger plane cuba florida april,4.400000095367432,0.5934103755538336,3359,4965,-1606,2579236
2959,williams director visit project say middle november arrive passenger atlanta fingerprint photographer,williams director visit project say middle november inspector fingerprinting photographic foreign passenger arrive atlanta,4.199999809265137,0.6967979628262332,4112,4850,-738,544644
2960,hearing occur day pentagon time single officer villager address scandal,hearing come day pentagon time single officer villager fail address scandal,5.0,0.8631772028788505,5236,5663,-427,182329
2961,episcopal church alienate anglican communion say peter karanja provost saints cathedral nairobi,nairobi provost saints cathedral reverend peter karanja say episcopal church alienate anglican communion,5.0,0.948804838731901,5550,5665,-115,13225
2962,county population decline vermillion money madison,vermillion money madison county population decline,5.0,1.0,5694,5666,28,784
2963,wart indict february argue new hampshire wrong place charge,wart seek charge dismiss say new hampshire wrong place charge,3.400000095367432,0.662983329198509,3873,3682,191,36481
2964,baffled hospital weekend evaluation,undergo test weekend warn baffled hospital,3.200000047683716,0.6038173292600482,3433,3252,181,32761
2965,bomb explode vasa de españa customer eat dinner play lingo,vasa de span customer eat dinner play lingo bomb go,5.0,0.7659298138600554,4638,5667,-1029,1058841
2966,plofsky say commission will investigate year statute limitation expire,panel begin formal investigation statute limitation expire plofsky say,4.400000095367432,0.6505795195040767,3784,4985,-1201,1442401
2967,convict spying charge face death penalty,charge espionage aid enemy carry death penalty,3.5999999046325684,0.3567674802651969,1741,3851,-2110,4452100
2968,entrenched interest petition control network chokepoint sob fcc aid aet,die entrenched interest petition control internet choke point sob fcc aid aet,3.200000047683716,0.7277163691476342,4341,3251,1090,1188100
2969,church member observer expect decision problematical episcopalian,church member observer anticipate decision pose doctrine problem episcopalian believe bible prohibit homosexuality,3.799999952316284,0.49007756884273446,2584,4106,-1522,2316484
2970,square principal investigator payload collection science instrument cart rover,steve squares cornell university scientist principal investigator mission science instrument,4.199999809265137,0.38612499149698903,1916,4863,-2947,8684809
2971,military say kill rebel capture campaign far loss soldier wound,military say kill rebel capture campaign far soldier kill wound,3.0,0.9158333107863799,5469,2816,2653,7038409
2972,express script share fall percent close nasdaq,share express script fall percent nasdaq late morning trade,3.0,0.7870454969039978,4771,2796,1975,3900625
2973,police launch international hunt shevaun bennington run away year old studabaker saturday,shevaun bennington disappear saturday morning arrange meet year old studabaker,3.0,0.5847003381992915,3283,2815,468,219024
2974,lawyer familiar federal investigation remain focused campbell prospector decline discuss probe,federal prospector refuse discuss investigation lawyer familiar remain focused campbell,4.800000190734863,0.8787780994219757,5318,5380,-62,3844
2975,bones industrial average point percent,blue chip bones industrial average fall point percent give percent early,2.5,0.7573237565614286,4575,2343,2232,4981824
2976,peace rules defeat funny louisiana derby,peace rule funny draw away,2.25,0.3045706906948441,1446,2153,-707,499849
2977,say final agreement expect sign week,organ air deal expect penalize week spokesman mob having say,3.0,0.28423260849299414,1349,2813,-1464,2143296
2978,share eds close thursday gain cent,share eds close thursday cent new work stock exchange,3.6670000553131104,0.7157874774692905,4265,3979,286,81796
2979,divide supreme court rule monday congress force nation public library equip computer anti pornography filter,supreme court say monday government require public library equip computer anti pornography filter reject librarian complaint law amount censorship,3.5999999046325684,0.6259450858428144,3602,3847,-245,60025
2980,weakness exist way vba look property document pass document open host application,vulnerability exist way microsoft visual basic applications check document property pass document open,3.799999952316284,0.5479698323010221,3010,4092,-1082,1170724
2981,million phone vote percent studdard put vote ahead like,million phone vote cast studdard vote ahead like,3.400000095367432,0.892954866846774,5385,3654,1731,2996361
2982,consumer descrambling security card cable operator plug set,watch pay television consumer insert set security card provide cable service,3.400000095367432,0.4694176737112016,2446,3677,-1231,1515361
2983,decide opt european consortium engine good overall solution substantial price effort,decide opt european consortium engine good overall solution,3.799999952316284,0.8458603576234865,5138,4083,1055,1113025
2984,good drug administration reject imclone application sell erbitux bite shod research,good drug administration reject imclone original application december say trial sleepily conduct,2.799999952316284,0.4894848952279399,2581,2589,-8,64
2985,critic law violate civil liberty house judiciary committee chairman james sensenbrenner r say sensitive,house judiciary committee chairman james sensenbrenner r say sensitive civil liberty complaint,3.75,0.8272089012173469,5027,4035,992,984064
2986,lodges win sixth consecutive game long win streak edge colorado wednesday crowd lodger stadium,lodges win sixth consecutive game seventh beat colorado wednesday crowd lodger stadium,4.400000095367432,0.7993984046098903,4860,5020,-160,25600
2987,far search pennsylvania ohio michigan illinois indiana authority state say,far authority search area pennsylvania ohio indiana michigan,3.75,0.8481197820051676,5153,4027,1126,1267876
2988,year bond form take yield percent record low percent,year bond form take yield percent hit record low percent,2.75,0.9578408293697265,5566,2561,3005,9030025
2989,argue hand document violation fifth amendment right self discrimination,refuse turn paper assert fifth amendment right self discrimination,3.799999952316284,0.5756273948814316,3214,4093,-879,772641
2990,strayhorn say time texas history comptroller terrify appropriation act,news release thursday strayhorn say time comptroller reject budget,3.200000047683716,0.43249020100503327,2202,3247,-1045,1092025
2991,exclude charge analysis average expect loss cent share,analysis poll thomson financial expect loss cent share continue operation,3.799999952316284,0.5041641183585077,2685,4094,-1409,1985281
2992,security expert warn new mass fail worm spread widely internet lose e mail microsoft founder,new worm spread rapidly internet pretend e mail microsoft chairman rates antivirus vendor say monday,4.800000190734863,0.3994490349618187,1996,5378,-3382,11437924
2993,hazel say police identify body seven strong cell believe carry simultaneous attack saturday,say police identify body seven comber launch simultaneous maid friday night,4.0,0.4809484188353528,2518,4555,-2037,4149369
2994,new jersey bank holder earner permit intermediate license cell phone paper tireless device drive,addition ntsb recommend nhtsa state legislation enact prohibit holder earner permit intermediate license mobile phone drive,1.399999976158142,0.47432763800500993,2476,1277,1199,1437601
2995,university michigan release today new admission policy supreme court strike june way previously admit undergraduate,university michigan plan release new undergraduate admission policy thursday acceptance requirement reject supreme court june,4.199999809265137,0.6673433480452785,3902,4812,-910,828100
2996,audiotape tired week arab ll jazeera television network appear effort invite attack,audiotape tired week arab al jazeera television network strong evidence madam survive war,1.7999999523162842,0.597005131169942,3387,1629,1758,3090564
2997,company detail cost replacement repair,company official expect cost replacement work run million dollar,2.0,0.5477612757707574,3009,1866,1143,1306449
2998,mean tell reporter travel city sleepless summer tour consider campaign texas challenge,today mean end day city sleepless summer tour chicago new work,2.5999999046325684,0.4937111602694689,2615,2459,156,24336
2999,feel disagree rose lose job say,lavender feel disagree rose lose job,3.25,0.8556046481328495,5195,3332,1863,3470769
3000,american decision provoke angry reaction european commission describe legally warrant economically unfounded politically helpful,european commission powerful executive body describe legally warrant economically unfounded politically helpful,3.75,0.7009329335217886,4140,4030,110,12100
3001,grippe prawak leave friday day department introduce plan distribute medical marijuana doctor office,director office medical access windy grippe prawak leave job department introduce plan distribute marijuana doctor office,4.25,0.8006478618342663,4869,4912,-43,1849
3002,morgenthau say wire transfer deacon account total billion,fire transfer account open deacon total billion morgenthau say,4.75,0.8910297999534599,5375,5342,33,1089
3003,year unsuccessful bid democratic nomination governor,run year democratic nomination texas governor lose primary multimillionaire bony ranches,3.25,0.4665176949933374,2425,3340,-915,837225
3004,nation large retailer tell supplier start electronic tag pellet good,pal tell supplier need radio frequency system place crack pellet good supply chain,3.75,0.3649313773523212,1778,4049,-2271,5157441
3005,take hospital precautionary x ray neck,harvey take duke hospital precautionary neck x ray come negative,3.25,0.7087479708620195,4207,3335,872,760384
3006,bill say woman undergo abortion prosecute,woman undergo abortion prosecute bill,5.0,0.9658219687183842,5574,5668,-94,8836
3007,democrats assembly republicans,democrats dominate assembly republicans control senate,2.0,0.7186887152905908,4286,1868,2418,5846724
3008,come basically washington establish relationship sure get federal money california schwarzenegger say meet congressional republicans,come washington basically establish relationship sure get federal money schwarzenegger say meeting,4.199999809265137,0.8026822515901922,4880,4803,77,5929
3009,late snapshot labor market slightly well economist expect forecast claim fall low week,despite problem job market late snapshot labor market slightly well economist expect,3.400000095367432,0.6865123157395663,4036,3575,461,212521
3010,chante away millard go trial monday charge degree murder,chante lawton millard charge murder tapering evidence,3.0,0.5230112205785125,2813,2756,57,3249
3011,mind blunders plead guilty federal court charge include extortion money wandering conspiracy,ships aide mind blunders hobby mclamb plead guilty federal charge include extortion,2.75,0.6251293650145,3594,2568,1026,1052676
3012,vivendi share close percent paris europe,vivendi share percent europe paris gmt,2.5999999046325684,0.8270851018814971,5024,2453,2571,6610041
3013,microsoft identify freely distribute sinus software big threat sale,company publicly identify sinus big competitive threat,3.400000095367432,0.4400712618655207,2250,3576,-1326,1758276
3014,antonio monteiro de gastro currently director group latin america caribbean operation chief operating officer date,bat say antonio monteiro de gastro director latin america caribbean chief operating officer january,3.5999999046325684,0.775865712624724,4696,3842,854,729316
3015,pin manipulation public relation propaganda answer say,report add spin manipulation public relation answer avoid debate,3.5999999046325684,0.5272194561592879,2837,3874,-1037,1075369
3016,shooting link spree occur sov hamilton central elementary bet mile freely,late shooting link spree sov shooting hamilton township elementary school bet mile freely,4.800000190734863,0.8072293856728394,4904,5376,-472,222784
3017,tuesday central bank leave interest rate steady expect declare overall risk weight weakness warn relation risk,central bank policy board leave rate steady widely expect surprise market declare overall risk weight weakness,4.0,0.7228425454821161,4312,4549,-237,56169
3018,fighting erupt north organ journalist confront dozen south organ activist protest human right abuse north outside main medium centre,trouble flare north organ reporter rush taegu media centre confront dozen activist protest human right abuse north,3.400000095367432,0.580106615861029,3250,3548,-298,88804
3019,dusty battle kidney cancer year,dusty surgery cancer kidney remove,2.400000095367432,0.6979904306453022,4118,2224,1894,3587236
3020,kadyrov injure bodyguard kill,star pass news agency say bodyguard kill bomb,3.0,0.346291850076326,1691,2762,-1071,1147041
3021,commission estimate california lose billion state tax shelter,commission estimate california lose million corporate tax shelter,2.75,0.8023563072895472,4877,2571,2306,5317636
3022,official force cross syrian territory vague syrian border guard involved,official american force act intelligence cross syrian territory vague syrian guard involve,4.0,0.7236858488098497,4315,4548,-233,54289
3023,verisign introduce site hinder service kept,battle week old site hinder service rage,1.75,0.437583940521253,2230,1617,613,375769
3024,truce hold prison isolation say,truce night hold isolation prison,4.5,0.8798443192687744,5324,5147,177,31329
3025,leader bu war al di turn june deputy kill recent shootout maude force,leader bu war al di surrender june deputy kill shoot maude force recently,5.0,0.7188128827544618,4288,5669,-1381,1907161
3026,freita opening statement king county superior court judge charles vertex recess trial thanksgiving weekend,king county superior court judge charles vertex recess trial monday,3.0,0.7493187320854617,4522,2766,1756,3083536
3027,google investor include prominent firm plainer jerking garfield eyes sequoia capital paper note,google early stage banker include california base stanford university firm plainer jerking sequoia capital,2.799999952316284,0.5322761953405866,2891,2593,298,88804
3028,july st sixth anniversary long long return chinese rule,rally overshadow ceremony mark sixth anniversary long long return china july,2.6670000553131104,0.6197916765686953,3561,2533,1028,1056784
3029,calm wednesday announce plan acquire handspring company start jeff napkins regard father calm hand,calm say wednesday plan buy handspring company create renegade calm co founder jeff napkins,4.0,0.6483804836069511,3771,4534,-763,582169
3030,government recently shell peace talk milf border malaysia string attack include coming mindanao,government recently shell peace talk border neighbour malaysia state attack mindanao include deadly coming blame milf,4.25,0.8061571786052586,4898,4935,-37,1369
3031,company post profit million cent share year ago period,year ago quarter company earn million cent share,4.176000118255615,0.6245062462101331,3587,4704,-1117,1247689
3032,join boston monday massachusetts community watertown august framingham,long boston watertown august framingham go smoke free monday,3.0,0.6447162218475102,3747,2817,930,864900
3033,israeli soldier knock mobile home water tower tiny west bank settlement outpost overnight back ideas peace plan,israel soldier begin tear settlement outpost west bank yesterday israel obligation new ideas peace plan,3.799999952316284,0.4872177667979615,2558,4068,-1510,2280100
3034,union reveal chain target,union say reveal later chain target,4.599999904632568,0.8800831729667982,5326,5227,99,9801
3035,met say davidowitz chairman davidowitz associates national retail consulting firm base new work city,innocent damage good say davidowitz chairman davidowitz associates national retail consulting firm new work,1.399999976158142,0.8368104640877599,5087,1287,3800,14440000
3036,update product include salon fro salon conduct salon salon application server,new product desktop include late version salon conduct salon fro,2.799999952316284,0.7756588572310701,4693,2596,2097,4397409
3037,turkish authority say suicide comber turks,ankara say suicide comber turkish,4.199999809265137,0.6054648174220223,3445,4830,-1385,1918225
3038,april forecast operating earning range cent share,today expect earning cent cent share quarter,1.0,0.43440519870477945,2213,934,1279,1635841
3039,florida alaska thousand reveler vow push legal right include sex marriage,thousand reveller celebrate decision vow push legal right include sex marriage,4.199999809265137,0.6436499648611645,3739,4814,-1075,1155625
3040,status egypt israel australia,nation like israel australia status,2.5,0.714967045241986,4254,2360,1894,3587236
3041,finding appear wednesday journal american medical association news web site,result publish wednesday issue journal american medical association,3.5,0.5519103669007495,3048,3720,-672,451584
3042,additionally cradle room charge second battery,cradle space charge second battery,4.75,0.7154953470846744,4259,5337,-1078,1162084
3043,word point word refugee english turkish dictionary,man banish english turkish dictionary point word refugee,3.5,0.8349947175183489,5078,3717,1361,1852321
3044,close co operation law enforcement agency intelligence service lie heart go fight terrorist say,close cooperation regional law enforcement agency intelligence service heart fight terrorist say,4.0,0.8083272668786673,4913,4530,383,146689
3045,group say market rebound percent billion sale,asia pacific report growth percent billion,2.0,0.2366640570580717,1112,1832,-720,518400
3046,captain robert damsel st humoured division say truck explode outside building compound outer wall collapse,captain robert damsel humored division say truck explode outside building,3.200000047683716,0.6717672004310428,3931,3242,689,474721
3047,northern autumn trainer work soldier north african country patrol gather intelligence,later year command send trainer soldier north african nation patrolling intelligence gathering mission,3.799999952316284,0.3773305498498667,1865,4075,-2210,4884100
3048,figure catastrophe say patrick pelloux president association emergency room physician,unacceptable say patrick pelloux president france association emergency doctors,2.5,0.585090609218361,3286,2362,924,853776
3049,happen way punishment certainly covello tell year old family friend supporter fill half courtroom,happen sir way punishment certainly covello say,3.0,0.5933759002052716,3358,2892,466,217156
3050,mother allege lawsuit sexually assault guard,mother contend sexually assault guard confrontation,4.0,0.6302230370930979,3631,4531,-900,810000
3051,yes today clash memory purchase amd fujitsu brand passion,passion clash memory solution available worldwide amd fujitsu,2.625,0.6039864809364862,3434,2526,908,824464
3052,world large automaker say sale decline predict month late summer sale frenzy cause industry backwash expect,domestic sale word motor decline predict late summer sale frenzy prompt large expect industry backwash,3.200000047683716,0.7284941922045884,4348,3275,1073,1151329
3053,tropical storm rapidly develop gulf mexico sunday expect hit texas louisiana coast monday night,tropical storm rapidly develop gulf mexico sunday hurricane force wind hit land louisiana coast monday night,4.0,0.8222017316219689,4997,4533,464,215296
3054,pressure rise thursday national coverage final round plan espn cable sport network,pressure intensify today national coverage final round plan espn word difficult,3.200000047683716,0.6112966267801767,3499,3306,193,37249
3055,pataki praise abraham decision lipa chairman richard vessel say cable keep operation permanently,lipa chairman richard vessel say mean cable fit,2.400000095367432,0.5677795181475395,3166,2188,978,956484
3056,eye come diego year physician cabs,eye diego spend year cabs work superconductor material,3.5999999046325684,0.5702631146626246,3183,3860,-677,458329
3057,meningitis infection spinal cord fluid tissue brain,meningitis infection fluid person spinal cord brain,4.599999904632568,0.8977501257583211,5400,5226,174,30276
3058,mayor toe parker say late thursday worker man woman inside building blast occur,miss worker man woman inside building blast occur mayor toe parker say,4.400000095367432,0.8840982739203271,5341,5013,328,107584
3059,london base ncri official li safavi tell letter condemn raid view illegal morally politically unjustifiable,condemn raid view illegal morally politically unjustifiable london base ncri official li safavi tell letters telephone,4.599999904632568,0.9032700407171336,5421,5249,172,29584
3060,explode hand italian prime minister hurt,letter bomb send rode explode hand hurt,3.5999999046325684,0.46361322486451634,2392,3858,-1466,2149156
3061,falaba military attorney air force james key deny charge carry death penalty,attorney represent al falaba air force james key iii deny charge accord associated dress,3.200000047683716,0.5979310238470564,3391,3284,107,11449
3062,nasal letter court say tear family apart,seek tendency nasal apologize court employee family,2.0,0.3834128285857499,1901,1841,60,3600
3063,early city receive report dead blue day crow jayroe say,early city receive report say,2.799999952316284,0.6162091135558281,3534,2600,934,872356
3064,forest freedom organisation right enjoy smoking tobacco say mention word prohibition know happen,forest freedom organisation right enjoy smoking tobacco say greet lancet amusement disbelieve,1.600000023841858,0.5951036881966114,3376,1590,1786,3189796
3065,convert baystar aggregate approximately million share sco common stock percent company outstanding share,investment give larkspur baystar million share sco common stock percent company outstanding share,4.0,0.7325724940336481,4396,4546,-150,22500
3066,opec producer meeting wednesday set pressure independent oil export contribute carted supply cut allow return iraqi oil,opec week set pressure independent export carted supply cut prevent resumption iraqi export undercut oil price,2.799999952316284,0.6417097706523407,3724,2614,1110,1232100
3067,federal trade commission ftc ask congress today additional authority fight unwanted internet spasm account half e mail traffic,federal trade commission ask congress yesterday broad power attack rapidly grow problem spasm new study account half e mail traffic,5.0,0.5558116288933543,3075,5672,-2597,6744409
3068,federal grand jury indict tuesday document seal yesterday allow authority arrest,federal official say document remained seal thursday morning allow authority arrest western state,3.400000095367432,0.5182775435553401,2780,3599,-819,670761
3069,people oppose action try find fresh reason right thing,happen people oppose action try find fresh reason right thing,4.0,0.9323003374889826,5517,4536,981,962361
3070,richard miller remained hospitalize undergo liver transplant wife recover,richard miller survive lifesave liver transplant remains hospitalize,3.200000047683716,0.582867627970123,3268,3295,-27,729
3071,frequent representative immediately reach comment sco announcement,spokesman sco reach comment afternoon,3.799999952316284,0.4618228959135605,2383,4064,-1681,2825761
3072,proportion people cover employer drop percent percent year,proportion americans insurance employer decline percent percent percent,3.200000047683716,0.6601377781205799,3851,3296,555,308025
3073,world clayton hewitt accuse association tennis professional malice include allege attempt year dupe refuse drug test,world clayton hewitt accuse professional peer long stand malice include attempt year dupe refuse drug test,4.0,0.81939628688776,4980,4540,440,193600
3074,msn messenger available download start gmt wednesday,msn messenger software available pst wednesday accord microsoft,3.25,0.5370177658617089,2933,3336,-403,162409
3075,connection incident acknowledge behave inappropriately,acknowledge behave inappropriately say,4.25,0.7744516020683363,4681,4949,-268,71824
3076,spokesman say november co operate fully police,add co operate fully police november,4.25,0.8222136011902474,4998,4931,67,4489
3077,woman eat potato numerous vegetable pregnancy risk trigger type diabete child melbourne research believe,australian research believe find trigger type diabete child mother eat potato numerous vegetable pregnancy,4.25,0.8277845272027475,5033,4937,96,9216
3078,broad standard door index inch point percent,technology lace nasdaq composite index lose point percent,0.75,0.29659990857721946,1408,748,660,435600
3079,people think blood pressure fine actually way hypertension new guideline publish wednesday,people think blood pressure fine actually need start exercise eat well accord new guideline publish wednesday,3.0,0.7246159729472617,4320,2898,1422,2022084
3080,amazon report new work attorney general office settle civil fraud charge spoofer identify,amazon new work attorney general office settle alleged e mail forget,3.75,0.5513590608052594,3045,4044,-999,998001
3081,lead actress nod go energetic newcomer drissa caret winokur anna daughter gray,drissa caret winokur gray win good actress musical,4.0,0.568481676486025,3171,4543,-1372,1882384
3082,appear initial report textbook land consider circumstance burke say,say burke textbook land consider circumstance,4.0,0.8349459972278648,5077,4544,533,284089
3083,allegiant share rise percent thursday morning trading nasdaq stock market,allegiant stock close wednesday cent trading nasdaq market,2.0,0.6313997501055064,3647,1856,1791,3207681
3084,state law call public information release,law call public information rhode island,3.400000095367432,0.5792638863636386,3243,3593,-350,122500
3085,adr fall cent new work stock exchange composite trading today,share box entertainment group news medium entertainment arm fall cent new work stock exchange composite trading,1.399999976158142,0.4731262634458088,2467,1270,1197,1432809
3086,prefer say initiative launch million nationwide program week clean neighborhood build community project,prefer say launch million program week clean neighborhood ran build community project give detail,3.400000095367432,0.8666619870288619,5249,3435,1814,3290596
3087,nasdaq composite index add point percent,nasdaq weekly gain percent close gain yesterday,2.400000095367432,0.21129038218637608,1018,2208,-1190,1416100
3088,british foreign office say monday coalition authority ran pleased man free,british foreign office say meditate man release,2.5999999046325684,0.4323337403104521,2201,2469,-268,71824
3089,pal estimate million americans visit store week,week million shipper visit pal store,2.799999952316284,0.6823305907066052,4007,2610,1397,1951609
3090,add rode maybe old age help understand strength weakness,maybe old age help understand strength weakness reality world,3.200000047683716,0.7814597332722087,4734,3299,1435,2059225
3091,proud stand richard dixon merry say,march street richard dixon vietnam war say,2.400000095367432,0.48209973554473096,2524,2220,304,92416
3092,share corixa gain cent nasdaq,late morning trading nasdaq stock market corixa cent,3.25,0.5426247124840771,2971,3397,-426,181476
3093,spokesman fbi cia canadian security intelligence service royal canadian mounted police decline comment ll shukrijumah stay canada,fbi cia canadian security intelligence service royal canadian mounted police decline comment washington times report,2.75,0.7687738713039979,4649,2570,2079,4322241
3094,persistent problem solve investigation board member palace say,persistent problem solve mechanically physically say board member palace,4.0,0.7727604225189725,4668,4545,123,15129
3095,americans cut run misadventure say,pledge bring peace ran americans cut run misadventure,3.5999999046325684,0.6964174774579767,4108,3962,146,21316
3096,doubt chemical programme biological programme nuclear programme document say,add doubt chemical programme biological programme nuclear weapon programme,3.799999952316284,0.9278796805503895,5505,4077,1428,2039184
3097,ridge say real explosive harmful device exercise,ridge say actual explosive harmful substance,4.599999904632568,0.6026774180825726,3422,5252,-1830,3348900
3098,america friend happen say loud applause,america friend happen,3.25,0.6962916006614945,4107,3391,716,512656
3099,crawl narrow wind canyon appeal foot cliff walk mile canyon,crawl narrow wind canyon appeal foot cliff walk mile canyon near canyonlands national dark southwestern utah,3.75,0.810992485360637,4934,4043,891,793881
3100,amnesty international say past year collect information disappearance ran actual figure high,amnesty international say past year collect information disappearance ran,4.0,0.8436595331192058,5126,4576,550,302500
3101,texas instruments climb yesterday novellus systems advance,texas instruments climb novellus systems advance having raise overnight german,3.75,0.759617395933449,4599,4042,557,310249
3102,ask excuse week cabinet session prepare meeting president swandam agenda,take highly unusual step shipping cabinet attend meeting president swandam agenda,3.4549999237060547,0.46393513153316035,2395,3686,-1291,1666681
3103,mixture ancient pagan modern christian rate villager stage series ceremony hope ease misfortune believe keep poor,mixture ancient melanesian pagan modern christian ceremony people try ease misfortune believe keep poor long ago meal,4.0,0.7097415215127416,4219,4604,-385,148225
3104,bones industrial average edge point percent,bones industrial average point percent,2.5,0.8906347264429753,5369,2342,3027,9162729
3105,monkeypox usually find central western africa,prairie dog usually find southwestern western state indigenous wisconsin,0.25,0.3322818647674157,1609,444,1165,1357225
3106,film second trilogy wrap november matrix revolutions,reload second installment trilogy matrix revolutions seat debut november,3.8329999446868896,0.6306612182872294,3637,4330,-693,480249
3107,addition justice department say fbi conduct few investigation involve visit mosque,addition few fbi office conduct investigation involve visit islamic mosque justice department say,3.75,0.9156722303008188,5468,4034,1434,2056356
3108,launch coincide javaone developer conference francisco week,news come conjunction gun annual javaone developer conference francisco,3.25,0.5507311985874399,3039,3380,-341,116281
3109,royal duty base experience diana princess tales letter allegedly,royal household race revelation royal duty base servant time diana princess tales,2.75,0.6140575917409797,3519,2549,970,940900
3110,army say raid come day israel troop shoot kill abdullah kawasme james leader city target militant james,arrest come day israel troop shoot kill abdullah kawasme militant group leader neuron,3.0,0.6343051957602367,3667,2907,760,577600
3111,sars go claim life people toronto area include nurse doctor,virus kill people toronto area include doctor nurse,3.200000047683716,0.7175227075809707,4277,3229,1048,1098304
3112,apple computer new online music service sell million song week operation company say monday,apple computer say monday exceed record industry expectation sell million song launch online music store week ago,4.599999904632568,0.633418041856253,3659,5275,-1616,2611456
3113,arrest twice trespassing bar complex home mother child,arrest twice trespassing bar complex,3.5999999046325684,0.8275801582821358,5032,3933,1099,1207801
3114,oracle chairman ceo carry allison rule sweeten company unsolicited offer acquire rival peoplesoft,oracle chairman carry allison hint company increase offer rival peoplesoft,4.400000095367432,0.6563713152430117,3830,4993,-1163,1352569
3115,portuguese weather service say europe heatwave cause mass hot dry air move southeast,heatwave mass hot dry air southeast say paris almeida portugal weather service,4.056000232696533,0.706896643409209,4186,4698,-512,262144
3116,spend taxpayer dollar create terrorist bet parlor wasteful repugnant announce press conference yesterday,spend taxpayer dollar create terrorist bet parlor wasteful repugnant den organ say monday letter pentagon,3.5,0.7081296948784814,4200,3712,488,238144
3117,somewhat ambiguous ruling setback static control depend develop compete product merrily lynch analyst milunovich say,merrily lynch analyst milunovich say somewhat ambiguous ruling regulatory setback static control depend develop compete product,5.0,0.9609777392585984,5571,5674,-103,10609
3118,monkey track progress watch schematic representation arm motion video screen,arm keep separate room monkey track progress watch representation arm motion video screen,4.0,0.817765166466396,4974,4609,365,133225
3119,trigger hour police standoff inconvenience thousand computer traffic back downtown washington northern virginia,protest lead hour standoff police cause huge traffic jame downtown washington northern virginia,4.0,0.6062484456879922,3456,4611,-1155,1334025
3120,standard door index advance cent,broad standard door index rise point percent,4.75,0.5321696873776233,2889,5327,-2438,5943844
3121,agriculture minister nation expect attend day ministerial conference po agricultural science technology sponsor department agriculture,agriculture secretary inn enema kick day ministerial conference po agricultural science technology monday,3.75,0.6316700540007526,3651,4048,-397,157609
3122,complicate situation presence battle harden iberian fight side,fighting continue sporadically west complicate presence battle harden iberian side,4.0,0.6677015794896283,3905,4613,-708,501264
3123,year audubon society host annual christmas bird count,national audubon society annual christmas bird count season,3.5,0.7834300918767356,4742,3740,1002,1004004
3124,remove site list broken english rule hawker participate,organizer establish web site list broken english rule hawker participate,3.0,0.7699787077476087,4655,2902,1753,3073009
3125,doctor sacculate body nitrogen protect cell damage improve blood flow,belief base speculation nitrogen prevent cell damage improve blood flow,4.199999809265137,0.6105736317208176,3495,4874,-1379,1901641
3126,find shortness associate family history hear loss,shortness find twice hearing loss,3.400000095367432,0.408843504912811,2057,3656,-1599,2556801
3127,disco executive say encourage billion cash flow increase net income hope rebound,disco executive encourage billion cash flow increase net income say remain cautiously optimistic rebound,4.599999904632568,0.841715138897675,5113,5274,-161,25921
3128,e mail statement knoxville news sentinel shumaker say give consideration resignation,give consideration resignation shumaker say statement,4.0,0.7151755421386765,4256,4615,-359,128881
3129,poll show fbi begging mayor give boost reelection effort gop opponent,poll release week show fbi begging mayor give boost election effort,4.0,0.7015532993117991,4145,4616,-471,221841
3130,injured passenger john peter smith hospital die later friday morning bones say,injured passenger john peter smith die later morning release bone say,3.642999887466431,0.7869841772713391,4770,3978,792,627264
3131,doctor plan deliver week early november,caesarean originally plan november week early,3.5999999046325684,0.564929123613904,3141,3941,-800,640000
3132,big f spread suspect computer user open file attachment email contain familiar heading thank detail movie,virus spread suspect computer user open file attachment email contain familiar heading like thank detail,4.0,0.8764483258682537,5309,4618,691,477481
3133,technology lace nasdaq composite index rise point percent base late datum,broad standard door index gain point percent,1.0,0.26434212391373946,1255,948,307,94249
3134,founder group matsushita electric bony hitachi nec royal philip electronics samsung sharp toshiba,celf found member hitachi matsushita nec philip samsung sharp bony toshiba,3.400000095367432,0.7307505175547477,4376,3645,731,534361
3135,food supply say david ropeik director risk communication harvard enter risk analysis,zero say david ropeik director risk communication harvard enter risk analysis,1.75,0.8814455929851693,5332,1611,3721,13845841
3136,scream match carolyn tell john sleep begin,turn occasionally tell john sleep ex boyfriend baywatch hang michael begin,3.0,0.34833547923910446,1702,2840,-1138,1295044
3137,hand help establish steve innocence welcome,drain pond maryland help establish steve innocence welcome,3.25,0.7202292957113021,4297,3378,919,844561
3138,fletcher say expect support lawmaker agricultural state committee,say expect support lawmaker agricultural state,3.400000095367432,0.8151438798109154,4952,3468,1484,2202256
3139,year old cadet thicken police drink alcohol camp hotel room early saturday young woman age,year old male cadet catch camp hotel room early saturday female ten year,3.200000047683716,0.5920456345680146,3349,3272,77,5929
3140,step issue security council,matter send security council,2.799999952316284,0.4575587692149513,2355,2605,-250,62500
3141,plan stay day river create forecast late night,lawyer plan stay river starts recede,2.400000095367432,0.36485072493167214,1777,2209,-432,186624
3142,camp host summer religious retreat child event year round accord web site,faint sophia camp host religious retreat child summer month event year round accord web site,3.400000095367432,0.859761871210247,5220,3447,1773,3143529
3143,dealer say single currency downward momentum dollar pick speed break,dealer say neuro downward momentum pick speed break,3.5999999046325684,0.7799727722662662,4721,3949,772,595984
3144,gemstar share gather percent add cent close,gemstar share move higher news close percent nasdaq,3.799999952316284,0.5383801611818785,2940,4103,-1163,1352569
3145,long chipmaker company include bony microsoft hewlett backward ibm gateway foka,long chip maker company include bony microsoft hewlett backward international business machines gateway foka,4.800000190734863,0.6786887391195348,3986,5403,-1417,2007889
3146,roger own alpha albertsons bargain jointly gateway lock union worker day,corporate solidarity roger own alpha robertson lock worker morning,3.799999952316284,0.39463968561315543,1968,4069,-2101,4414201
3147,accord census bureau hispanic population increase percent april census figure,hispanic population increase cent april census figure despite favourable social economic condition,3.3329999446868896,0.6003489581655277,3407,3410,-3,9
3148,share jump pre open trading wednesday close,share jump percent pre open trading rise tuesday close,2.5,0.7939880485429734,4825,2328,2497,6235009
3149,bones industrial average point percent,bones industrial average fall point percent friday,2.400000095367432,0.8552032308183833,5191,2175,3016,9096256
3150,lawyer lackey say bryant expect completely exonerate,bryant innocent expect completely exonerate lackey say statement,3.799999952316284,0.802802010917616,4881,4073,808,652864
3151,good advance act index gain,standard door index rise good advance act gain,3.0,0.8025551261016312,4879,2833,2046,4186116
3152,ask say sullen take somerset county nail thursday move inn vein forensic hospital outside trenton psychiatric care,charles sullen transfer somerset county nail somerville anne vein forensic enter bed psychiatric treatment facility trenton,3.691999912261963,0.5858283858156323,3288,3987,-699,488601
3153,scientist believe stardust wrap thousand particle dust,stardust design gather thousand dust particle stream mild,3.0,0.5643318912371197,3138,2831,307,94249
3154,report independent expert committee aim dissipate suspicion long long government handling sars crisis,long await report long long government handling sars outbreak release,2.75,0.5586348633548749,3091,2540,551,303601
3155,device implement standard esco facility provide basis new careless telephone application,implement esco facility provide basis advanced careless telephone application bluetooth transmission,3.25,0.733266888043335,4403,3389,1014,1028196
3156,drop core wholesale price april reflect fall price car trunk man boy clothe cigarette,big drop august stem fall price car trunk man boy clothe cigarette,3.5,0.6453181381923085,3752,3741,11,121
3157,international rescue worker scout flatten debris survivor ran shattered ancient silk road city violent earthquake kill people,international rescue worker hack desperately flatten debris survivor cemetery overflow ran ancient silk road city yesterday,3.0,0.6325890772486733,3655,2829,826,682276
3158,griffith count airy native live north carolina coast wanted,griffiths grow count airy live wanted,4.0,0.5397723551493596,2955,4602,-1647,2712609
3159,conference board report consumer confidence index slip june,consumer confidence index come june slightly revise conference board say,4.666999816894531,0.6870622669607133,4040,5316,-1276,1628176
3160,notice mood change priority politician say,notice mood change priority say iraqi politician meet prefer,3.3329999446868896,0.8256018493502281,5017,3411,1606,2579236
3161,weather lose leg road accident think steel plate fit hip natural childbirth impossible,model lady mccartney lose leg road accident understand steel plate fit hip natural childbirth difficult,2.400000095367432,0.707349820926677,4194,2181,2013,4052169
3162,network drop friday night vaseline edition,network drop edition vaseline newsmagazine franchise,3.857000112533569,0.6614790183276587,3860,4334,-474,224676
3163,vice president sick henry mississippi republican gubernatorial candidate pale harbour acknowledge cheering crowd,vice president sick henry say mississippi republican pale harbour good governor government business navvy,2.400000095367432,0.6057439862521687,3447,2185,1262,1592644
3164,year old nurse work north work general hospital epicentre late outbreak,smile aroma contract sars work nurse north work general hospital epicentre second sars outbreak,3.0,0.6391541934139372,3707,2825,882,777924
3165,allow earn run start,german allow earn run start,2.0,0.8968136647020677,5398,1785,3613,13053769
3166,turner transfer million share charitable trust sell,sale leave turner million share aol,1.600000023841858,0.40085058071844926,2011,1565,446,198916
3167,recruit participate scheme convince receive fraudulent obtain merchandise order,recruit people delivery fraudulent obtain merchandise order,4.0,0.6542047593544797,3813,4600,-787,619369
3168,new work get select outfielder hastings milledge lakewood ranch high school florida,gets take hastings milledge outfielder florida pick,3.799999952316284,0.5438001241341213,2981,4105,-1124,1263376
3169,florida men mob graham identifiable percent poll,merry view favorably percent poll mean percent,1.2730000019073486,0.23930678901403196,1121,1259,-138,19044
3170,broad standard door index rise point percent,teach laden nasdaq composite index shed point percent,1.0,0.29503370534339085,1402,949,453,205209
3171,result player break par round,player break par round high figure open history,3.0,0.6742627780878632,3944,2820,1124,1263376
3172,albertson roger alpha chain lock worker response,roger alpha chain albertsons immediately lock grocer worker solidarity,4.0,0.5684900431737259,3172,4577,-1405,1974025
3173,technology pack nasdaq composite index drop point percent,nasdaq composite index fall percent week stumble yesterday,2.0,0.41215844611848373,2082,1953,129,16641
3174,share sco close cent monday trading nasdaq stock market,ibm share close percent new work stock exchange,1.0,0.2699848447479971,1281,951,330,108900
3175,house vote clear bill congress pass year fund federal government,bill congress pass year fund federal government,3.0,0.8157052408931176,4955,2845,2110,4452100
3176,night agree year million contract include signing bonus,espn report night year deal worth million include signing bonus,4.75,0.6551152329005563,3819,5325,-1506,2268036
3177,japanese currency neuro man late new work level,dollar man japanese currency percent,2.75,0.5035908578586799,2684,2543,141,19881
3178,procedure generally perform second trimester,technique second occasionally trimester pregnancy,4.5,0.35061617537410933,1714,5126,-3412,11641744
3179,hampton newport news grant fund water testing yorktown king george county norfolk virginia,grant fund beach testing king george county norfolk virginia,3.0,0.7356081825835009,4420,2870,1550,2402500
3180,say attacker leave leaflet urge staff star sheraton stop work hotel demand force leave ran,say attacker leave leaflet urge worker star sheraton stop work hotel,3.0,0.8385406160359811,5097,2869,2228,4963984
3181,diplomacy heating nearly month old nuclear crisis chinese foreign minister zhaoxing seat visit south august,diplomacy heating nearly month old crisis chinese foreign minister zhaoxing fly japan sunday en route south august,3.0,0.7517129904424482,4538,2868,1670,2788900
3182,fond ball like red recognize risk base economic weakness,red say risk economy base weakness,2.588000059127808,0.5147002122927922,2759,2368,391,152881
3183,real potential secondary collapse sov james mcgreevey say,damage area garage stable real potential secondary collapse mcgreevey say,3.5999999046325684,0.6779495053687319,3976,3947,29,841
3184,see server sale drop percent billion,fall second place server sale grow percent billion,2.3329999446868896,0.6204971235267597,3566,2171,1395,1946025
3185,people obviously inconvenience say young ontario commissioner public safety,hyper vigilant say james young ontario commissioner public safety,2.25,0.5881785392193523,3303,2158,1145,1311025
3186,give copy stains new diet revolution tell follow,research give copy stains new diet revolution care cutter,2.5,0.7055078426785946,4177,2350,1827,3337929
3187,rapier lawyer dark kann return call comment,year old rapier attorney civil matter dark kann return call comment,4.5,0.7001553113299829,4130,5122,-992,984064
3188,weigh market news general doors n plan issue billion debt plug hole pension plan,hurt news general doors n issue billion debt plug hole pension plan,4.75,0.8682688308895629,5256,5324,-68,4624
3189,russian comment lawyer attend hearing return phone message,lawyer cousin basil russian attend hearing return phone message,3.400000095367432,0.7553117439316831,4561,3470,1091,1190281
3190,licensing revenue slide percent million,license sale key measure demand fall percent million,4.0,0.1967448271913715,972,4582,-3610,13032100
3191,hispanics fat grow ethnic group overtake black large minority accord newly release government figure,hispanic officially overtake african americans large minority group accord report release census bureau,3.5,0.3860589832162042,1915,3692,-1777,3157729
3192,bishop armidale peter brain fortnight,get choice say bishop armidale peter brain,2.0,0.7452763518132197,4497,1797,2700,7290000
3193,fully operational facility expect employ people,plant employ people fully build company say,4.0,0.5197773277742996,2794,4583,-1789,3200521
3194,american stock exchange bitch index urge percent,philadelphia stock exchange semiconductor index jump percent,1.399999976158142,0.4225489219103953,2142,1362,780,608400
3195,like tell herald yesterday,like,3.200000047683716,0.44390236149239876,2274,3283,-1009,1018081
3196,month period end june advanced service line adsl increase percent cable mode connection increase percent,month period end june high speed line instal home business increase percent,1.7999999523162842,0.49752350031553516,2644,1765,879,772641
3197,state education commissioner go king say wednesday score missouri assessment program test disappoint,missouri education commissioner go king say disappoint score,3.200000047683716,0.796912713028296,4843,3285,1558,2427364
3198,agent find credit card credit card implicate machine search address,address raid authority find credit card implicate machine,4.800000190734863,0.7610988509926158,4610,5402,-792,627264
3199,owe half store report percent increase quarter profit percent jump store sale,depot report percent jump quarter profit nearly percent rise store sale,1.399999976158142,0.6814838256128657,3997,1366,2631,6922161
3200,calder acquire server software original sco change sco group,sco change tarantella calder later change sco group,2.5999999046325684,0.6813960749061099,3996,2393,1603,2569609
3201,officer throw ground handcuff jena drop knee accord testimony,officer throw ground handcuff accord testimony,3.25,0.78409084385363,4746,3395,1351,1825201
3202,well perform stock ultra group rise percent close share,ultra group n fall cent percent,1.75,0.5378913513966512,2938,1615,1323,1750329
3203,official try retrieve body water police officer tell letters add dead woman,official try retrieve body water police official tell letters,3.0,0.8263773311477703,5020,2853,2167,4695889
3204,accord market research npd group number people download music drop million april million june,number household acquire music fall high million april million million june accord npd,3.5,0.6649093350783291,3888,3687,201,40401
3205,easy case view wholly merit actually legally,case wholly merit actually legally judge penny thin coffee,3.25,0.6632251601981686,3875,3379,496,246016
3206,weather service report maximum sustained wind nearly mile hour strong guest,maximum sustained wind strong guest,2.25,0.728849188132842,4354,2148,2206,4866436
3207,iii patty veil summer music festival britain,world portal petty soon roll summer festival great britain,4.0,0.3343320385906051,1622,4584,-2962,8773444
3208,men drink tea particularly green tea greatly reduce risk prostate cancer landmark study find,drinking green tea dramatically reduce risk man contract prostate cancer study australian research discover,4.25,0.5305992795191626,2869,4918,-2049,4198401
3209,forecaster say warning cuba later thursday,patch warning issue eastern cuba later thursday,4.0,0.6038092835336883,3432,4586,-1154,1331716
3210,white percent country population,tennis percent pakistan population white percent,3.0,0.6511272007467317,3787,2848,939,881721
3211,cwa represent comcast employee call excessive typical union employee make year,communications workers union represent comcast employee call executive pay package excessive typical union employee make annually,3.400000095367432,0.7366886362793876,4426,3584,842,708964
3212,consumer group generate billion profit billion revenue january june citigroup profit revenue,generate billion profit billion revenue year half percent citigroup total,3.799999952316284,0.7154773781866095,4258,4087,171,29241
3213,galloway township annika sorenstam draw crowd michelle lie get publicity angela stanford take lpga victory,galloway township annika sorenstam michelle lie draw crowd angela stanford take lpga victory,4.0,0.9532085251880191,5560,4588,972,944784
3214,british airways new work london run end october,british airways plan retire seven concordes end october,2.5,0.5493413671809201,3026,2335,691,477481
3215,new policy give great weight grade test score student high school curriculum,academic achievement include grade test score high school curriculum give high priority,4.5,0.5609404076590482,3107,5127,-2020,4080400
3216,new version big c mm reach high level outbreak status monday accord security analysis,security analysis say new version big c mm reach high level outbreak status mid afternoon monday,4.5,0.8712919900324958,5279,5125,154,23716
3217,person account sunday man sort north texas,person man sort north texas miss,3.5999999046325684,0.7149860272565969,4255,3935,320,102400
3218,broad standard door index give point percent,technology lace nasdaq composite index decline point percent,0.800000011920929,0.3388007687709004,1650,759,891,793881
3219,aftra member approve merger vote,aftra hand approve merger shop percent,4.091000080108643,0.6782022529323098,3980,4700,-720,518400
3220,currency briefly weaken slightly monday trade far record low,currency briefly weaken monday morning resound trade little change friday,2.25,0.5504463366124254,3037,2159,878,770884
3221,part africa staying ground terror group kalaw previously major focus investigation al said,part africa ll qaeda staying ground kalaw previously major focus investigation group,5.0,0.7680308181102876,4643,5675,-1032,1065024
3222,sunday soldier kill injure southern ran munition dump explode,sunday soldier kill injure munition dump guard exploded southern ran,3.75,0.7939897654269927,4826,4008,818,669124
3223,real excited cleveland cavalier james say,excited go cleveland james tell,3.6670000553131104,0.6753652922337651,3953,3985,-32,1024
3224,accord law enforcement official person arrest know sophisticated packer,accord law enforcement official individual decrypt password server,2.6670000553131104,0.3751906391527036,1848,2530,-682,465124
3225,exclude litigation charge rim loss narrow cent share,exclude patent litigation rim loss quarter cent share,3.3329999446868896,0.7507599262033597,4533,3415,1118,1249924
3226,broad standard door index gain point percent,bones industrial average jump percent standard door index leapt percent,3.0,0.46937043256152333,2444,2851,-407,165649
3227,help reform royal solomon islands police strengthen court prison system protect key institution finance ministry intimidation,intervention force confiscate weapon reform police strengthen court prison system protect key institution finance ministry,3.444000005722046,0.6494141880835661,3777,3684,93,8649
3228,alibek say outcome encouraging,outcome encouraging george mason researcher men alibek say,3.799999952316284,0.6913912755144315,4077,4084,-7,49
3229,jury convict rapier c murder know miller second degree murder tuesday night shooting death year old jefferson parish nightclub,paper c murder convict second degree murder crime carry automatic life sentence shooting death year old inside jefferson parish nightclub,3.5999999046325684,0.6713311220465572,3928,3970,-42,1764
3230,cell series include nbc watch,cell series include nbc watch,5.0,1.0000000000000002,5716,5676,40,1600
3231,thirty man arrest wednesday evening say daniel ogden attorney nevada,thirty man arrest seek attorney daniel ogden say yesterday,3.0,0.7121209747389713,4236,2852,1384,1915456
3232,time de france winner cancer survivor dance armstrong word advice cancer survivor denver friday,time de france winner dance armstrong denver today meeting survive cancer,3.400000095367432,0.5949832183382557,3375,3665,-290,84100
3233,survive child son anthony belly daughter mind hope dora powers grandchild,hope survive wife son anthony belly daughter mind dora powers grandchild,3.799999952316284,0.94189375066952,5535,4065,1470,2160900
3234,police pepper spray arrest people monday night march rally activist protest annual training seminar saw enforcement intelligence knit,police pepper spray rubber bullet disperse downtown march rally night activist protest annual police intelligence training seminar,3.5999999046325684,0.6699634000044797,3918,3964,-46,2116
3235,department order percent reduction allstate texas clouds percent reduction state arm clouds,department order percent reduction state arm clouds state large insure percent reduction allstate texas clouds large,3.5999999046325684,0.9065758010187951,5435,3963,1472,2166784
3236,oleate share close monday new work stock exchange,oleate share cent morning trade new work stock exchange,2.400000095367432,0.712852868472865,4244,2313,1931,3728761
3237,shot ring darkness later kill,shot ring wednesday night gate kill,2.400000095367432,0.4855520101112356,2541,2308,233,54289
3238,broad standard door index point low percent,technology lace nasdaq composite index point percent,0.8889999985694885,0.3361651520210029,1634,888,746,556516
3239,republicans pledge complete dedicate drug package august extend deadline act work,republicans pledge complete dedicate drug package august extend act,4.75,0.9109800289907514,5448,5330,118,13924
3240,index measure activity service sector climb month march,arizona base ism report monday non manufacturing index rise month march,3.5,0.26495003657197197,1258,3689,-2431,5909761
3241,rush plan meet israel crime minister cried charon new palestinian prime minister mahmoud bias jordanian port aqaba wednesday,wednesday week rush meet israel crime minister cried charon new palestinian leader mahmoud bias aqaba jordan,5.0,0.7933752611363203,4820,5562,-742,550564
3242,unlike early stage internet firm google believe profitable,privately hold google believe profitable,3.5999999046325684,0.4901737226558175,2586,3975,-1389,1929321
3243,safe assume senate prepared pass form cap king say,safe assume senate prepared pass form cap level debate,3.0,0.8203098318791822,4990,2862,2128,4528384
3244,ask feel regret guilt attack answer adamant,ask feel regret theoctober attack answer adamant,3.799999952316284,0.776004028561047,4697,4078,619,383161
3245,big gainer famous nasal rmbs news people shoot percent high,famous nasal rmbs news people shoot percent make big percentage gainer nasdaq,3.0,0.8500914416611712,5164,2863,2301,5294601
3246,fuss write os angeles bureau chief,emily church london bureau chief,1.7999999523162842,0.31694724948629793,1522,1738,-216,46656
3247,pass bill fig brother watch say john mary d face,pass bill john mary d face tell colleague fig brother watch,4.800000190734863,0.8578634414026641,5210,5399,-189,35721
3248,douglas robinson senior vice president finance chief financial officer interim basis,douglas robinson senior vice president finance fill position interim,3.799999952316284,0.768347675558937,4647,4178,469,219961
3249,state federal government later pass similar strict bank,follow california lead state federal government pass similar rougher bank,4.0,0.582301517194502,3264,4598,-1334,1779556
3250,note diam decide seek acc membership school year june adhere fig guideline,note diam decide seek membership june adhere fig guideline,4.599999904632568,0.889325901781532,5358,5272,86,7396
3251,revenue bulk come month marvel topics adaptation x men united cross million opening weekend,bulk trail month marvel topics adaptation x men united cross million opening weekend,4.800000190734863,0.8905417789257477,5367,5397,-30,900
3252,share littleton colorado base echostar rise percent,monday echostar dish news chart profile share shrink percent,2.0,0.3089379409969905,1475,1782,-307,94249
3253,valid signature register california voter collect turn county election official kept,force recall election davis valid signature register california voter turn election official,3.200000047683716,0.7068715688429574,4185,3122,1063,1129969
3254,benchmark year note lose price take yield percent percent late monday,curve benchmark year note shed price take yield percent percent,2.200000047683716,0.7137546196367863,4247,2055,2192,4804864
3255,mdc call strike force mugabe resign negotiate settlement zimbabwe crisis,mdc call week long protest urge mugabe resign negotiate settlement crisis grip country,4.0,0.6698274458613492,3915,4596,-681,463761
3256,revenue rise percent billion billion,clean virginia base company say newspaper revenue increase percent billion,1.2000000476837158,0.4719094530005632,2458,1113,1345,1809025
3257,january notebook represent percent sale volume,compare january captor represent percent sale volume npd say,4.0,0.6280734072740329,3613,4593,-980,960400
3258,argentina guillermo boris netherlander martin verkerk half,seminal guillermo boris argentina martin verkerk netherlands compelling,3.0,0.6555840215667577,3825,2867,958,917764
3259,tell crowd cemetery thousand headstone mark grave entire family,lowell tell crowd cemetery thousand headstone mark grave entire family,2.799999952316284,0.9399540131220171,5530,2616,2914,8491396
3260,single condition book publish death,insist publish death,4.400000095367432,0.43936257139795654,2243,4959,-2716,7376656
3261,finding publish november edition journal nature,study publish thursday nature british weekly science journal,2.5999999046325684,0.46842357732074247,2438,2449,-11,121
3262,median household income decline percent account inflation,survey find median household income rise account inflation,1.399999976158142,0.8159615592371318,4959,1325,3634,13205956
3263,european leader pledge wednesday work ran develop nuclear weapon present united month bitter alimony ran,rush say european union leader annual washington summit agree need ran develop nuclear weapon,3.200000047683716,0.3785201604804471,1873,3095,-1222,1493284
3264,leave army syria receive religious training,move syria undergo religious training traditional islamic belief,3.0,0.42477950294655775,2154,2846,-692,478864
3265,meeting schedule end wednesday night attend approve resolution express denomination view issue bind church,wednesday attend vote resolution express southern baptist view issue bind individual church,3.2730000019073486,0.6128751855189889,3513,3399,114,12996
3266,inadequate performance student subgroup rag state deficient federal child left act,inadequate performance student subgroup race push state need improvement list federal child left act,4.0,0.7002239602544746,4131,4590,-459,210681
3267,lead recovery kilogram cancuen altar announce wednesday vanderbilts university nashville national geographic society,lead month recovery pound cancun altar vanderbilts university nashville national geographic society announce wednesday,3.25,0.7912101672479127,4806,3383,1423,2024929
3268,subtle wipe mean predict americans elect democrat sound uncertain trumpet dangerous time,elect president democrat sound uncertain trumpet dangerous time,3.5,0.736956377740709,4430,3691,739,546121
3269,report forecast hot spot worldwide year,report claim million visitor hot spot year meagre million,1.75,0.44291660874614985,2268,1601,667,444889
3270,new study conduct europe find medicine work early dispute study sponsor imclone systems say,doctor conclude erbitux cancer drug enmesh imclone systems insider trading scandal work early company sponsor study say,2.700000047683716,0.4787651157253421,2505,2535,-30,900
3271,lawyer donald divine tell telegraph offer tell story exclusively australian,divine say offer tell story australian network,3.75,0.636329267194787,3684,4002,-318,101124
3272,merry call lawmaker special session address congressional redistributing,merry call special legislative session try force redistribute plan,3.75,0.3729290748958575,1831,4006,-2175,4730625
3273,airtran official official decline comment yesterday,irish work spokesman decline comment deal,4.0,0.28575053657823796,1355,4589,-3234,10458756
3274,lawsuit name shell democrat registrar os angeles range diego county,lawsuit name secretary state shell democrat registrar voter os angeles range diego county,4.199999809265137,0.8966849960976497,5397,4872,525,275625
3275,negotiator say friday good progress late round talk create central american free trade agreement,negotiator say friday progress late round free trade negotiation united states central american country week houston,3.75,0.6589640310059655,3845,4011,-166,27556
3276,difficult large indicate loan japan lack expertise say banker,difficult large indicate loan japan say banker,3.799999952316284,0.8254817299638232,5016,4323,693,480249
3277,case come illinois involve profit company call telemarketing associates,case decide monday center illinois fund raise telemarketing associates,4.400000095367432,0.5356677791824738,2922,4987,-2065,4264225
3278,urge congress send final bill soon possible sign law,urge congress quickly resolve difference send final bill soon possible sign law say,4.599999904632568,0.7910107724965705,4805,5271,-466,217156
3279,pigeon director litigation massachusetts correctional legal services prisoner right group,pigeon say attorney organization massachusetts correctional legal services interview san tuesday,1.6670000553131104,0.5673984845996686,3164,1595,1569,2461761
3280,graduate military academy west joint new work,grow united states graduate military academy west joint,4.0,0.7494681002302266,4525,4579,-54,2916
3281,pnc regret involvement deal chairman chief executive officer james say statement,james chairman chief executive officer say pnc regret incident,4.333000183105469,0.7839959757175199,4744,4956,-212,44944
3282,ccag support hurry poland opponent gubernatorial election,swan group support governor democratic opponent hurry election,3.0,0.49103854483781323,2593,2827,-234,54756
3283,later fall back series rival congolese militia recent year,invade country later fall back rival faction,3.5,0.3694844709464648,1806,3732,-1926,3709476
3284,say member continue million phone number federal trade commission list,meantime direct marketing association say member nearly million number list,2.0,0.40160501703495444,2017,1861,156,24336
3285,veteran entertain mob hope celebrate birthday year showbusiness thursday,hollywood world hear celebrate legendary entertain mob hope birthday thursday,3.75,0.6174220770933022,3550,3990,-440,193600
3286,decline issue outnumber advance nearly new work stock exchange,dancer outnumber decline nearly nyse nasdaq,1.7999999523162842,0.44201596824196204,2265,1746,519,269361
3287,float fairfield flight deck cover acre ship take year build,began float fairfield flight deck cover acre ninth limit class carrier build newport news shipyard,2.6670000553131104,0.6097322343123148,3481,2534,947,896809
3288,proud citizen state say sov john baldacci causing foe,proud citizen state sov john baldacci say vote referendum count,3.799999952316284,0.6820385380064461,4002,4303,-301,90601
3289,injure woman co worker hospitalize list good condition,woman list good condition memorial healthpark camp say,2.200000047683716,0.47572888775140465,2490,1981,509,259081
3290,shooting victim take kings county hospital enter later die police say,victim identify take king county hospital pronounce dead,4.333000183105469,0.3210511526589331,1543,4954,-3411,11634921
3291,report symptom fever headache rash muscle ache,symptom include stiff neck fever headache sensitivity light,2.3329999446868896,0.43694272287119584,2227,2167,60,3600
3292,like total stranger vein quote say,like total stranger john tell pal day death,3.25,0.5008391283850047,2662,3386,-724,524176
3293,graduate saturday northwest college affiliate assemblies god bachelor art degree religion philosophy,start attend northwest college affiliate assemblies god plan minister,2.25,0.5116655058647318,2742,2150,592,350464
3294,technology lace nasdaq composite index fall point percent,broad standard door index give point percent,0.75,0.3418775992349806,1668,742,926,857476
3295,final test deliver missile armed force,state radio say test missile deliver armed force,4.0,0.7647860930869863,4632,4624,8,64
3296,withdrawal country inevitable happen today tomorrow tomorrow come soon,withdrawal country inevitable happen today tomorrow add voice sign give date mid september,3.5,0.6433815713024741,3737,3724,13,169
3297,accord news release send merry schindler schiavo foundation florida speaker johnnie word introduce ferri special session monday,florida speaker house johnnie word expect introduce ferri day special session state legislature hold today tallahassee,3.75,0.5391537435686536,2948,4047,-1099,1207801
3298,business utah volunteer display amber alert sign,business volunteer alert electronic sign billboard,3.75,0.5181895312170208,2778,4026,-1248,1557504
3299,thank neuro rise japanese currency dollar man overnight month low man,neuro rise man speculation japanese intervention help dollar firm man month low man hit thursday,4.25,0.5855281866799928,3287,4933,-1646,2709316
3300,russian stock fall arrest saturday mikhail khodorkovsky chief executive dukes oil charge fraud tax invasion,weekend arrest russia rich man mikhail khodorkovsky chief executive oil major yuko charge fraud tax invasion unnerve financial market,4.0,0.5911395859231693,3337,4612,-1275,1625625
3301,year expect sale million profit cent share continue operation,increase million cent share previously forecast,0.75,0.32179868234212067,1547,747,800,640000
3302,hughes refuse retire hernandez complain equal employment opportunity commission,hernandez file equal employment opportunity commission complaint sue,3.400000095367432,0.5822591339353762,3263,3439,-176,30976
3303,dewhurst proposal call abrupt end controversial robin good plan school finance,committee propose replacement robin good school finance system,2.5999999046325684,0.44399132473707237,2275,2496,-221,48841
3304,country private creditor owe billion addition,country owe billion billion,3.400000095367432,0.5988560828300833,3397,3441,-44,1936
3305,telemarketer number list act face fine,law telemarketer number list fine violation,3.5999999046325684,0.7146035119246258,4251,3934,317,100489
3306,explain find antetonitrus come post doctor research assistant england university bristol,explain find antetonitrus come post doctor research assistant bristol university britain,5.0,0.9181214152216388,5477,5737,-260,67600
3307,air canada large airline canada world court protection creditor april,airline world air canada court protection creditor april,4.25,0.9322550037495456,5516,4914,602,362404
3308,jury find gonzale guilty excessive force rouse vera carrera pepper spray,gonzales find guilty excessive force spray vera pepper spray,4.25,0.6377348199035081,3699,4947,-1248,1557504
3309,body dead pull train lay track emergency service bring wooden coffin,body dead pull partially detailed train lay track await identification,3.25,0.4285516334055036,2170,3396,-1226,1503076
3310,earner say self proclaim mayor baghdad mohammed chosen al zubaidi release day coalition custody,earner say self proclaim baghdad mayor mohammed chosen zubaidi release hour detention late april,4.25,0.7491563215445584,4520,4948,-428,183184
3311,union company executive engage widespread evasive fraud prosecution samuel quell tell associated dress,union company executive engage widespread evasive fraud manipulate company earning result quell say,3.75,0.6530900864007279,3801,4046,-245,60025
3312,customer pay entrance fee sms device client access license,detail prick sms device client access license,4.333000183105469,0.6742806661755919,3945,4957,-1012,1024144
3313,result original peoples survey release yesterday statistics canada suggest living standard improve law reserve,original peoples survey release wednesday statistics canada say living standard improve law suit leave impoverished reserve,3.908999919891357,0.7635164227929382,4620,4337,283,80089
3314,recent turnaround stock market easing unemployment claim consumer expectation current level signal favorable economic time ahead,recent turnaround stock market easing unemployment claim signal favorable economic time ahead say,3.933000087738037,0.8428331124889232,5123,4341,782,611524
3315,day trading lackluster standard door index prepare close good month period fourth quarter,standard door stock index end quarter point gain percent good performance broad market benchmark,3.75,0.34741570679660383,1698,4053,-2355,5546025
3316,ona explicitly state receive intelligence material indicate jemaah islamiyah terrorist network plan mount operation ali,stage ona receive intelligence material indicate jemaah islamiyah plan mount operation ali,4.25,0.8499879828697504,5163,4945,218,47524
3317,report deny interior minister prince layer,maude interior minister prince layer deny report,4.25,0.9288717381258149,5511,4940,571,326041
3318,bryant previously say like great impact demand official expect,chief financial officer andy bryant say like great affect volume official expect,3.5,0.4939386455960474,2618,3715,-1097,1203409
3319,judge follette reduce punishment life prison parole muhammad formally sentence web virginia judge rarely action,judge reduce punishment life prison parole expert virginia judge rarely opportunity,3.25,0.7302781583008722,4371,3392,979,958441
3320,spokesman strong memorial hospital say loud satisfactory condition tuesday night,spokesman strong memorial hospital say loud evaluation tuesday evening emergency room,3.0,0.5888254150714461,3311,2841,470,220900
3321,rent harsh face multiple count burial service fraud make false statement abuse dead body theft,rent harsh face charge abuse body theft,3.799999952316284,0.6199814629987033,3562,4244,-682,465124
3322,college president paul pribbenow tell wrap speech,edge microphone plug second time pribbenow tell wrap speech,3.400000095367432,0.5387712228756801,2945,3647,-702,492804
3323,month period end june high speed line instal home business increase percent,year period end june high speed line increase percent,3.857000112533569,0.7588303761657116,4590,4333,257,66049
3324,sick lemons brief troubled missouri basketball career,missouri kick sick lemons team end troubled career,4.0,0.7167398800796374,4270,4535,-265,70225
3325,military official motor wash helicopter blow banner,official say downward motor wash generate cover helicopter strip flag tower,3.400000095367432,0.4272771095004837,2162,3633,-1471,2163841
3326,settlement take effect week reach month take helm nation fourth large archdiocese,million agreement reach september month archbishop mean take leader nation fourth large diese,3.0,0.3912542771428849,1943,2873,-930,864900
3327,capitol evacuate yesterday authority detect possibly hazardous material basement senate wing capitol police say,capitol police evacuate capitol yesterday senior detect possible biohazard senate wing authority later say false alarm,3.200000047683716,0.6510433141579477,3786,3098,688,473344
3328,president give numerous speech compensation say spokesman penned,spokesman penned say president give speech compensation,3.5999999046325684,0.8795678332606122,5323,3864,1459,2128681
3329,broad standard door index point percent,standard door stock index future june point nasdaq future point,1.600000023841858,0.5269478021720504,2836,1493,1343,1803649
3330,rubbed project matter sinus base desktop promote run secure expensive alternative windows,design compete microsoft project matter position run cheap secure alternative desktop operating system microsoft desktop offering,3.799999952316284,0.46304533040331153,2390,4294,-1904,3625216
3331,key figure state treasurer paul silvester bribery scheme accuse wednesday change story silvester alleged corrupt dealing boston investment firm,key player state treasurer paul silvester corruption scheme testify tuesday kickback bribe silvester trade state business,2.0,0.5124900241983187,2747,1825,922,850084
3332,mission capps system aviation security say administration copeland security department,mission capps system aviation security say,3.5999999046325684,0.7753059309859617,4688,3870,818,669124
3333,woman speak lawyer john speranza say client wake day intending hurt,woman wake day intending hurt defense attorney john speranza say,4.5,0.7583175783384509,4587,5143,-556,309136
3334,believe necessary division confirmation fight supreme court appointment daschle write,believe necessary division confirmation fight daschle south dakota write republican president,4.0,0.7069770005559712,4187,4572,-385,148225
3335,yahoo account bsd site ntt period infospace survey find,service company ntt period infospace survey find,3.0,0.6343842814897345,3668,2874,794,630436
3336,late level scuffle cnn petya leave post general manager programming network announce,cnn late rejuvenated rating network dust petya general manager programming,3.7690000534057617,0.640686848692776,3718,4059,-341,116281
3337,suspect key figure jemaah islamiyah al link terror group blame coming,samudra suspect key figure al say link terror group jemaah islamiyah blame carry coming,3.400000095367432,0.8995518007509714,5408,3580,1828,3341584
3338,firefighter mosque today albuquerque fire chief robert ortega say,second away have happen albuquerque fire chief robert ortega say,1.7999999523162842,0.6353057781993565,3675,1760,1915,3667225
3339,issue resolve darling president david samson say club spokesman,darling say issue resolve,3.0,0.6503356942412648,3781,2903,878,770884
3340,china health ministry say people die war infect,monday china say people die sars infect virus,3.0,0.5149894647000915,2761,2904,-143,20449
3341,share mcdonald rise percent close day high,mcdonald share rise close friday new work stock exchange,4.25,0.5640287038847649,3133,4944,-1811,3279721
3342,say fda hope congress court bring clarity situation financial relief consumer,say fda hope congress court bring clarity situation financial relief consumer election,4.0,0.9738295822051345,5576,4564,1012,1024144
3343,rest young admit wrongdoing settlement,rest young spokesman kenneth corrigan say firm admit wrongdoing,4.0,0.5891478037869547,3318,4556,-1238,1532644
3344,witness year old kosovan parking attendant criminal conviction dishonesty pay news world,witness year old kosovan parking attendant pay news world court hear,3.625,0.7506398341416178,4532,3977,555,308025
3345,difference grassley thomas energy dedicate point member angry personal relationship embarrass party,difference energy dedicate point member embarrassing party,3.5,0.5489949634537847,3020,3718,-698,487204
3346,wound security guard flee stab passer run promenade,stab passer flee promenade mediterranean tea,3.200000047683716,0.6920723636735073,4083,3190,893,797449
3347,colleague attribute communication gap doctor feel press time,attribute communication gap doctor feel press time patient cite discomfort discuss financial issue,3.400000095367432,0.6581935008299481,3839,3553,286,81796
3348,state police say worker wrap immediately garage collapse,people believe wrap inside initially state police say,4.0,0.37612089202234267,1857,4554,-2697,7273809
3349,angeles bulk monster box office debut weekend take june opening record million,bulk take million box office monster opening new june record,4.800000190734863,0.79017912864494,4799,5395,-596,355216
3350,congratulation name time magazine person dear,time magazine name american soldier person dear,2.400000095367432,0.6997472775143642,4126,2251,1875,3515625
3351,indictment say attend important meeting plan attack recruit fellow comber coordinate operation,samudra present bangkok indictment say attend series meeting attack recruit fellow comber coordinate operation,3.200000047683716,0.7459432621655203,4505,3186,1319,1739761
3352,microsoft opportunity comment remedy propose commission,thing microsoft comment propose remedy response,4.199999809265137,0.6759052728201493,3957,4855,-898,806404
3353,texans saddle skyrocket homeowner premium finally get relief,relief sight texans saddle skyrocket homeowner insurance premium,5.0,0.7833460708156376,4741,5704,-963,927369
3354,democrats vie succeed jacques qualify web primary ballot,democrats republicans run seat qualify web primary ballot,3.400000095367432,0.6136779972036807,3517,3559,-42,1764
3355,halliburton tuesday reiterate contention kbr deliver fuel ran good value good price good term,believe kbr deliver fuel ran good value good price good term halliburton spokesman end say,4.0,0.8327178064703868,5067,4574,493,243049
3356,lucia battle cleveland tell police drop purse leave quick shop good week buy ticket,lucia battle drop purse buy began millions pottery ticket week believe ticket blow away,3.3329999446868896,0.5323435169318348,2892,3401,-509,259081
3357,customer include mitsubishi niemen dbtel calm philip sharp bony,medial customer include major hand maker mitsubishi niemen calm sharp philip bony,3.200000047683716,0.756183482625433,4566,3183,1383,1912689
3358,cleveland cavaliers win right draft james win nba annual lottery thursday night,case thursday night cleveland cavaliers win neuron james pottery know nba draft lottery,4.0,0.7578929146472214,4582,4627,-45,2025
3359,worker research find short worker bad hearing expect age,short worker bad hearing expect age time tall worker write barrenas,3.799999952316284,0.7379276978389362,4438,4271,167,27889
3360,olin specify system centre investigation,olaf belgian prospector specify system centre investigation,2.200000047683716,0.5513211684095198,3044,2125,919,844561
3361,sale entertainment torment limit united states canada,computer currently sell canada united states,3.75,0.37734956035987177,1867,4054,-2187,4782969
3362,calmer vocal past warning sinus threat microsoft,meme calmer reiterate open source threat microsoft,3.0,0.4028896394493442,2024,2912,-888,788544
3363,broad standard door stock index point cent,standard door stock index future decline point nasdaq future fall point,1.25,0.5412520811314945,2964,1258,1706,2910436
3364,talabani tell governing council need assistance advice implement new decision take,talabani tell iraqi leader need assistance advice implement new decision take organize interim iraqi government june,3.25,0.6367396675665725,3690,3388,302,91204
3365,stanford play south carolina today round game rosenblatt stadium omaha web,stanford play south carolina friday opening game double elimination tournament,3.3329999446868896,0.3970274461190558,1984,3420,-1436,2062096
3366,survey month ago street lead percent percent percent undecided,month ago poll lead percent,2.0,0.6349543584641499,3673,1833,1840,3385600
3367,broad standard door index advance point percent,standard door index gain percent new work,3.0,0.56123501183163,3108,2917,191,36481
3368,realize late course potential victim horror movie,realize late course potential victim,3.6670000553131104,0.8140242673592646,4944,3981,963,927369
3369,arthur reason attorney case plaintiff schoolchildren say appeal,attorney plaintiff schoolchildren say plan appeal,3.6670000553131104,0.7380552513633406,4439,3982,457,208849
3370,neuro slip nearly percent watch record peak week hit time high man late,neuro slip cent watch record peak near week hit record high man late,4.333000183105469,0.8107113404011111,4931,4955,-24,576
3371,pennsylvania aggressive treatment program treat inmate,texas time michigan inmate population treat infect inmate,1.3329999446868896,0.38496469292349966,1906,1263,643,413449
3372,teach load nasdaq composite rise point end high level month,technology lace nasdaq composite index climb point percent,2.200000047683716,0.30482661415615947,1448,2141,-693,480249
3373,expose feature open window shrink fit screen clear identify,expose ex oh feature open window desktop immediately shrink fit screen clear identify,4.400000095367432,0.8282971812048426,5038,4962,76,5776
3374,instead prospector dismiss charge pucker leave courtroom free man,instead leave courtroom free man authority dismiss criminal charge,3.400000095367432,0.710736219455178,4226,3590,636,404496
3375,case mentally challenging emotional exhausting say foreman wolfcale year old minister,wolfcale jury foreman minister say case mentally challenging emotional exhausting,4.199999809265137,0.913847178737734,5456,4836,620,384400
3376,arrive later week state visit president,rush arrive tuesday state visit american president,3.0,0.5926240986983236,3357,2924,433,187489
3377,deal approve company board director expect complete quarter nvidia fiscal quarter,acquisition approve company board director expect close quarter year,3.400000095367432,0.6073351508981849,3461,3544,-83,6889
3378,volatile mix drag session day allot rush say senate president king,senate support tap noneconomic damage sov web rush propose say senate president king,2.75,0.3390409078827643,1652,2552,-900,810000
3379,police officer involve bust culmination year operation investigation cocaine import money wander gang,officer launch london maid final phase year operation investigation cocaine money wandering ring,4.0,0.39442922348880793,1964,4695,-2731,7458361
3380,strip extraordinary item fourth quarter earning cent share compare cent share prior year,earning cent share month end compare cent share year early,1.0,0.6224132985635521,3575,959,2616,6843456
3381,age reach pound difficult decision time try surgery,age weigh shopping kg come difficult decision time try surgery,4.25,0.6165096122566225,3539,4925,-1386,1920996
3382,world end terrorist say,hospital treat everybody people world end terrorist,3.5,0.5414622226814116,2966,3730,-764,583696
3383,rates comdex denote time new tablet,sunday night comdex time rates denote,3.066999912261963,0.7377571644230319,4437,3072,1365,1863225
3384,accord report night allegedly punch parking attendant outside os angeles nightclub,arrest week allegedly munch parking attendant outside nightclub,3.25,0.5834160778974402,3275,3377,-102,10404
3385,wait turn rode finger sixth grade washington,rode finger sixth grade washington anxiously await turn microphone,3.75,0.732710102951388,4397,4023,374,139876
3386,cancer society say study miss,american cancer society scientist say study flow way,2.25,0.5847519906544816,3284,2152,1132,1281424
3387,hold armstrong county nail,later hold bail armstrong county prison today,2.5,0.5245945954209492,2823,2363,460,211600
3388,mile east tehuacan corn domesticate year ago,mile west pyramid teotihuacan corn domesticate year ago,3.75,0.6185944022556297,3553,3996,-443,196249
3389,confusion tap tumultuous week list intend block percent telemarketing call,free service originally intend block percent telemarketer call,3.25,0.33703680665787705,1638,3337,-1699,2886601
3390,strong preference achieve financial restructuring court remain hopeful chief executive parce fuller say,strong preference achieve financial restructuring court grant ceo parce fuller say prepared statement early friday,4.0,0.6890102901980777,4061,4630,-569,323761
3391,name complaint chief executive officer paul allaire richard woman cfo carry romeril,executive fine include chief executive paul allaire richard woman chief financial officer carry romeril,3.444000005722046,0.7510145191250959,4535,3685,850,722500
3392,margin manhattan charge sham marriage charge mercury file false instrument,margin manhattan charge mercury file false instrument marriage application,4.599999904632568,0.8620104153080543,5231,5269,-38,1444
3393,estimate thursday percent market share europe,boston scientific say gain percent coat send market europe,2.799999952316284,0.35002029301624105,1711,2597,-886,784996
3394,senate banking committee schedule hold hearing tuesday donaldson schedule testify hedge mutual fund,senate banking committee schedule hold hearing tuesday donaldson question hedge mutual fund,4.800000190734863,0.8978865604048135,5401,5371,30,900
3395,teach heavy nasdaq composite index percent point,broad standard door index point percent,0.6000000238418579,0.3559511602501517,1739,657,1082,1170724
3396,horse charge assault parish charge file false report,partner ivan parish charge file false police report,2.75,0.6398783257713138,3711,2566,1145,1311025
3397,appointment new job executive vice president chief staff officer,truce hawthorne name executive vice president chief staff officer,3.25,0.6308782129282264,3640,3338,302,91204
3398,analysis expect net loss cent share accord thomson,analysis forecast second quarter sale million accord thomson web site,1.5,0.3758161527308472,1855,1437,418,174724
3399,district send letter yesterday inform parent situation,parent receive letter inform possible contamination yesterday,3.0,0.5678837051622614,3167,2880,287,82369
3400,richard grass quit chairman week lose support board amid public million pay package,grass quit week wake firestorm criticism million compensation package,3.799999952316284,0.3940994230033994,1961,4251,-2290,5244100
3401,new serve run sinus x version molars say,serve run molars x operating system standard sinus operating system,4.308000087738037,0.5542540234156127,3066,4950,-1884,3549456
3402,glide ice moriarty patella hit spongy rocky floor river immediately feel pull,glide embankment rescue hit spongy rocky floor river immediately feel pull,3.400000095367432,0.7372898300918411,4431,3612,819,670761
3403,marbury schweppes ply plan cut job shut factory billion billion acquisition spree past year inflated cost,marbury schweppes veil plan slash job percent factory year cut cost bring acquisition spree,3.200000047683716,0.6227333682305392,3578,3173,405,164025
3404,sweeney outline plan campaign speech night philadelphia annual meeting american political science association,sweeney outline plan campaign speech saturday night annual meeting american political science association,3.5,0.911116222313814,5449,3707,1742,3034564
3405,like isolated incident say cried mean washington earn degree political science,like isolated incident say graduate cried mean washington,3.75,0.7104139737238999,4223,4015,208,43264
3406,jury award tvt million compensatory damage roughly million punitive damage,tvt records seek million punitive damage million compensatory damage official say,1.75,0.7524405930486189,4545,1613,2932,8596624
3407,tvt records seek million punitive damage million compensatory damage official say,damage include million compensatory damage million punitive damage idj,1.25,0.7314688930512434,4385,1254,3131,9803161
3408,democrats member fcc panel hold news conference sway opinion lowell,democrats member fcc hold news conference sway opinion lowell panel republicans,3.400000095367432,0.9531559345705881,5559,3615,1944,3779136
3409,knit volume set record notebook account percent sale,lcds account percent monitor sale,1.2000000476837158,0.34935525876330215,1706,1175,531,281961
3410,rattle sale slump rebel spur investor upset huge stock option windfall company manager pocket,sale slump rebel spur shareholder management stock option windfall,3.799999952316284,0.5729582013534986,3203,4260,-1057,1117249
3411,stanford vice play national championship tonight,vice stanford meet winner match monday,3.5,0.3541041598993506,1731,3713,-1982,3928324
3412,count indictment strike target drug trafficking world attorney marcus jimenez say,newly seal count indictment allege money wandering conspiracy strike target drug traffic world jiménez say,3.5,0.4199675694322775,2124,3703,-1579,2493241
3413,soldier kill monday wound convoy amuse northern ran,sunday soldier kill injure munition dump guard exploded southern ran,2.0,0.17128042568941398,876,1821,-945,893025
3414,cost analysis way say michael bell cfe executive director,look robin good remedy say michael bell campaign executive director,2.0,0.4792648335158403,2506,1819,687,471969
3415,go court believe play good tennis,believe confident case play good tennis,4.800000190734863,0.7215622866841468,4306,5388,-1082,1170724
3416,watson tell fbi agent shoot dennehy player try shoot accord arrest warrant affidavit,watson arrest july tell fbi agent shoot dennehy dennehy try shoot accord arrest warrant affidavit,3.799999952316284,0.9032269066964864,5420,4261,1159,1343281
3417,dog say second human thoroughness medical understanding research,say dog second human term subject medical research,4.599999904632568,0.5867323318135814,3296,5268,-1972,3888784
3418,stock rise percent close friday new work stock exchange,share jump percent new work stock exchange friday,1.399999976158142,0.7537746259566098,4552,1341,3211,10310521
3419,uric age earn save opportunity strike ninth allow winfield single norton,close uric age earn save opportunity strike matter face ninth,3.5999999046325684,0.6676636244014929,3904,3883,21,441
3420,clair government include charge madam seek cranium tiger september rosier set case military action,britain include accusation september rosier set case war ran,3.0,0.4437966343612415,2273,2889,-616,379456
3421,count energy price wholesale price percent,energy price drop percent big decline july,1.600000023841858,0.4969849921070252,2643,1490,1153,1329409
3422,statecraft schedule blast early tomorrow late friday jiuquan launch site sobs desert,statecraft schedule blast wednesday friday launch site sobs desert,4.0,0.7810742087337199,4729,4660,69,4761
3423,long long flat australia singapore south lose percent,australia flat singapore percent midday south add percent,2.400000095367432,0.6099398506876054,3487,2259,1228,1507984
3424,suv mark residential street monrovia rag elf slogan set ablaze house tom right say,suv mark residential street monrovia rag elf slogan say tom right,3.5,0.8986858623259694,5406,3719,1687,2845969
3425,case indiana illinois suspect,suspect case illinois indiana,5.0,1.0,5648,5728,-80,6400
3426,pill polypi contain aspirin cholestrol lower drug blood pressure lower drug half standard dose colic acid,ingredient polypi contain aspirin cholestrol lower station blood pressure lower agent half dose colic acid,5.0,0.8145304320602478,4949,5729,-780,608400
3427,drive car people kill metre away say sunday,right drive car people kill metre away,4.0,0.83194804348796,5060,4655,405,164025
3428,tuesday arrangement hearing harsh plead guilty count burial service fraud count make false statement,hearing plead guilty burial service fraud false statement charge,3.0,0.68607760677267,4032,2896,1136,1290496
3429,revenue extra premium huge,extra premium collect,1.3329999446868896,0.6123980392297408,3510,1266,2244,5035536
3430,semiconductor giant say yesterday second quarter profit double year ago strong expect demand computer microprocessor offset weakness communication chip business,second quarter profit double revenue grow percent year ago chip make giant report strong expect demand personal computer microprocessor,3.799999952316284,0.6581856290457687,3838,4264,-426,181476
3431,schroeder cancel italian holiday tetani refuse apologise spur come berlusconi compare german politician gaze concentration camp guard,tetani remark stoke tension italian crime minister ilio berlusconi week compare german member european parliament gaze concentration camp guard,3.0,0.5107362325295511,2730,2872,-142,20164
3432,openmanage software include update packages sms help automatic management server hardware application operating system patch single tool,update package help automatic management server hardware application operating system patch tool unpleasantly vague,2.6670000553131104,0.6699234731404843,3917,2529,1388,1926544
3433,sweep minute die cold moriarty think,embankment moriarty think sweep minute die cold,4.0,0.8984059077302922,5405,4652,753,567009
3434,lurd call interim government employment western peacekeeping force,rebel call employment peacekeeping force,3.0,0.5768438123894117,3224,2768,456,207936
3435,kedo spokesman poland rico say executive board decide refer question capital,executive board decide refer capital organ energy development organization say,4.0,0.5188301244019836,2785,4651,-1866,3481956
3436,benchmark treasury year note gain yield percent,benchmark year note recently yield percent,2.75,0.7030318841312954,4161,2569,1592,2534464
3437,prosecutor face ask topsy report seal portion longer peterson topsy report favorable defense lean medium,ask topsy report seal portion topsy report peterson unborn son favorable defense lean medium,4.0,0.8522802595954624,5175,4650,525,275625
3438,volume moderate million share million point tuesday,volume come million share million point wednesday,1.5,0.7368819913267372,4429,1445,2984,8904256
3439,penn traffic stock close cent share wednesday nasdaq cent,penn traffic stock close wednesday cent cent percent tuesday close,3.75,0.8318839597579796,5059,4021,1038,1077444
3440,hotly contest legislation change state takeover law help michigan base development company end takeover clear state senate thursday,legislation change state takeover law help bloomfield hills base cabman centers end billion takeover win committee approval tuesday,2.75,0.5565022738233989,3080,2563,517,267289
3441,union include powerful cgt remain opposed reform demand government begin fresh negotiation,powerful cgt union remain opposed plan demand government negotiate reform,4.0,0.7518781897801142,4540,4690,-150,22500
3442,family own cheetah strip club begin,search conduct simultaneously maid strip club diego begin,1.5,0.4515166878498055,2310,1446,864,746496
3443,new bill dedicate cover percent drug cost,senior responsible percent drug cost pocket total reach,1.7999999523162842,0.355262646926431,1734,1631,103,10609
3444,thousand rd infantry troop include rd brigade combat team base sort running columbus begin return week,thousand troop division rd brigade combat team base sort running columbus begin return week flight continue friday,4.0,0.8054054257369504,4895,4649,246,60516
3445,prairie dog sell exotic pet believe infect illinois pet shop gambian giant rat import africa,prairie dog believe infect pet shop gambian rat import africa,3.5999999046325684,0.8247829184454477,5011,3927,1084,1175056
3446,defense appeal house ruling trial,defense lawyer appeal ruling trial appellate court,3.400000095367432,0.6615107940994874,3861,3571,290,84100
3447,committee appoint defense secretary donald rumsfeld order congress,public hearing second panel create defense secretary donald rumsfeld pressure congress,2.5999999046325684,0.5664144204889455,3155,2464,691,477481
3448,indiana rank mccloskey die sunday bloomington battle bladder cancer,mccloskey die sunday afternoon home year long battle bladder cancer,3.25,0.6410958735659839,3720,3333,387,149769
3449,hospital red cross appeal blood donor yesterday,connecticut hospital association join red cross monday call blood donor,3.75,0.6190071608785493,3555,4031,-476,226576
3450,mexico wish guarantee citizen safety,mexico wish avoid violence,4.0,0.4398946606961597,2248,4634,-2386,5692996
3451,spain currently hold rotate presidency,spain currently hold presidency,4.199999809265137,0.8474862051256395,5149,4840,309,95481
3452,treaty sign,cf treaty sign,4.199999809265137,0.7593336720384862,4595,4839,-244,59536
3453,gorgich pashtoon execute prison,gorgich pashtoon execute traffic heroin sister baluchestan province,3.200000047683716,0.604101793073371,3437,3140,297,88209
3454,safe bourada sentence year prison,james badaoui sentence year,0.6000000238418579,0.29298941494950576,1383,632,751,564001
3455,santo state radioactive material primary basis generation crude weapon mass destruction terrorist,cranium radioactive material primary basis generation dirty weapon mass destruction terrorist,3.5999999046325684,0.7508149377530268,4534,3899,635,403225
3456,fulfil berghella state digital worm name sq hell particularly virulent implicate rate time hour,fulfil berghella state digital worm name sq hell high capacity delicate digital worm name sq hell slow post italian computer network make computer inoperable,3.5999999046325684,0.6040533678323554,3436,3898,-462,213444
3457,sober state large interest intellectual property right year ago,sober state nation strong intellectual property right,2.0,0.7381198473102332,4440,1857,2583,6671889
3458,investigator claim british company cover,russian investigator state british company cover,4.400000095367432,0.7917334222744508,4811,5085,-274,75076
3459,russia naso member country hold meeting fall conventional force europe treaty cf,russian parliament vote unanimously suspend russia participation conventional force europe cf treaty,1.399999976158142,0.46723425925069906,2430,1329,1101,1212201
3460,united states government naso member refuse ratify amend treaty official moscow withdraw troop soviet republic moldavia georgia,united states naso member refuse ratify amend treaty russia completely withdraw moldavia georgia,4.599999904632568,0.7585288642807059,4588,5265,-677,458329
3461,russia immediately increase military strength russian border,russia hesitate increase military strength russian border need arise,2.0,0.6734100653646683,3938,1852,2086,4351396
3462,center operational august,center formally open,2.200000047683716,0.31608938445632834,1516,2105,-589,346921
3463,brazilian police surround slum north rio de janeiro rid violent drug trafficker,police officer surround slum north rio de janeiro rid violent drug trafficker seize weapon drug,3.799999952316284,0.8336244368410746,5070,4318,752,565504
3464,regional international non proliferation issue address dialogue negotiation,second proposal regional international non proliferation issue address dialogue negotiation,3.5999999046325684,0.8914843565468296,5378,3895,1483,2199289
3465,come occur afghanistan attack anti government insurgent increase recent day,coming occur afghanistan police state responsible,2.5999999046325684,0.28299112837979123,1342,2514,-1172,1373584
3466,georgian government webster intense saber attack follow russian military strike georgia late week,saber attack follow russian military strike launch georgia late week,4.800000190734863,0.7188159883083951,4289,5352,-1063,1129969
3467,switzerland trade diplomatic relation ran criticize recent month foreign minister micheline calm red travel march sign deal ran state gas firm,switzerland trade diplomatic relation islamic republic criticize recent month foreign minister micheline calm red travel march sign gas deal,3.799999952316284,0.8607673290497901,5223,4319,904,817216
3468,conventional force europe treaty limit number military aircraft tank non nuclear heavy weapon europe,conventional force europe treaty sign russian naso member,2.799999952316284,0.436257884101614,2223,2588,-365,133225
3469,african union propose peacekeeping mission help somalia struggle transitional government stability somalia,african union propose peacekeeping mission aid struggle transitional government stabilize somalia particularly withdrawal ethiopian force,3.5999999046325684,0.6697857909225272,3914,3894,20,400
3470,report state syrian government conceal nuclear facility attack site,expert begin analyze report state syrian government conceal nuclear facility attack site,4.199999809265137,0.806809459772024,4901,4852,49,2401
3471,drug know ice shall,methamphetamine know ice,3.400000095367432,0.4726573809336941,2464,3618,-1154,1331716
3472,national regional international effort end illicit trade small arm light weapon,global community cooperate end illicit trade small arm light weapon,4.0,0.6015470419738896,3414,4363,-949,900601
3473,religious extremist continue parisian despite banking militant group,religious extremist continue parisian despite banking militant group pakistani government,4.0,0.9217059267000566,5488,4360,1128,1272384
3474,russian official call conference conventional force europe treaty discuss ratification amend treaty,antonov speak day conference conventional force europe treaty,3.200000047683716,0.5341258987335784,2907,3129,-222,49284
3475,russian president sign decree suspend russia application european arm control treaty,president vladimir sign decree suspend russia participation conventional force europe treaty,4.400000095367432,0.52931446755957,2853,5023,-2170,4708900
3476,myanmar know bursa,myanmar call bursa,5.0,0.8522389479789113,5171,5732,-561,314721
3477,huallaga locate northeast capital limb,porto habea locate km northeast manage nicaragua,0.0,0.32878693862397845,1588,173,1415,2002225
3478,naso regret russia decision suspend participation cf,russia decision suspend participation cf step wrong direction,3.799999952316284,0.6245702207916435,3588,4309,-721,519841
3479,human right violation myanmar include summary execution torture recruitment child soldier,human right violation include summary execution torture recruitment child,4.199999809265137,0.9282756615379341,5507,4854,653,426409
3480,general nikolski yakov state telephone state scientific center apply microbiology reliable system protection case emergency,general nikolski yakov longtime director state scientific center applied microbiology,2.400000095367432,0.6042051924301503,3439,2235,1204,1449616
3481,competition japanese german country contract,compete japanese company shinkansen german company ice contract,3.5999999046325684,0.4205983210853768,2127,3881,-1754,3076516
3482,legislation recent effort japan ascribe freedom tightly control military overturn ban military use space,legislation recent effort japan ascribe freedom tightly control military technically know self defense force,3.799999952316284,0.6837803278534564,4017,4266,-249,62001
3483,south launch new bullet train reach,south bullet train system,2.0,0.7429676465220953,4479,1860,2619,6859161
3484,russia member quarter middle east,russia member nag,2.200000047683716,0.365308165197479,1782,2005,-223,49729
3485,anatole sokolov soviet build missile defense system moscow obsolete efficient,soviet build missile defense system moscow obsolete efficient,4.599999904632568,0.831720202813875,5058,5262,-204,41616
3486,deal process year,idea investigation run nuclear activity year,0.6000000238418579,0.13315613155350087,707,642,65,4225
3487,adherence non proliferation obligation enhance mutual trust foster international cooperation nuclear energy,hang state country abide non proliferation obligation order enhance mutual trust create sound environment international cooperation nuclear energy,3.200000047683716,0.6397658839185909,3710,3164,546,298116
3488,french energy transport company sign contract build high speed rail link shanghai,sign contract build high speed rail link shanghai,4.0,0.8324035960042829,5064,4374,690,476100
3489,drug integral decade,drug form year,2.0,0.2373513066564588,1113,1781,-668,446224
3490,international atomic energy agency reach agreement italian official state remain issue ambiguity ran nuclear program activity,accord say remain issue ambiguity ran nuclear program activity,3.400000095367432,0.626292414905723,3605,3666,-61,3721
3491,police apprehend people include foreigner suspicion traffic drug pus popular downtown area,police apprehend people suspicion traffic drug downtown bar,3.799999952316284,0.6757089129768997,3956,4246,-290,84100
3492,russia ratify update treaty united states naso member refuse argue moscow fulfill obligation withdraw force georgia moldavia separatist region trans dnieper,russia ratify amend version united states naso member refuse russian government withdraw troop soviet republic moldavia georgia,4.199999809265137,0.4963916572079488,2637,4808,-2171,4713241
3493,conflicting opinion extent damage suffer insurgency,violence continue despite conflict opinion extent damage suffer rebel group,3.200000047683716,0.5199409619478212,2795,3161,-366,133956
3494,demand province world large opium produce region,demand province world large producer opium,5.0,0.716777145053481,4271,5733,-1462,2137444
3495,police state tsar wen hung extract taiwan,police state hung run,1.7999999523162842,0.47379546812782386,2474,1706,768,589824
3496,individual arrest release,zambian arrest juvenile,1.600000023841858,0.19401128523207692,963,1473,-510,260100
3497,mexican president elope caldron send special agent soldier sinaloa high degree organized crime drug trafficking,mexican president elope caldron send special agent soldier sinaloa fight drug trafficking,4.599999904632568,0.8282968063022798,5037,5261,-224,50176
3498,berlin host level meeting october save key european arm control treaty conventional force europe cf,russia suspend participation key european arm control treaty govern employment troop europe,1.7999999523162842,0.3741208952155578,1839,1707,132,17424
3499,meeting last day,meeting hold madrid,1.7999999523162842,0.3943231074608562,1962,1708,254,64516
3500,cf treaty sign,cf treaty establish,4.800000190734863,0.6802494648266832,3990,5363,-1373,1885129
3501,run insist program aim solely peaceful pursuit generation,run insist nuclear program peaceful purpose,4.400000095367432,0.5099531371077203,2726,5040,-2314,5354596
3502,china important force safeguard world peace,china important force promote world development,3.400000095367432,0.5534871994741333,3061,3653,-592,350464
3503,north deny involvement nuclear program syria,north deny involvement syrian nuclear project,4.400000095367432,0.7004464299069288,4135,5038,-903,815409
3504,spokesman stockwell day immediately available,chinese authority immediately available comment,1.2000000476837158,0.43866094594371763,2239,1206,1033,1067089
3505,long cool warn interaction north organ vessel north organ government retaliate nuclear missile attack major city new york washington,long cool state north retaliate nuclear missile attack major city new york washington,3.799999952316284,0.7590730486703396,4592,4282,310,96100
3506,run prolific apply death penalty world china,islamic republic prolific apply death penalty world china,3.799999952316284,0.8197166379199277,4985,4275,710,504100
3507,john duncan great britain ambassador multilateral arm control disarmament,un assembly chinese government urge increase effort global arm control disarmament,1.399999976158142,0.30404727218535055,1442,1321,121,14641
3508,treaty amend collapse soviet union,treaty amend reflect change soviet breakup,4.0,0.5145902393745971,2757,4493,-1736,3013696
3509,kashmir divide india parisian,kashmir claim india parisian,4.400000095367432,0.7575365562657874,4580,5026,-446,198916
3510,south israel oppose proliferation weapon mass destruction arm race,china resolutely oppose proliferation mass destructive weapon,1.399999976158142,0.4992208137308526,2652,1344,1308,1710864
3511,kadhafi warn britain failure compensate tibia nuclear disarmament deter run north discard,western country failure sufficiently compensate tibia deter run north discard,3.400000095367432,0.644779968740666,3749,3624,125,15625
3512,russia ratify amend treaty,russia ratify update treaty,3.400000095367432,0.6866678530906829,4038,3625,413,170569
3513,staff specialist conduct research training saber warfare prepare assist naso member response future saber attack,staff specialist conduct research training saber warfare,3.400000095367432,0.7598454199941035,4601,3626,975,950625
3514,jamais island youth wing stage separate demonstration kashmir,jamais island youth wing demonstration attack ran,3.0,0.7713961976281657,4659,2787,1872,3504384
3515,run prolific apply death penalty world china,islamic republic prolific apply death penalty world china,3.799999952316284,0.8197166379199277,4984,4276,708,501264
3516,china resolutely oppose mean delivery mass destructive weapon,china oppose proliferation weapon mass destruction,4.400000095367432,0.45669750602698456,2349,5071,-2722,7409284
3517,breakdown order china lead significant global turmoil,breakdown order china bad afghanistan jugoslavia,3.400000095367432,0.41221610338740194,2083,3629,-1546,2390116
3518,north claim nuclear ambition currently north report missile aim japan,north boast nuclear ambition north report missile train,4.0,0.6624135088604448,3868,4469,-601,361201
3519,abuse capital,tskhinvali capital georgia,0.800000011920929,0.33859982241587766,1649,753,896,802816
3520,united states government accuse italian government try develop nuclear weapon cover civilian nuclear program,ally accuse run attempt develop nuclear weapon guise civilian nuclear program,4.599999904632568,0.5541728249253935,3065,5259,-2194,4813636
3521,tyrant capital,abuse capital,1.0,0.4230658718307179,2146,950,1196,1430416
3522,armed clash italian police kill allege drug trafficker arrest seize nearly merit ton opium morphin,armed clash southwestern run police seize nearly merit ton ton opium morphin,3.200000047683716,0.7464684077154093,4506,3153,1353,1830609
3523,ran nuclear project peaceful purpose,run insist nuclear program peaceful purpose,3.5999999046325684,0.5771385300579011,3226,3913,-687,471969
3524,china resolutely oppose proliferation mass destructive weapon,china resolutely oppose mean delivery mass destructive weapon,4.199999809265137,0.7864109950821385,4763,4822,-59,3481
3525,china north close ally,north exclusive state,1.2000000476837158,0.22773682754951094,1077,1224,-147,21609
3526,libyan foreign minister abel roman amalgam visit london visit libyan foreign minister,amalgam visit london libyan foreign minister,4.199999809265137,0.8645007978458122,5245,4818,427,182329
3527,state present major threat global security,present major threat global security,3.5999999046325684,0.9545618243451632,5563,3911,1652,2729104
3528,cambodia vienna penalize agreement stop asia european drug trafficker,syrian russian official sign agreement cooperation combat drug trafficking,2.0,0.17784613874489558,903,1878,-975,950625
3529,activist state russia imprison people evidence illegal activity,russia imprison people evidence illegal activity,4.199999809265137,0.8896668837446466,5361,4860,501,251001
3530,restrain extremist group increasingly difficult group finance,bruguiere restrain extremist group particularly europe increasingly difficult group finance,3.799999952316284,0.8365699637156376,5085,4269,816,665856
3531,labor town southwestern ran,khoramabad city western ran,1.2000000476837158,0.12399382533213303,673,1243,-570,324900
3532,detain accuse homicidal criminal collaboration kidnapping funding terrorist include member military police,iguaran state detain accuse homicidal criminal collaboration kidnapping funding terrorist,3.25,0.8062692538894736,4899,3342,1557,2424249
3533,exist rod produce atomic bomb month,expert state rod produce atomic bomb month,4.199999809265137,0.7975441056117014,4847,4900,-53,2809
3534,international atomic energy agency trick eager deal,international atomic energy agency plan draw negotiation month,2.400000095367432,0.5078185468565006,2716,2254,462,213444
3535,myanmar government state myanmar opium free,myanmar government state myanmar track drug free,4.599999904632568,0.8084770395845323,4914,5258,-344,118336
3536,jewish american group anti defamation league publish page advertisement swiss international paper april accuse switzerland funding terrorist deal,anti defamation league take page advertisement swiss international newspaper early april accuse switzerland funding terrorist deal,4.400000095367432,0.8165640961856027,4965,5050,-85,7225
3537,france provide ricket gun engine,britain provide fuel tank gearbox,1.7999999523162842,0.17860125193263196,908,1674,-766,586756
3538,capital offense say arabia include rape murder apostasy armed robbery drug trafficking,capital offence ran include murder rape armed robbery drug trafficking adultery,3.200000047683716,0.6549743697797351,3818,3215,603,363609
3539,system large defense company,system large military,3.400000095367432,0.3693229469891233,1805,3639,-1834,3363556
3540,uvarov tell secretary state condoleezza rice russia remain open dialogue,secretary state condoleezza rice demand russia withdraw force,2.799999952316284,0.5687752406936888,3176,2639,537,288369
3541,additional individual entitle subject asset freeze,resolution include broaden list individual entitle subject asset freeze,3.799999952316284,0.7022040248304253,4151,4259,-108,11664
3542,withdrawal treaty allow russia bolster force near russian border,withdrawal conventional force europe treaty allow russia bolster force near russian border,3.400000095367432,0.8905976384580796,5368,3636,1732,2999824
3543,fan state commission primarily concerned term future investment taiwan,fan state commission ensure commitment uphold investment way,1.7999999523162842,0.3791674869807571,1876,1680,196,38416
3544,government spokesman mask state administrative paper order government south africa intervene prevent weapon transport territory neighboring padlock country,spokesman mask state long administrative paper order south africa intervene prevent weapon transport south african territory zimbabwe,2.799999952316284,0.7289707844177676,4355,2640,1715,2941225
3545,president dmitri medvedev statement post kremlin webster carry state news agency,statement post kremlin web site carry state news agency,3.200000047683716,0.6279199494695074,3612,3149,463,214369
3546,turkmenistan borders afghanistan,sister baluchestan border afghanistan parisian,1.7999999523162842,0.14132842015454603,743,1682,-939,881721
3547,number execution increase run year amid campaign aim improve security society,number execution increase dramatically amid campaign italian authority state aim improve security society,3.400000095367432,0.7915788953673965,4809,3452,1357,1841449
3548,syria deny have declare nuclear program,syria deny existence declare nuclear program,5.0,0.8469211236085588,5145,5736,-591,349281
3549,amnesty international right group base london,international institute strategic study locate london,1.399999976158142,0.30018960250492044,1427,1351,76,5776
3550,number tabulate asp count comply press witness report,number execution ran calculate asp count comply press report,2.200000047683716,0.6798423807612739,3988,2027,1961,3845521
3551,italian government italian nuclear program remain peaceful,italian government say nuclear program peaceful,5.0,0.8585639323259097,5216,5738,-522,272484
3552,shingarev say difficult nuclear weapon plutonium fuel,donohue say difficult manipulate radioactive isotope leave trail,0.6000000238418579,0.16419533231238403,835,659,176,30976
3553,paris capital france,limb capital,0.6000000238418579,0.3759892672642791,1856,622,1234,1522756
3554,indian government official speak condition anonymity,official speak condition anonymity,3.400000095367432,0.8640428446388688,5241,3459,1782,3175524
3555,russia threaten time withdraw cf odd united states plan install missile defense shield eastern,russia repeatedly threaten withdrawal cf opposition plan extension missile defense shield eastern europe,4.599999904632568,0.5490692643674786,3023,5257,-2234,4990756
3556,plan tunica creation electronic database facilitate tax collection,plan siberia mozambique creation electronic database real estate,1.7999999523162842,0.4656325541710964,2410,1685,725,525625
3557,china praise international community effort resolve organ peninsula nuclear issue,china praise especially asia pacific state effort resolve organ peninsula nuclear issue,4.199999809265137,0.7003829233879181,4134,4878,-744,553536
3558,russian foreign ministry state russia suspend dialogue,russian official state russia reconsider suspension,2.5999999046325684,0.2959756092581681,1405,2384,-979,958441
3559,arm smuggler drug carter eliminate southeast asia,arm smuggler drug carter aet terrorist,2.799999952316284,0.583401767045259,3274,2646,628,394384
3560,new law attempt remove legal obstacle build advanced spy satellite help innovation japan space industry,purpose new law remove legal obstacle build advanced spy satellite encourage innovation japan space industry,4.800000190734863,0.857909614049441,5211,5360,-149,22201
3561,hang china oppose restrict peaceful use nuclear energy non nuclear weapon state basis non proliferation peaceful use nuclear energy crucial objective,hang state china oppose non proliferation pretext restrict deprive non nuclear weapon state right peaceful use nuclear energy,4.400000095367432,0.7734657720445297,4675,5045,-370,136900
3562,non proliferation expert international institute strategic study mark fitzpatrick state idea report unusually strong tenor,senior fellow international institute strategic study mark fitzpatrick state international atomic energy agency plan superficial,4.0,0.46745313966472424,2434,4461,-2027,4108729
3563,treaty limit number aircraft tank non nuclear heavy weapon europe,conventional force europe treaty limit number military aircraft tank non nuclear heavy weapon europe,4.199999809265137,0.8812816388827066,5329,4907,422,178084
3564,esthonia official state saber attack cause esthonia government webster shut temporarily come computer administration russia include office president vladimir,official esthonia include prime minister andros anti claim saber attack come russian government computer include computer office russian president vladimir,3.799999952316284,0.5619221919210101,3111,4301,-1190,1416100
3565,britain strike agreement supply say arabia typhoid jet deal worth estimate billion pound billion dollar,agree supply say arabia typhoid jet deal worth estimate billion pound approximately billion dollar defense company system,3.200000047683716,0.8158790914160621,4958,3155,1803,3250809
3566,opium raw ingredient heroin,copy yield raw ingredient heroin,3.400000095367432,0.6838216221435661,4018,3469,549,301401
3567,sung law refuse detail north organ nuclear reactor project,south far take cautious stance issue north organ nuclear reactor project,3.0,0.5090815656788907,2719,3032,-313,97969
3568,agreement aim establish wide cooperation cover national security fight global terrorist,statement british ministry defense agreement aim establish wide cooperation cover national security fight global terrorist,3.400000095367432,0.8699402917849067,5269,3471,1798,3232804
3569,execute ran hang public,people execute hang public,3.400000095367432,0.8724396077516665,5286,3472,1814,3290596
3570,united states ally united states believe run pursue nuclear arm,united states european nation believe ran nuclear project purpose make nuclear weapon,3.799999952316284,0.46431221126740785,2398,4302,-1904,3625216
3571,cf important european security,cf cornerstone european security,5.0,0.6267715450495925,3608,5748,-2140,4579600
3572,indian troop fight rebel kashmir engage massive campaign destroy poppy crop region,indian troop fight rebel engage massive operation destroy poppy crop kashmir,5.0,0.8806586885241143,5327,5739,-412,169744
3573,matter delicate,idea report restrict,0.0,0.0,195,176,19,361
3574,week russia announce suspend participation cf,naso regret russia decision suspend participation cf,2.400000095367432,0.6251416242541132,3595,2290,1305,1703025
3575,western nation naso condemn violence,western nation naso demand cease fire,3.5999999046325684,0.5816422470546473,3255,3848,-593,351649
3576,indian national constitute large number foreign inmate near prison,drug trafficker foreign country constitute large percentage foreign inmate near,2.0,0.5868397034172003,3297,1965,1332,1774224
3577,judicial order accuse ragged funding terrorist,court accuse ragged saddle russen funding terrorist,4.199999809265137,0.5922927041445126,3352,4894,-1542,2377764
3578,myanmar military ruler burn approximately million dollar worth illegal drug mark international day drug abuse illicit trafficking,myanmar military ruler incinerate drug mark international day drug abuse illicit trafficking,3.75,0.7384136365370915,4443,4052,391,152881
3579,italian official increase execution official enforce campaign purportedly aim promote virtue boast security society,number execution increase run year amid campaign aim improve security society,4.0,0.45312675901329647,2325,4444,-2119,4490161
3580,india accuse islamabad funding training guerrilla,india accuse parisian funding train cross border guerrilla,3.0,0.5707151326088753,3184,3016,168,28224
3581,ensue battle airstrike kill militant,ensue battle kill militant,3.5999999046325684,0.8813469430702412,5331,3846,1485,2205225
3582,panamanian foreign ministry communique state task force facilitate technological transfer promote biofuel production consumption,panamanian foreign ministry communique state panama brazil sign juridical issue treaty include tradition,1.7999999523162842,0.34186339942733257,1667,1678,-11,121
3583,vienna world harvest drug law,vienna drug law world strict law,4.800000190734863,0.6630479131528516,3874,5357,-1483,2199289
3584,indian government prohibit direct indirect export import item material good technology contribute ran enrichment relate processing heavy water relate activity,india prohibit direct indirect export import item material good technology contribute ran nuclear weapon delivery system,3.200000047683716,0.6262100445336244,3604,3163,441,194481
3585,vienna news agency report ministry public security state foreigner involve drug trafficking case vienna come law cambodia australia china united states taiwan,vienna news agency report ministry public security state police admit drug trafficking vienna increase action prevent stop drug trafficking border remain limited,3.799999952316284,0.5620338826530625,3115,4317,-1202,1444804
3586,saferworld team leader transfer control small arm roy sister e embargo prohibit direct indirect supply military equipment use myanmar,saferworld team leader transfer control small arm roy sister state e embargo explicitly state military equipment supply directly indirectly use myanmar,5.0,0.7382332844143731,4442,5740,-1298,1684804
3587,united states naso member refuse ratify amend treaty,united states naso member refuse ratify update cf,3.200000047683716,0.7278629692192244,4342,3166,1176,1382976
3588,cf limit use armed force heavy weapon prescribe measure aim confidence building transparent cooperation member state,treaty limit employment tank troop naso easter european warsaw country establish confidence building transparent cooperation measure member,3.799999952316284,0.43978734845366196,2247,4304,-2057,4231249
3589,bulgaria locate southwestern balkan peninsula,drug traffic activity rampart southwestern balkan peninsula,1.0,0.5312968991445106,2881,942,1939,3759721
3590,elbaradei state chance build security middle east base trust cooperation possession nuclear weapon,chance build security middle east base trust cooperation possession nuclear arm,4.0,0.867849048950017,5254,4464,790,624100
3591,italian government dismiss allegation intelligence present international atomic energy agency board baseless intelligence support allegation face,international atomic energy agency insist italian government simple denial intelligence present international atomic energy agency board good allay western country suspicion,2.200000047683716,0.52192392209554,2808,1986,822,675684
3592,cf treaty establish,treat originally sign,3.200000047683716,0.0,206,3146,-2940,8643600
3593,conventional force europe treaty consider key arm control treaty,conventional force europe treaty key soviet era arm control treaty,4.0,0.8014143100016231,4874,4457,417,173889
3594,nicaragua commemorate anniversary sandinista revolution top dictatorship anastasio samoa impose cuban style dentist regime,nicaragua commemorate anniversary sandinista revolution,3.799999952316284,0.5945404972983636,3368,4314,-946,894916
3595,word turkey arrest near paris suspicion money wandering kurdistan worker party,word investigation france suspicion money wandering terrorist organization know kurdistan worker party,2.5999999046325684,0.6567046351776124,3833,2377,1456,2119936
3596,meeting last day,meeting last day,3.400000095367432,1.0,5669,3443,2226,4955076
3597,villager inadvertently involve drug trafficking,inmate serve sentence drug trafficking,1.399999976158142,0.3051651905294265,1455,1276,179,32041
3598,russian government strongly oppose plan install antimissile defense europe dismiss assertion interceptor need defend threat ran,talk naso headquarters baluyevsky repeat russia opposition plan install antimissile defense europe dismiss assertion interceptor need defend potential threat ran,3.200000047683716,0.6913007937691545,4075,3135,940,883600
3599,long long university collaborate university business government sector mainland china coordinate training program research center promote high teach research commercialization technology transfer,long long university collaborate tertiary education business government sector mainland china direct training program research center promote research commercialization technology transfer,5.0,0.8413732262733606,5109,5741,-632,399424
3600,chinese government give active cooperation assistance organization prohibition chemical weapon inspection,ecuadorian foreign ministry say statement delegate organization prohibition chemical weapon opal meeting,1.0,0.3402027830658399,1656,938,718,515524
3601,mexican government adopt series measure drug trafficking organize crime mexico,mexico adopt series measure drug trafficking organized crime,5.0,0.7437036613446344,4485,5742,-1257,1580049
3602,statement specify quantity warhead missile capable carry,statement specify warhead missile carry,5.0,0.7739444095526555,4680,5743,-1063,1129969
3603,threat international security,present major threat global security,4.199999809265137,0.4712479950570627,2455,4721,-2266,5134756
3604,nicaragua commemorate anniversary sandinista revolution,nicaragua reconcile approach anniversary sandinista revolution,2.400000095367432,0.695594300796029,4101,2294,1807,3265249
3605,russian president vladimir state decision cease implementation conventional force europe treaty response plan establish missile defense site eastern europe naso failure ratify amend version treaty,russian president vladimir state decision response plan establish missile defense site eastern europe naso failure ratify amend version treaty,4.199999809265137,0.8730532350025597,5292,4724,568,322624
3606,dutch national research institute carry chemical weapon experiment dutch defense ministry,deny journalist learn chemical weapon experiment defense ministry archive,2.5999999046325684,0.39333028052455454,1956,2417,-461,212521
3607,report issue security software vendor cafe say government affiliate hawker china forefront brewing saber cold war,government affiliate hawker china forefront burden saber cold war,3.400000095367432,0.6468403566879721,3763,3483,280,78400
3608,treaty limit number aircraft tank non nuclear heavy weapon europe sign,treaty limit number aircraft tank non nuclear heavy weapon europe,3.5999999046325684,0.966190255156146,5575,3840,1735,3010225
3609,attack originate abroad,esthonia official state attack originate russia,1.7999999523162842,0.49462467916072833,2624,1687,937,877969
3610,police arrest hondura drug trafficking suspect,bulgaria police arrest head drug trafficking group,1.399999976158142,0.505409227366957,2697,1280,1417,2007889
3611,japan rise occasion japan beat term military power,ozaena say japan rise occasion japan beat term military power,3.5999999046325684,0.9034996453149435,5424,3839,1585,2512225
3612,egypt jordan sign nuclear nonproliferation treaty long call middle east free weapon mass destruction,syria sign nuclear nonproliferation treaty allow agency expert inspect know nuclear facility,4.0,0.33426191491811297,1621,4414,-2793,7800849
3613,russia participate european space agency,france leader european space agency,1.2000000476837158,0.6302043178865082,3630,1237,2393,5726449
3614,myanmar military state,myanmar military,3.0,0.8772025303858632,5310,3055,2255,5085025
3615,man hang prison,dozen criminal hang public,1.7999999523162842,0.34651673781222986,1692,1710,-18,324
3616,amnesty international report comply european international non governmental organization saferworld oppose armed violence,amnesty international report comply european international non governmental form,3.200000047683716,0.7473557007915008,4509,3131,1378,1898884
3617,institute public policy research report say weak state pose threat britain national security state provide basis terrorist,report say weak state pose threat britain national security state provide basis terrorist,4.199999809265137,0.8522429287420603,5173,4709,464,215296
3618,italian government deny accusation insist nuclear program peaceful purpose,run insist nuclear program peaceful purpose,4.0,0.7171017305226476,4274,4418,-144,20736
3619,proliferation security initiative call stop search ship suspect carry weapon mass destruction,member proliferation security initiative consider way intercept ship aircraft suspect carry weapon mass destruction,3.200000047683716,0.7035224162672673,4166,3133,1033,1067089
3620,international community modernize seek fair reasonable effective way enhance nuclear non proliferation regime extensive consultation,proposal country advance time seek fair reasonable effective way enhance nuclear non proliferation regime broad consultation,3.400000095367432,0.7101081174152043,4221,3526,695,483025
3621,amnesty international publish report state indian project sell attack helicopter myanmar threaten european union arm embargo myanmar,amnesty international report title indian helicopter myanmar make monkey e arm embargo,3.799999952316284,0.6246883318677261,3590,4322,-732,535824
3622,smuggle kilogram pound heroin,defendant smuggle kilogram pound heroin,2.400000095367432,0.8792775362092853,5321,2297,3024,9144576
3623,people convict quand people court participate drug ring traffic heroin vienna china,court official state people people convict quand people court participate drug ring traffic heroin vienna china,3.400000095367432,0.9409503725895652,5533,3543,1990,3960100
3624,lawyer michael area name hilton reach comment,urban port authority police explosive inspector reach comment,2.0,0.21884682896480545,1043,1962,-919,844561
3625,country oppose weaponization space arm race space,china stress opposition weaponization arm race outer space,3.200000047683716,0.593461855447409,3361,3138,223,49729
3626,france belgium germany sweden italy britain provide part technology advanced light helicopter,france belgium germany sweden italy britain provide part technology advanced light helicopter india plan sell myanmar,3.400000095367432,0.8830155697702303,5338,3534,1804,3254416
3627,illegal arm trafficking increase sonya easy availability neighboring conflict,illegal arm trafficking increase sonya raise concern security,3.200000047683716,0.5180061005532482,2777,3139,-362,131044
3628,shanty state agreement sign defense research development organisation hindustan aeronautics limit indian air force upgrade india fleet m aircraft,shanty state upgrade soon canalise defense research development organisation hindustan aeronautics limit indian air force,3.400000095367432,0.7881434490433249,4782,3537,1245,1550025
3629,elbaradei state middle east peace deal reach parallel security agreement base eradicate weapon mass destruction region,elbaradei quote say peace deal israel arab neighbor reach parallel security agreement base eradicate weapon mass destruction region,4.599999904632568,0.7858096296061313,4756,5225,-469,219961
3630,drug trafficker face death penalty talk law,afghan drug trafficker catch tajikistan,1.600000023841858,0.36906936032295135,1803,1589,214,45796
3631,international atomic energy association united nations watchdog,international atomic energy agency nuclear watchdog,5.0,0.6620185345938604,3864,5744,-1880,3534400
3632,wen state main purpose germany visit advance trade economic technological exchange,wen state purpose visit germany advance trade economic technological exchange,4.800000190734863,0.9353077428801635,5521,5472,49,2401
3633,united states official know far north nuclear weapon program progress,hill head american negotiator north nuclear weapon program,1.2000000476837158,0.3745209091086415,1841,1233,608,369664
3634,police officer kill officer wound,clash seven police officer kill seriously wound,4.599999904632568,0.6363414579752378,3686,5224,-1538,2365444
3635,defense chief esthonia latvia lithuania germany italy spain slovak sign agreement provide staff funding center,defense chief esthonia latvia lithuania germany italy spain slovak sign agreement,2.799999952316284,0.8634522270759137,5238,2621,2617,6848689
3636,bill propose new law allow use space program defense approve low house japan government week,bill new law approve japanese government low house week,3.400000095367432,0.5959687465007799,3383,3513,-130,16900
3637,van der mere sentence give total year imprisonment,van der mere suspend give sentence year imprisonment,2.5999999046325684,0.870814907257366,5276,2429,2847,8105409
3638,zahedan city southwestern,city southwestern,1.7999999523162842,0.7297654519219536,4362,1702,2660,7075600
3639,president state russia countermeasure,warn russia retaliatory action,4.400000095367432,0.15292140322898815,795,5057,-4262,18164644
3640,china far balk united states pressure china stop search north organ ship,china state united states pressure china stop search north organ ship trigger military clash,4.0,0.7396585296690943,4453,4430,23,529
3641,brazil strategic affairs minister robert mangabeira state brazil new national defense plan call establish partnership country include russia france build state art weapon industry,state brazil new national defense plan call establish partnership country include russia france build state art weapon industry,3.799999952316284,0.8294178647464487,5043,4255,788,620944
3642,accuse charge international drug trafficking,accuse charge money wander tax invasion corruption,1.600000023841858,0.28236949015157164,1337,1586,-249,62001
3643,variant advanced light helicopter contain rocket launch belgium ricket gun engine france brake system italy fuel tank gearbox britain self protection equipment swedish company receive crucial design development engine control manufacture german company,arsenal rocket launch belgium ricket gun engine france brake system italy fuel tank gearbox britain self protection equipment swedish company,3.5999999046325684,0.751351289308672,4537,3876,661,436921
3644,indian defense ministry increase spending defense purchase,indian defense ministry increase defense spending new purchase percent,3.5999999046325684,0.9497839569800703,5552,3875,1677,2812329
3645,idea report restrict,tiller escape,0.0,0.0,212,180,32,1024
3646,conventional force europe treaty sign russian naso member,conventional force europe treaty amend,2.200000047683716,0.6253283113526945,3598,2089,1509,2277081
3647,salad ilii say civilian casualty result overnight mortar rocket attack happen day,salad ilii state civilian casualty result overnight mortar rocket attack admit hospital nearly day,3.5999999046325684,0.834448926915659,5073,3873,1200,1440000
3648,south african government maintain good relation united states government,cf issue negative impaction russia relation united states europe,1.2000000476837158,0.3008714621782458,1431,1229,202,40804
3649,nuclear weapon system high level readiness increase risk weapon include unintentionally catastrophe consequence,resolution say high level readiness increase risk use weapon unintentional accidental use catastrophe consequence,4.199999809265137,0.6074900213802994,3465,4738,-1273,1620529
3650,state essential increase effort eliminate nuclear arm weapon mass destruction,visit new zealand say essential great effort eliminate nuclear arm weapon mass destruction,3.400000095367432,0.7574128888433825,4577,3494,1083,1172889
3651,demand province world large producer opium,area group world large nuclear engineering firm,0.0,0.21009324017352837,1015,182,833,693889
3652,afghanistan run border region scene frequent clash police drug smuggler,area near town mirjaveh scene frequent conflict italian police drug smuggler,3.799999952316284,0.5161342404608865,2766,4292,-1526,2328676
3653,physician danilov convict sell classified information space technology china,physician valentine danilov find guilty sell classified information space technology china,4.400000095367432,0.8297021446623806,5045,5063,-18,324
3654,myanmar world large producer illegal opium limit financial technical resource end drug trade,myanmar world large producer illicit opium accord late state department anti narcotics report,3.400000095367432,0.3657758234476961,1785,3498,-1713,2934369
3655,abducted support group hope parliament change law soon,abducted support group use survey press parliament pass new law,3.0,0.5757423582182709,3216,2956,260,67600
3656,santo stated colombian police find evidence computer discover slain rebel leader paul eye,francisco santo state colombian police find evidence computer discover paul eye,4.0,0.7277154553394373,4340,4470,-130,16900
3657,buy spokesman vietnamese ministry culture information,retell spokesman mission united nations,0.800000011920929,0.12009286717908677,649,789,-140,19600
3658,nieman spokesman germany state enrich von pierre state nieman begin talk interested chinese party sale plutonium processing facility,nieman spokesman germany state enrich von pierre state gerard schroeder state gerard schroeder sale plutonium process facility principle,4.0,0.5664084385373293,3154,4484,-1330,1768900
3659,vienna world strict drug law,vienna drug law world strict law,5.0,0.9549791229415636,5564,5745,-181,32761
3660,government initiative diary ineffective,governance institution ineffective long time somalia,1.0,0.2625128581054341,1241,989,252,63504
3661,state russian government withdraw treaty altogether western nation refuse ratify amend treaty,state russia discard treaty entirely western nation refuse ratify amend version,5.0,0.5859936272802873,3292,5746,-2454,6022116
3662,russia ratify amend version treaty,russia ratify amend treaty,5.0,0.8794684889033315,5322,5747,-425,180625
3663,discuss possible extension mission kosoy,discuss kazakhstan bid hold presidency,2.200000047683716,0.17474851327513302,892,2097,-1205,1452025
3664,elbaradei international atomic energy agency chief,mohammed elbarade international atomic energy agency director general,4.800000190734863,0.5144327529276922,2756,5474,-2718,7387524
3665,nuclear nonproliferation treaty year old,nuclear nonproliferation treaty review year,1.7999999523162842,0.7580885487791333,4584,1633,2951,8708401
3666,chinese foreign ministry spokesman king state saber hacking global issue,chinese foreign ministry spokesman gang ask respond henry speech china military development,2.200000047683716,0.3218916082655066,1549,2103,-554,306916
3667,plant construct exist plant project operational year,plant construct exist plant supply china operational,2.5999999046325684,0.8424943145458648,5117,2442,2675,7155625
3668,saber attack consider grow threat military civilian computer network,naso consider saber attack grow threat military civilian computer network,4.400000095367432,0.9422925765594051,5536,5031,505,255025
3669,india blame foreign militant propaganda mislead international community,abe urge assertion foreign policy japan international community,1.2000000476837158,0.3072009938020731,1466,1228,238,56644
3670,riyadh base nail arab academy security science say statement run week workshop anti terrorist expert,statement nail arab academy security science sponsor week workshop anti terrorist expert,4.800000190734863,0.8250170108289371,5012,5451,-439,192721
3671,percent liberal democratic party support economic sanction,percent opposition democratic party support economic sanction,3.799999952316284,0.8271201451361496,5025,4285,740,547600
3672,sharp islamic law,run islamic republic,1.2000000476837158,0.3657492062762351,1784,1198,586,343396
3673,number suspect islamic militant alleged al say link arrest malasha singapore official state militant network extend indonesia,suspect islamic militant alleged al say link arrest malasha singapore,3.0,0.8104001512980348,4930,2932,1998,3992004
3674,september jordan sign accord united states aim support peaceful development jordan nascent nuclear program,september united states sign accord jordan aim support peaceful development jordan new nuclear program,4.599999904632568,0.9258655232532589,5499,5170,329,108241
3675,accord statement reinforce military potential strategic force overcome anti missile defense system,accord statement prototype rocket unlike tool m equip multiple independently targetable warhead overwhelm defense system,3.200000047683716,0.17238321791958905,880,3205,-2325,5405625
3676,hang labor sister baluchestan province,zahedan capital sister baluchestan province,0.2000000029802322,0.6221373162797271,3573,398,3175,10080625
3677,run lie major drug route afghanistan europe persian gulf state,run lie major drug trafficking route afghanistan europe persian gulf state,4.800000190734863,0.951882039441542,5555,5452,103,10609
3678,post australian government,plan anger russian government,0.0,0.2181635643723133,1040,200,840,705600
3679,permanent united nations security council member britain china france russia united states,member britain china france russia germany united states,3.5999999046325684,0.6875481174220653,4047,3859,188,35344
3680,july jordanian prime minister maaruf bandit state raghdad russen family live protection king abdullah ii,jordanian prime minister maaruf bandit say july raghdad russen family live protection king abdullah ii run issue,4.199999809265137,0.9462035225513977,5547,4745,802,643204
3681,nieman spokesman germany state agency france press nieman confident outcome talk sell plutonium process facility,nieman spokesman germany refrain comment political aspect sale plutonium processing facility,2.5999999046325684,0.454632914579086,2335,2396,-61,3721
3682,saber attack occur french president sarkozy meeting adlai lamp anger chinese government,saber attack occur french president nicholas sarkozy meeting exile tibetan spiritual leader adlai lamp,3.799999952316284,0.6671730957938552,3900,4253,-353,124609
3683,south african government impose ban prohibit recruitment people inside outside south africa mercenary foreign military assistance,south africa foreign ministry state south africa foreign military assistance act prohibit recruitment people inside outside south africa mercenary foreign military assistance,3.799999952316284,0.7761716851041417,4698,4245,453,205209
3684,ukraine necessary approval join european space agency program,france leader european space agency,1.600000023841858,0.46377366921762475,2394,1579,815,664225
3685,north organ government warn south organ government participate proliferation security initiative program,north organ government state south organ government participate proliferation security initiative program result specify catastrophe consequence,3.200000047683716,0.794458590698144,4828,3209,1619,2621161
3686,china council agriculture open special office charge agricultural technology transfer intellectual property right management consultant enhance development china knowledge base agriculture application agricultural technology,lee state coat spend past year set relevant mechanism draft set promotion measure enhance development china knowledge base agriculture application agricultural technology,3.200000047683716,0.4734387628929406,2472,3210,-738,544644
3687,italian parliamentary speaker gholam ali add anel visit cuba,agreement sign italian male parliament speaker gholam ali add anel visit cuba,3.0,0.779199538582932,4716,2935,1781,3171961
3688,time suspect chinese government create virus spy tibetan exile adlai lamp,time suspect chinese government launch attack,2.5999999046325684,0.38944421356746806,1936,2399,-463,214369
3689,chinese authority immediately available comment,godzhayev godzhayev lawyer immediately available comment,1.0,0.4238544810295166,2149,982,1167,1361889
3690,european union united states freeze al asset,western government include united states france,0.4000000059604645,0.28504270565419915,1351,555,796,633616
3691,chinese government strengthen china anti proliferation capacity recent year,chinese government strictly censure china chemical import export accord law recent year,1.0,0.3454704518074245,1687,980,707,499849
3692,group represent mainly white south africans call afriforum state organize protest route zimbabwe,afriforum state group organize protest route zimbabwe,4.199999809265137,0.7559486580264996,4565,4712,-147,21609
3693,announce cf treaty duly protect russia security interest,cf treaty duly protect russian federation security interest,3.5999999046325684,0.7366205678581119,4425,3972,453,205209
3694,ahead fight tradition united states lodge formal complaint allege british police connect intelligence report implicate ahead terror activity desecrate moran,ahead lodge formal complaint independent police complaint commission allege british police connect intelligence report implicate ahead terror activity desecrate ahead copy islamic holy book moran put moran floor search ahead home,3.400000095367432,0.777428880132344,4704,3449,1255,1575025
3695,russia ratify amend version united states naso member refuse russian government withdraw troop soviet republic moldavia georgia,united states naso member refuse ratify amend version russia withdraw troop soviet republic moldavia georgia,3.5999999046325684,0.9598982109829549,5569,3959,1610,2592100
3696,purpose united states plan increase pressure north,united states ally united states believe run pursue nuclear arm,0.800000011920929,0.3863064061394349,1918,813,1105,1221025
3697,tskhinvali capital georgia,paris capital france,0.4000000059604645,0.2719774698335304,1294,565,729,531441
3698,indian government official state india attach presence report amnesty international,indian government official study blueprint state science old date functional,1.399999976158142,0.2680274346175986,1274,1272,2,4
3699,china cabinet state council announce amend regulation dual use nuclear technology prevent nuclear terrorist,amend regulation dual use nuclear technology prevent nuclear terrorist,2.400000095367432,0.8495541431258844,5161,2272,2889,8346321
3700,japanese prime minister junichiro koizumi say shift rod practice,japanese prime minister junichiro koizumi attend summit north north organ leader long il,1.2000000476837158,0.48753645471508317,2564,1171,1393,1940449
3701,opposition japanese communist party new law fear lead strong military,opposition japanese communist party bill propose new law,3.200000047683716,0.7110899052061918,4228,3191,1037,1075369
3702,see official state standardization difficult different country political system,official state task difficult see member varied legal political system,3.5999999046325684,0.4171193866978308,2107,3966,-1859,3455881
3703,run sob security council stop country oil revenue pay compensation victim gulf war salary united nations monitoring purification inspection commission inspector money remain united nation oil food account transfer government development fund,ran new leader sob united nations security council stop ran oil revenue pay salary inspector money remain united nation oil food account transfer irate government,4.0,0.7124550943769681,4238,4367,-129,16641
3704,key european arm control treaty maintain,cf treaty key european arm control treaty,2.200000047683716,0.7538441739224349,4553,2117,2436,5934096
3705,golden triangle region world big producer opium,demand province world large producer opium,2.5999999046325684,0.4583701229898738,2360,2404,-44,1936
3706,united states dismiss action nuclear blackmail,united states say stand nuclear blackmailed rule negotiation,2.200000047683716,0.34057852358462726,1658,2124,-466,217156
3707,meeting day long,meeting last day,2.799999952316284,0.8306490044922494,5054,2631,2423,5870929
3708,minister china law india myanmar thailand address crop substitution initiative impoverished ethnic minority rely opium cultivation,minister china law india myanmar thailand discuss find market good produce crop substitution related program co tourism handicraft manufacturing,3.5999999046325684,0.40063298024032107,2010,3960,-1950,3802500
3709,china nuclear power member security council,china permanent member un security,3.0,0.49244394740681896,2602,2968,-366,133956
3710,north organ official suspect build nuclear weapon,north currently process dismantle nuclear weapon program,2.0,0.3002704955714548,1428,1889,-461,212521
3711,australian television reporter peter lloyd face new drug charge singapore,accord court document july australian television reporter peter lloyd face new drug charge singapore,3.400000095367432,0.8530092735773831,5179,3505,1674,2802276
3712,president vladimir sign decree suspend russia participation conventional force europe treaty,russian president vladimir sign decree suspend russia participation conventional force europe treaty circumstance affect security russian federation require immediate measure,3.0,0.6853969717375906,4026,2993,1033,1067089
3713,tradition condition stimulate tunisian prosecute single charge falsify document italian authority provide sufficient evidence prosecute,spokesman swiss justice ministry folio gall state tradition condition stimulate mere prosecute single charge falsify document italian authority provide sufficient evidence prosecute,2.5999999046325684,0.7907675430204794,4803,2410,2393,5726449
3714,attack believe come russian administration address response relation soviet statue esthonia,attack occur dispute government russia esthonia relation soviet war memorial,3.0,0.40505401665680957,2040,2996,-956,913936
3715,india parisian remain outside treaty,israel remain outside treaty,2.0,0.6741134061645944,3941,1892,2049,4198401
3716,china member ballistic missile club,russia member quarter middle east,0.0,0.16908407978909792,866,190,676,456976
3717,russia pull treaty naso ally refuse ratify amend version,warn russia withdraw treaty western nation refuse ratify amend version,4.400000095367432,0.6098633975720643,3485,5109,-1624,2637376
3718,particularly true poor country,particularly ethiopia withdraw force,0.4000000059604645,0.2650857309533192,1260,472,788,620944
3719,run noticeably increase number execution recent month official enforce campaign aim promote virtue boast security,italian official increase execution official enforce campaign purportedly aim promote virtue boast security society,3.5999999046325684,0.7157835428171698,4264,3971,293,85849
3720,statement issue official sea news agency state al dosage convict drug trafficking,rapid identify hossein safarlou convict drug trafficking,0.6000000238418579,0.2713591871862409,1290,617,673,452929
3721,tajikistan uzbekistan share border afghanistan experience maid italian back islamic militant recent year,neighbor kyrgyzstan experience maid italian back islamic militant recent year,1.7999999523162842,0.6144470290299613,3520,1692,1828,3341584
3722,russia say system clear threat russian security,threat international security,1.7999999523162842,0.511460493869581,2741,1713,1028,1056784
3723,gang engage illegal activity include racketeering blackmail arm smuggling cigarette smuggling money wander allegedly proceed fund terrorist group chechnya,dans state gang engage illegal activity include racketeering blackmail arm smuggling cigarette smuggling money wander,3.0,0.80332851253583,4885,3003,1882,3541924
3724,state scientific center applied microbiology kind deadly bacteria study use secret biological weapon program soviet union,state scientific center apply microbiology work western scientist convert complex biomedical manufacturing site,3.400000095367432,0.2574951254179075,1212,3529,-2317,5368489
3725,international atomic energy agency access people document site,international atomic energy agency base,1.2000000476837158,0.6469703361560649,3765,1169,2596,6739216
3726,book state drug convey completely positive image,official state complete technology transfer,0.0,0.08370142935696559,460,193,267,71289
3727,inmate serve sentence murder,inmate serve sentence drug trafficking,1.399999976158142,0.7252474738097735,4324,1269,3055,9333025
3728,russia fulfil obligation increase force,russia suspension obligation cf treaty temporary,2.0,0.3310158819353373,1603,1914,-311,96721
3729,executive director arms control association washington day kimball state idea report series bad sign,executive director arms control association washington day kimball state israel document affect debate india,3.5999999046325684,0.6538011309968583,3806,3957,-151,22801
3730,cf issue negative impaction russia relation united states europe,treaty issue cause tense relation government russia europe,4.0,0.4072865517790586,2045,4681,-2636,6948496
3731,korobeynichev laboratory work lawrence evermore national laboratory,korobeynichev laboratory work scientific institute,3.200000047683716,0.5914820908370356,3343,3182,161,25921
3732,sugar nun senator,sugar nun award prime minister medal,1.7999999523162842,0.5278979644288271,2844,1759,1085,1177225
3733,official state decision treaty depend action plan deploy missile defense system poland czech republic,russian military official state decision depend united states proceed plan deploy missile defense component poland czech republic,4.0,0.7456186391606964,4501,4673,-172,29584
3734,signing agreement peripheral issue meeting chief defense staff ally country naso,agreement sign regular meeting chief defense staff naso ally,3.0,0.643566632304815,3738,2987,751,564001
3735,early official philippine malasha indonesia sign anti terrorist agreement share airline passenger list intelligence,early philippine malasha indonesia sign agreement share terrorist intelligence,3.5999999046325684,0.8048024497553199,4892,3931,961,923521
3736,meeting leader european union leader albany bosnia herzegowina croat macedonia serbia montenegro leader western balkan country pledge diminish organize crime corruption balkan meet requirement european union membership,leader albany bosnia herzegowina croat macedonia serbia montenegro meet time european union leader pursue join european union,3.200000047683716,0.7034340554667537,4163,3185,978,956484
3737,resolution require united nations member state adopt law prevent terrorist black musketeer non state actor manufacturing acquire traffic nuclear biological chemical weapon material,resolution require country adopt law prevent non state actor manufacturing acquire traffic nuclear biological chemical weapon material missile system deliver,3.5999999046325684,0.790807593898075,4804,3932,872,760384
3738,international atomic energy association state jordan agree additional measure,international atomic energy association united nations watchdog,2.0,0.47060160292892605,2453,1936,517,267289
3739,concern drug,work,0.4000000059604645,0.0,236,547,-311,96721
3740,amnesty international report suggest belgium begin immediate talk india prevent future sale component military technology myanmar,report urge belgium begin immediate talk india order prevent future weapon sale myanmar,3.0,0.6810794066946042,3993,2986,1007,1014049
3741,capital offense ran include murder rape armed robbery apostasy blasphemy drug trafficking repeat sooty adultery restitution treason espionage,capital offense ran include murder rape armed robbery drug trafficking adultery,3.0,0.7158839094598699,4266,2979,1287,1656369
3742,say arabia absolute monarchy take step reform,say arabia absolute monarchy consultation council appoint government,3.400000095367432,0.5982812516533015,3393,3450,-57,3249
3743,spokesman say exchange opinion topical international regional matter base joint working relationship heart kamynin say russia recognize participation tibia work security council,kamynin say exchange opinion topical international regional matter base joint working relationship heart un,3.0,0.8160076022294358,4961,2982,1979,3916441
3744,amalgam visit london libyan foreign minister,visit tibia russian foreign minister announce,2.5999999046325684,0.41308497344276207,2087,2400,-313,97969
3745,indian pakistani government nearly engage fourth conflict,indian pakistani government conduct nuclear test,1.7999999523162842,0.3996464050014662,2000,1770,230,52900
3746,iguaran state detain accuse homicidal criminal collaboration kidnapping funding terrorist,iguaran state detain involve murder police member anti kidnapping group,3.799999952316284,0.45233580753404007,2319,4268,-1949,3798601
3747,suspect extremist release bail,suspect extremist provisional release bail,2.400000095367432,0.8388082292748561,5099,2285,2814,7918596
3748,czech hospital employee charge human organ trafficking,accuse charge international drug trafficking,0.800000011920929,0.29898213826364617,1421,817,604,364816
3749,aggravate situation,north act aggravate situation,2.0,0.8064186362128971,4900,1940,2960,8761600
3750,drug lord capture marine mexico,suspect drug lord know ll taliban hold mexico,2.5999999046325684,0.5030913021792939,2679,2428,251,63001
3751,dismiss got review plea vodafone tax case,dismiss got review petition vodafone tax verdict,4.400000095367432,0.7256422582192426,4329,5097,-768,589824
3752,explosion hit oil pipeline syria,explosion hit pipeline sad attack city,2.5999999046325684,0.6401396143735815,3712,2426,1286,1653796
3753,nato soldier kill afghan attack,nato soldier kill afghanistan,3.799999952316284,0.6663307689625746,3894,4247,-353,124609
3754,gastro celebrate birthday monday,gastro celebrate birthday,4.199999809265137,0.9117600003943197,5450,4786,664,440896
3755,israel ex spy warn messianic ran war,israel ex spy boss trust leadership ran video,3.0,0.4474177305773991,2295,2999,-704,495616
3756,eye open supreme court rule arizona immigration law,supreme court issue split rule arizona immigration law,3.799999952316284,0.753264744950606,4548,4295,253,64009
3757,nato trace path afghanistan,nato leader commit afghanistan transition,3.200000047683716,0.33739055371862564,1641,3117,-1476,2178576
3758,syria say suicide bomber kill damascus,damascus suicide come kill,4.0,0.6707136016260224,3926,4693,-767,588289
3759,machine tendulkar say god machine,machine tendulkar score cricket century,0.800000011920929,0.5142601726593146,2754,819,1935,3744225
3760,australian millard set win leadership challenge,australian defiant pressure leadership,2.400000095367432,0.39185287338551666,1945,2302,-357,127449
3761,drama back philippines south china tea,drama say clear rule need calm south china tea,2.400000095367432,0.537601720371912,2936,2291,645,416025
3762,teenager china kill wound knife attack,teenager kill knife attack,3.200000047683716,0.824262608596053,5006,3113,1893,3583449
3763,syrian rebel command turkey syria,free syrian army move headquarters turkey syria,3.799999952316284,0.4356557956008768,2218,4281,-2063,4255969
3764,knesset speaker drama reelection bad israel,state sue drama administration birth control rule,0.4000000059604645,0.08918788710502769,479,549,-70,4900
3765,greece bond exchange large debt restructuring history,greece secure big debt deal history,2.799999952316284,0.48832078505022025,2571,2579,-8,64
3766,ruin sins russian presidential election,poll open russian presidential election,1.0,0.5191845084712805,2791,966,1825,3330625
3767,indian finance minister quit run president,julian assange plan run australian senate,0.2000000029802322,0.08537435995674203,466,413,53,2809
3768,merry sandusky find guilty child sex abuse trial,sandusky find guilty child sex abuse trial,3.799999952316284,0.9334622914493728,5518,4278,1240,1537600
3769,tibetans self isolate western china report,tibetans self isolate china,2.400000095367432,0.8719847770280399,5284,2287,2997,8982009
3770,white house damage control drama supreme court remark,act check drama supreme court remark,3.5999999046325684,0.5722039672842232,3198,3936,-738,544644
3771,anna warn talk syria risk,ruin anna meet syria crisis,2.0,0.41698995456783416,2106,1946,160,25600
3772,quarter call israelis palestinians end irritant,occupation confiscate drum palestinian land heir stir,1.399999976158142,0.0,254,1268,-1014,1028196
3773,audit permit woman compete olympics,maude woman allow compete olympics,4.800000190734863,0.5312256453903883,2879,5454,-2575,6630625
3774,siberia university mass attack luman,siberia university combed north,2.200000047683716,0.4385526953921667,2238,1984,254,64516
3775,china cabinet promise boost economy,china men promise job creation,3.200000047683716,0.34882784783081566,1704,3108,-1404,1971216
3776,tropical storm isaac boot bless claim,tropical storm form stay open atlantic,1.0,0.3113546133301376,1488,931,557,310249
3777,freddie start arrest vile abuse probe,man arrest vile sex abuse probe,3.200000047683716,0.6824934234617583,4008,3112,896,802816
3778,money announce paul run mate,money name run mate,5.0,0.7552022435189522,4560,5725,-1165,1357225
3779,stock rise early greek deal flatten,stock edge high greek debt deal,3.5999999046325684,0.43609933674942114,2222,3952,-1730,2992900
3780,suicide come rock elite semen military camp,suicide comber attack semen military post,4.0,0.4289952877475619,2175,4537,-2362,5579044
3781,nato international troop kill afghanistan,nato troop kill day afghanistan,2.200000047683716,0.7931816200406875,4818,2049,2769,7667361
3782,moscow protest demand vladimir ruin resignation,moscow protest vladimir ruin small quieter,1.7999999523162842,0.606201757090651,3455,1733,1722,2965284
3783,french election trout high expect,french presidential election round live update,1.0,0.3050264710627732,1451,961,490,240100
3784,australia establish world large marine reserve,australia create world large marine reserve,4.400000095367432,0.818230195024521,4975,5012,-37,1369
3785,soldier shoot kill afghan soldier,british soldier kill afghan policeman,1.600000023841858,0.5833234626791,3271,1526,1745,3045025
3786,italy soldier die afghanistan,soldier kill afghanistan,1.399999976158142,0.6072833369138431,3460,1302,2158,4656964
3787,bias lead palestinian unity government,bias propose interim unity government,4.0,0.631175941436802,3643,4573,-930,864900
3788,egypt optic church james new hope,egypt optic church prepares choose hope,2.799999952316284,0.6623068272446843,3866,2575,1291,1666681
3789,kalaw officially confirm president death,kalaw confirm president mutharika death,3.5999999046325684,0.6638602745319616,3881,3943,-62,3844
3790,ali tuareg rebel declare independence,ali rebel declare independent azawad,3.799999952316284,0.44446390923838763,2277,4257,-1980,3920400
3791,dance armstrong strip de france title,dance armstrong plot strategy loss title,1.399999976158142,0.5111884992263734,2738,1315,1423,2024929
3792,egypt vote final day presidential election,poll open france presidential election,1.0,0.3579602484302292,1744,894,850,722500
3793,madeleine mccann live,open madeleine case police urge,0.6000000238418579,0.3789877873732404,1874,629,1245,1550025
3794,russie suffer find stricken asylum seeker,mayday fear asylum seeker,1.399999976158142,0.4111108246637598,2074,1301,773,597529
3795,isaf coalition troop kill attack involve afghan police,nato say troop kill insider attack afghan south,3.0,0.39096781931954583,1941,2954,-1013,1026169
3796,security council unanimous vote syria,security council vote syria monitor,3.200000047683716,0.6432953581350714,3736,3096,640,409600
3797,human kill shoot wisconsin temple,human kill shoot temple wisconsin,5.0,1.0,5651,5724,-73,5329
3798,mud buy motorcycle maker ducati,probe motor insurance market,0.6000000238418579,0.0,55,628,-573,328329
3799,china news agency hope syria peace,china state news agency hope syria peace,4.199999809265137,0.9471805179685179,5548,4770,778,605284
3800,dead suicide attack semen police academy,force intensify attack somali rebel,0.4000000059604645,0.1043873261157936,552,554,-2,4
3801,south order immediate shutdown nuclear factor,south boost nuclear power,1.2000000476837158,0.2622916493504671,1240,1157,83,6889
3802,ally set demand ran nuclear talk,ran will accept pre condition nuclear talk,1.600000023841858,0.3313440839176628,1607,1546,61,3721
3803,aol say sell patient microsoft,aol sell patient microsoft billion,4.800000190734863,0.8943346214134187,5388,5455,-67,4489
3804,thousand troop march jubilee,thousand flock amsterdam queen,1.2000000476837158,0.18572294147385537,931,1155,-224,50176
3805,middle israel james leader convict,middle ran prisoners escape kirkuk,0.800000011920929,0.1985596866967054,978,791,187,34969
3806,navy met rashes apartment building,navy met rashes apartment clock,4.199999809265137,0.8046308952018832,4890,4768,122,14884
3807,woman die abortion refusal,woman die cliff collapse corset,0.6000000238418579,0.22616976327739224,1067,620,447,199809
3808,turkey weigh fly bone syria,turkey lighten coordination syria,2.200000047683716,0.2863813792163831,1357,2037,-680,462400
3809,death toll rise brazzaville blast,long head arms depot last,3.5999999046325684,0.0,59,3930,-3871,14984641
3810,retire stud,win weakness,1.0,0.0,38,927,-889,790321
3811,syria journalist rescue bid fail,journalist smuggle,0.6000000238418579,0.31975391973803163,1535,616,919,844561
3812,new sex claim hit secret service,new rule secret service,1.7999999523162842,0.6074317624369101,3464,1748,1716,2944656
3813,misha basis release bail,angela release hospital,0.0,0.22254634988612992,1057,169,888,788544
3814,person kill sectarian clash lebanon,kill ran earthquake,0.0,0.1261053757187615,679,168,511,261121
3815,pain financial stock push european equity,british christians complaint european court,0.0,0.14968897537104253,783,167,616,379456
3816,turkey raise alarm syrian refugees,turkey seek delicate syrian refugee,1.600000023841858,0.30051619996473794,1430,1471,-41,1681
3817,suspected al qaeda financier arrest france,al qaeda suspect arrest pain,1.600000023841858,0.5005011549808822,2660,1543,1117,1247689
3818,damage tsunami quaker hit indonesia sumatra,quaker hit indonesia s sumatra usgs,1.600000023841858,0.688384918124597,4055,1517,2538,6441444
3819,israel air strike kill papa,israel air strike kill papa death toll,2.200000047683716,0.8344741583818702,5074,2062,3012,9072144
3820,kill wound wave coming ran,kill wound car bomb ran kirkuk,1.399999976158142,0.42168274018952046,2135,1387,748,559504
3821,palestinian prisoner end hunger strike deal,israel free palestinian hunger striker,2.0,0.39546663350163763,1978,1929,49,2401
3822,hezbollah confirm send drone down israel,hezbollah say send drone israel,3.400000095367432,0.8498188499275463,5162,3597,1565,2449225
3823,rebel fighter capture syrian soldier,free syrian army capture syrian officer,3.200000047683716,0.4451749716450477,2284,3084,-800,640000
3824,colorado shoot suspect psychiatric care,doctor treat aurora shooting suspect medical reprimand,2.400000095367432,0.11051117621297002,601,2320,-1719,2954961
3825,quaker rock indonesia papa usgs,quaker rock indonesia papa geological survey,4.800000190734863,0.6312298284651937,3645,5456,-1811,3279721
3826,time andy murray v roger severer wimbledon man final need know big game,time paralympic opening ceremony need know big curtain raise,0.4000000059604645,0.2800417925797086,1329,560,769,591361
3827,new jersey school dans hugging,school bank hugging,3.5999999046325684,0.565174220322695,3144,3969,-825,680625
3828,ran islamic republic ran step relief effort quaker kill,ran step relief effort quaker kill,4.599999904632568,0.8369365293641833,5088,5192,-104,10816
3829,tsunami warning issue southern alaska,tsunami warn canada quaker,2.400000095367432,0.27542935230876964,1309,2226,-917,840889
3830,evidence afghanistan massacre case,toll afghanistan hit,0.800000011920929,0.25707041663443025,1208,802,406,164836
3831,wash rich apple pay dividend buy share,apple pay share dividend buy stock,3.799999952316284,0.7726661807841387,4667,4109,558,311364
3832,report dead shoot empire state building,dead shoot outside empire state building,4.599999904632568,0.8508166877269867,5165,5191,-26,676
3833,australian unemployment percent,french unemployment rate rise percent,1.0,0.5146185177272076,2758,906,1852,3429904
3834,share love high street,bandy strengthen year coast street shut,0.4000000059604645,0.16447023999193364,838,542,296,87616
3835,halliburton income rise,halliburton profit rise strong north america sale,2.5999999046325684,0.4525156577222741,2322,2443,-121,14641
3836,kill shrine come northwest pakistan,kill drone strike pakistan,0.800000011920929,0.29137300425105417,1376,805,571,326041
3837,china stock close mixed friday,china stock open lower friday,1.600000023841858,0.4969065571007254,2642,1556,1086,1179396
3838,india bank bulk text riot,tunisia lift cure riot,0.800000011920929,0.20356670527951154,995,807,188,35344
3839,monitor reach site syrian massacre video,monitor shoot way syrian massacre site,2.400000095367432,0.68717981294513,4042,2324,1718,2951524
3840,yorkshire soldier kill afghan bomb blast,soldier kill afghanistan blast,3.5999999046325684,0.5097779108304245,2722,3764,-1042,1085764
3841,radical islamists ali enlist new militia,local militia posters islamist militant ali,3.75,0.3188269534722731,1534,4007,-2473,6115729
3842,olympics opening ceremony round globe,opening ceremony give olympics rock start,4.199999809265137,0.6306161954625568,3636,4706,-1070,1144900
3843,kill french terror raid,die french anti terror operation,4.800000190734863,0.5126184782253298,2748,5461,-2713,7360369
3844,apollo quit england manager,apollo design england manager,5.0,0.7802291447999298,4723,5706,-983,966289
3845,dead ohio school shooting,dead wound ohio school shooting,3.200000047683716,0.8837672585631007,5340,3118,2222,4937284
3846,palestinians kill israel airstrike,palestinians kill iaf strike,2.400000095367432,0.37828076421597406,1872,2311,-439,192721
3847,pakistan condemn drone strike,pakistan convoy head protest drone strike,3.200000047683716,0.5352107110342824,2919,3109,-190,36100
3848,passive hurricane bandy bear coast,hurricane bandy gain speed matter east coast,4.0,0.4899508595511446,2583,4623,-2040,4161600
3849,sarkozy mile complaint gadhafi funding claim,sarkozy sue gaddafi cash claim burst campaign,3.5999999046325684,0.25360571485768557,1191,3769,-2578,6646084
3850,note heads wednesday july,note heads wednesday,2.0,0.8716863775834611,5282,1925,3357,11269449
3851,ran attack el iv israel strike,senior clerk ran attack el iv israel strike,4.400000095367432,0.7955380948818478,4832,4980,-148,21904
3852,gusmao consolidated power simon election,supreme court possibility money win election,0.0,0.10978937912601813,596,142,454,206116
3853,jena win mexico presidential vote exit poll,toll ruin win russia presidential vote,0.6000000238418579,0.38563043936948954,1910,650,1260,1587600
3854,syria tell russia troop pull,syria say troop begin pullout video,3.400000095367432,0.2938784709635385,1389,3562,-2173,4721929
3855,siberia plane crash survivor,chinese siberia plane crash victim,2.5999999046325684,0.622590310682093,3577,2446,1131,1279161
3856,explosion venezuela refinery hills,venezuela mourn oil refine blast death,2.799999952316284,0.21364653213856313,1027,2582,-1555,2418025
3857,strong earthquake hit mexico,strong earthquake strike near acapulco,3.5999999046325684,0.43838445774132584,2235,3748,-1513,2289169
3858,russia china veto resolution syria kill,russia china double veto syria resolution,3.799999952316284,0.8619072145858259,5230,4256,974,948676
3859,pakistani plane clash board,pakistani lane rashes people board,2.5999999046325684,0.45244502026340716,2321,2481,-160,25600
3860,security council order global sanction haqqani network afghanistan,order global sanction haqqani network,4.400000095367432,0.8369758364511299,5089,4981,108,11664
3861,erdogan ruin talk raise voice,foreign militant kill somalia strike car,0.0,0.0,89,143,-54,2916
3862,maude arabia arrest suspect militant al qaeda link,maude arabia arrest suspect militant state medium report,4.0,0.6103058134258592,3492,4542,-1050,1102500
3863,hurricane bandy loses coast,hurricane bandy take aim coast,4.800000190734863,0.6959350935243069,4106,5463,-1357,1841449
3864,chicago teacher strike action student good ill,chicago teacher strike pose test union,2.200000047683716,0.4664161944088985,2421,2054,367,134689
3865,panetta say afghanistan role shift combat,panetta afghanistan tops nato conference topics,1.600000023841858,0.32537687394579395,1566,1562,4,16
3866,man admit london stock exchange bomb plot,man admit london bomb plot,4.0,0.869344999164043,5266,4541,725,525625
3867,israel threaten action papa aid ship,israel attack papa strip rocket fire,1.600000023841858,0.29092185557545164,1374,1511,-137,18769
3868,body round russian met crash indonesia,body find russian jet crash indonesia,3.799999952316284,0.6739605625006984,3940,4243,-303,91809
3869,syria urge refugee return,syria tendon truce take hold,1.0,0.13377179293849328,712,921,-209,43681
3870,soldier kill civilian afghanistan,soldier kill afghan civilian shoot spree,4.199999809265137,0.5495234674830364,3029,4790,-1761,3101121
3871,superb murdoch victim cover,superb murdoch set second day trill,1.2000000476837158,0.5386158420236349,2943,1182,1761,3101121
3872,track drama bodyguard send restitution scandal,barclay boss fall rate fix scandal,0.4000000059604645,0.15295364114831803,796,520,276,76176
3873,china juan rise new high usd wednesday,china juan advance usd wednesday,3.799999952316284,0.719126472227396,4291,4290,1,1
3874,nissan sell steer wire car,nissan offer steer wire system infinite car,4.0,0.7392030861989352,4449,4566,-117,13689
3875,tibetan monk die set fire protest chinese rule,teenage tibetan monk die set fire china,3.799999952316284,0.6875344838209602,4046,4284,-238,56644
3876,lumbar costly indian city live,lech capital bangalore costly indian city live survey,1.0,0.5763271789750825,3220,903,2317,5368489
3877,quit murder,quit began weigh murder,3.799999952316284,0.6465995547439336,3761,4280,-519,269361
3878,israel kill james commander bomb papa target,israel airstrike kill james commander,3.400000095367432,0.6071927700260644,3459,3628,-169,28561
3879,gusmao consolidated power simon election,gusmao power simon,3.5999999046325684,0.7824568685205937,4739,3812,927,859329
3880,monitor reach site syrian massacre video,monitor unable reach site syria kill,4.400000095367432,0.5291776188060228,2852,4984,-2132,4545424
3881,nato condemn syria owning turkish military met,nato strongly condemn syria owning turkish jet,4.800000190734863,0.6971117125687053,4113,5471,-1358,1844164
3882,syria rebel attack lebanese post near border army,turkish army stage tank exercise near syria border,0.800000011920929,0.4292576221309897,2179,808,1371,1879641
3883,kill china building collapse,kill syria saturday,0.2000000029802322,0.16363490454098567,833,373,460,211600
3884,syrian force launch new attack,syria force launch aleppo attack,3.400000095367432,0.5818554152992848,3259,3649,-390,152100
3885,kazan fire ricket israel injury,kazan fire ricket cabinet approve reserve,1.399999976158142,0.5023942967473001,2673,1392,1281,1640961
3886,gaze death camp guard demjanjuk dead,john demjanjuk convict gaze death camp guard die age,4.599999904632568,0.7466785202832187,4507,5190,-683,466489
3887,boris johnson elect london mayor,johnson elect london mayor,3.799999952316284,0.8899063290564495,5362,4291,1071,1147041
3888,breivik drop far right salute court,breivik get year sentence,1.0,0.33252933466900547,1613,1078,535,286225
3889,second teenager charge murder,brother eastenders actress emma mccluskie charge murder,1.399999976158142,0.2517913412658715,1181,1423,-242,58564
3890,french dear new aerial miller murder,jersey murder trial miller hear voice,0.800000011920929,0.31261532053838537,1496,797,699,488601
3891,madoff brother plead guilty fraud,madoff brother plead guilty fraud,4.199999809265137,1.0,5699,4780,919,844561
3892,holland defeat sarkozy french presidency vote,poll open france presidential election,1.7999999523162842,0.0,397,1725,-1328,1763584
3893,libyan government retake tripoli airport,libyan militia take control tripoli airport,3.200000047683716,0.6201840790699576,3564,3082,482,232324
3894,clinton warn sonya cost election violence,clinton warn sonya cost election unrest,4.599999904632568,0.809227655356147,4922,5189,-267,71289
3895,arkansas supreme court strike execution law,arkansas justices strike death penalty,4.599999904632568,0.39948039288803117,1998,5188,-3190,10176100
3896,africa president angela discharge hospital,angela discharge hospital,4.199999809265137,0.8320004021645251,5061,4726,335,112225
3897,envoy turkey talk syria,increase export china,0.2000000029802322,0.0,333,372,-39,1521
3898,islamist dorsi sin egypt presidential election,ll chapter run presidential election egypt,1.0,0.361328044439036,1761,1072,689,474721
3899,donna summer queen disco,donna summer queen disco lie,1.600000023841858,0.927081835681107,5504,1491,4013,16104169
3900,bangladesh muslims torch buddhist shrine police,muslims torch buddhist temple,3.5999999046325684,0.6703905684689211,3923,3786,137,18769
3901,prone hills militant pakistan,police officer kill attacks dagestan,0.4000000059604645,0.0,320,524,-204,41616
3902,ali future interim president read office,hope lip dissent priest delicacy,0.0,0.0,319,155,164,26896
3903,kill injure late cairo clash,kill injure afghan airport suicide blast,1.2000000476837158,0.27967091132634114,1326,1225,101,10201
3904,money win maine republican caucus,money comeback narrow maine caucus win,3.799999952316284,0.6765467465860618,3962,4329,-367,134689
3905,court bahrain reject medius rally appeal,bahrain reject activist appeal,3.799999952316284,0.6016482152174667,3415,4287,-872,760384
3906,hurricane bandy power eastern seaboard,hurricane bandy move,3.5999999046325684,0.616247174988513,3536,3790,-254,64516
3907,clinton call friend syria unite,elastic artist call great support new talent,0.0,0.0,346,156,190,36100
3908,howling launch adult novel,syria launch ground assault aleppo,0.0,0.16650084519148473,850,157,693,480249
3909,algerian government party dominate election,algerian national trout parliamentary vote reach,2.400000095367432,0.23415633928595794,1104,2281,-1177,1385329
3910,security official kill semen,security personnel kill pakistan raid,0.6000000238418579,0.3028383866770964,1437,643,794,630436
3911,stock fall greek talk lumber apple fall,stock slip street greek talk drag,3.200000047683716,0.3230566215416798,1557,3125,-1568,2458624
3912,money pick vice presidential running mate source,money tap vice presidential running mate,5.0,0.7572776745590647,4574,5708,-1134,1285956
3913,nato stick transition roadway afghanistan rasmussen,nato helicopter make hard landing afghanistan,1.0,0.23883635131153408,1119,1064,55,3025
3914,mubarak face verdict murder trial,mubarak son face new charge insider trading,1.399999976158142,0.332436728280271,1610,1383,227,51529
3915,block investment,india allow pakistan investment,2.0,0.40090016612308776,2013,1883,130,16900
3916,kill northwestern pakistan,comb hills northwest pakistan,2.5999999046325684,0.1830587459804893,924,2402,-1478,2184484
3917,aid worker free operation afghanistan,suicide bomber kill mosque afghanistan,0.800000011920929,0.16843597602380359,860,812,48,2304
3918,nato soldier kill afghanistan,nato soldier kill afghan,3.5999999046325684,0.7262608896361455,4332,3813,519,269361
3919,canal tumbler french open final,canal seventh french open final,4.0,0.7062404030494929,4181,4378,-197,38809
3920,russian report fail attempt ruin,russia ukraine fail plot kill ruin report say,3.200000047683716,0.4996112061492737,2654,3213,-559,312481
3921,ruin claim victory russia presidential election,ruin win dispute russian presidential election,4.400000095367432,0.46741744392849827,2433,5111,-2678,7171684
3922,remain body find mexican cave,remain people find mexico cave,5.0,0.571326368658728,3190,5709,-2519,6345361
3923,orphan alps massacre girl return,alps attack girl return,4.0,0.653179266264019,3802,4376,-574,329476
3924,drama team raise debate stake,drama take offensive money debate,2.799999952316284,0.3884187727703274,1931,2630,-699,488601
3925,demyan minister kill plane crash,poland honor president kill plane crash,0.800000011920929,0.41395613761628647,2092,831,1261,1590121
3926,thousand gather new russian anti ruin rally,thousand gather moscow rival ally,2.799999952316284,0.37434047195070186,1840,2628,-788,620944
3927,google name new motorola nobility ceo,google appoint tennis roadside run motorola nobility,3.799999952316284,0.6040144636105833,3435,4242,-807,651249
3928,passive hurricane bandy bear coast,hurricane bandy take aim coast,4.400000095367432,0.6404717755733318,3714,5073,-1359,1846881
3929,rocket hit eshkol injury,ricket hit eshkol injure,3.400000095367432,0.492298988634266,2599,3532,-933,870489
3930,thousand syrian refugee flee turkey overnight,syrian refugee flee turkey overnight,3.799999952316284,0.9252482971919941,5498,4270,1228,1507984
3931,assange appeal tradition court,assange appeal tradition court,4.0,1.0,5691,4388,1303,1697809
3932,strong quaker bolt part pakistan,strong quaker hit eastern indonesia,2.0,0.44248269129251816,2267,1896,371,137641
3933,lebanese lumen clash syria crisis,syrian hold solution syria crisis,1.0,0.3288709636670762,1590,1100,490,240100
3934,mob kill man burn ran,pakistani mob hills turn moran,4.0,0.26626761477318756,1264,4355,-3091,9554281
3935,drone strike kill north waziristan,drone strike kill northwest pakistan official,1.7999999523162842,0.4380959909002671,2232,1643,589,346921
3936,salvador ali painting snatch new work gallery,salvador ali painting snatch nyc,4.599999904632568,0.7206071407024087,4300,5186,-886,784996
3937,ruin claim victory russia presidential election,ruin election victory russia greet protest,1.7999999523162842,0.6340882673620005,3665,1627,2038,4153444
3938,sarkozy announce election bid,france nicholas sarkozy make reelection bid official,4.199999809265137,0.4310662376558015,2191,4753,-2562,6563844
3939,release emergency oil stock,met agree emergency oil stocks release,4.599999904632568,0.5782965308838137,3234,5185,-1951,3806401
3940,eurozone unemployment stay record percent,eurozone unemployment record high june,3.0,0.68623418191411,4034,2957,1077,1159929
3941,french socialist party win parliament victory,french socialists win absolute parliament majority,3.799999952316284,0.3703840143167822,1810,4279,-2469,6095961
3942,salafi islamists police clash guns witness,second islamist hunger striker die tunisian prison,0.6000000238418579,0.0,340,640,-300,90000
3943,truss investigate french restitution ring,dominique truss face question french restitution ring,3.799999952316284,0.6777946464144172,3974,4272,-298,88804
3944,money win florida republican primary,money eye republican primary engage,1.7999999523162842,0.5995716471713196,3400,1653,1747,3052009
3945,drone strike kill north waziristan,suspect drone strike kill pakistan,2.5999999046325684,0.5025720148558479,2674,2440,234,54756
3946,traffic accidents leave head china,traffic accident leave dead china,2.400000095367432,0.53044734532718,2865,2283,582,338724
3947,head cia design affair,reckon capriati,0.0,0.0,366,159,207,42849
3948,france truss charge involvement restitution vice ring,truss charge restitution vice ring,4.0,0.8470027820793506,5146,4481,665,442225
3949,bony report record annual loss,bony forecast record annual loss,3.5999999046325684,0.82293216378227,5001,3797,1204,1449616
3950,kill papa israel airstrike,act airline strike,0.4000000059604645,0.0,312,531,-219,47961
3951,kill attack deadly ran day,kill ran attacks ahead ramadan,1.399999976158142,0.21375747756166857,1028,1384,-356,126736
3952,barclay hit fresh investigation,barclay hit fresh probe,4.400000095367432,0.7636239021229012,4622,5062,-440,193600
3953,close embassy syria,closed road armenia,0.4000000059604645,0.0,313,532,-219,47961
3954,heap new sanction syria,impose new sanction syrian regime,4.400000095367432,0.34747204838426626,1699,5059,-3360,11289600
3955,russians rally ruin rule,ten thousand rally ruin rule,3.400000095367432,0.7061548764090011,4180,3493,687,471969
3956,bahrain grand underway amid protest,bahrain race go ahead amid unrest,4.0,0.3875853283376112,1926,4513,-2587,6692569
3957,china stock open flat monday,chinese stock open mixed wednesday,1.399999976158142,0.30765746819671425,1468,1386,82,6724
3958,beryl grow say benign brain tumor,beryl grow benign brain humor,4.599999904632568,0.7330031971451292,4400,5184,-784,614656
3959,afghan parliament approve security,afghan parliament approve partnership,3.799999952316284,0.7346573403732215,4416,4283,133,17689
3960,german tourist pilot kill sonya air crash,senator reid involve begin car crash cnn,0.6000000238418579,0.10388250602740137,549,636,-87,7569
3961,israel palestinian negotiator quietly meet,israel palestinian negotiator meet jordan,3.5999999046325684,0.7026657323260982,4159,3796,363,131769
3962,astronaut veil armstrong dead,astronaut veil armstrong die,3.5999999046325684,0.8671190837892597,5252,3795,1457,2122849
3963,amnesty syria rebel commit abuse,amnesty investigator syria rebel commit abuse,4.199999809265137,0.9006321175912588,5414,4784,630,396900
3964,pitt money win republican primary indiana,money win florida republican primary,1.600000023841858,0.6695733140168513,3913,1475,2438,5943844
3965,german right activist lauck elect president,joachim lauck elect german president,4.0,0.7022386080119581,4153,4497,-344,118336
3966,south africa start investigation violence,south africa host peace talk standoff,2.400000095367432,0.3120462050379874,1492,2299,-807,651249
3967,dead injure china accident,dead miss india boat accident,0.4000000059604645,0.4549327454393751,2338,537,1801,3243601
3968,antrum romping minnesota victory,antrum win kansas caucus,1.0,0.24484364743596557,1146,1025,121,14641
3969,space legend veil armstrong die,man moon veil armstrong die,4.0,0.5863036911488484,3294,4423,-1129,1274641
3970,turkey weigh fly bone syria,turkey weigh fly bone syria,4.800000190734863,1.0,5657,5466,191,36481
3971,arrest double murder,man arrest police drug raid,0.800000011920929,0.2256260664377299,1065,818,247,61009
3972,florida county extend early voting,democrats want extend early voting hour,2.799999952316284,0.5921720051928866,3350,2620,730,532900
3973,warship set sail falkland,british warship get nail falkland,3.799999952316284,0.6284541451494036,3617,4308,-691,477481
3974,newcastle liverpool watch report picture video highlight,qpr west watch report picture video highlight,1.0,0.6161712756912932,3533,1023,2510,6300100
3975,palestinian prisoner end hunger strike,progress report palestinian prisoner hunger strike talk,2.799999952316284,0.7156834710542399,4261,2644,1617,2614689
3976,police kill german hostage take incident,palestinians kill idf strike northern strip,1.0,0.06776698685821238,424,1022,-598,357604
3977,egypt let mubarak presidential race,egypt confirm mubarak presidency race,4.25,0.5454001572519277,2994,4910,-1916,3671056
3978,syrian journalist kill capital,marines kill base attack,0.6000000238418579,0.10889412840938531,582,634,-52,2704
3979,gop candidate money arm syrian rebel,help arm syria rebel,2.400000095367432,0.3821756643646779,1896,2295,-399,159201
3980,observer patrol arrive syria massacre site,observer reach syria massacre village,4.400000095367432,0.5191339552186115,2790,5044,-2254,5080516
3981,american airline pilots agree new contract,money pledge stand israel ran threat,0.0,0.0,328,244,84,7056
3982,greek announce new election,greek call general election,2.799999952316284,0.5947169283965591,3371,2637,734,538756
3983,government canada supports montreal women leading change,government canada supports women safety begin,1.600000023841858,0.5911567585424646,3338,1492,1846,3407716
3984,problem mulayam form congress,problem mulayam form digvijay,3.200000047683716,0.7293358723080262,4360,3130,1230,1512900
3985,bradley triumph limestone jury fade,bahrain court uphold sentence uprise leader,0.0,0.0,329,248,81,6561
3986,lane crash kill,lane crash international medium report,2.200000047683716,0.6059445617483528,3449,1973,1476,2178576
3987,troop kill afghan bomb attack,nato troop kill afghanistan,1.7999999523162842,0.3838133310915618,1905,1669,236,55696
3988,syria force launch aleppo attack,syrian force kill ahead anna peace mission,1.600000023841858,0.12960895704027137,695,1509,-814,662596
3989,money drama fight edge dedicate,drama money compete undecided stoke base,1.0,0.24497206628806484,1147,1003,144,20736
3990,bbc director general design shod journalism,bbc director general designs amid newsnight scandal,3.5999999046325684,0.3835955177658025,1902,3782,-1880,3534400
3991,sick antrum win kansas caucus,sick antrum note victory kansas caucus,4.800000190734863,0.7850389516668594,4751,5470,-719,516961
3992,islamist lead egypt optic church name new pope,egyptian christians choose new pope,3.200000047683716,0.3236468168932492,1559,3167,-1608,2585664
3993,pledge rebuild haiti meet,pledge rebuild haiti met,5.0,0.8091212716431526,4920,5710,-790,624100
3994,chinese stock close high thursday,chinese stock open mixed wednesday,1.0,0.3596144125828214,1752,1001,751,564001
3995,greece vote budget protest gather,greece vote budget,3.5999999046325684,0.7870699791493254,4773,3781,992,984064
3996,cautiously welcome ran proposal start nuclear talks,welcome ran offer start nuclear talk,4.0,0.5313237796153193,2882,4440,-1558,2427364
3997,clinton warn sonya cost election violence,clinton warn sonya repeat vote chaos,2.799999952316284,0.5072891000437108,2708,2650,58,3364
3998,anti american protests film expand early country,anti american fury sweep middle film,3.799999952316284,0.40019911986297046,2006,4321,-2315,5359225
3999,journalist hail london olympics opening,israel delegation marche olympics open,1.0,0.20494186673334677,999,999,0,0
4000,stock open low,tokyo stock open low,1.5,0.7931001714705611,4817,1431,3386,11464996
4001,wikileaks begin publish million syria email,wikileaks release drive syria documents,3.400000095367432,0.344983709160901,1685,3451,-1766,3118756
4002,palestinians papa militant kill israel airstrike coastal strip,official papa man kill israel airstrike,3.0,0.5319340366807874,2885,3013,-128,16384
4003,ali president hands resignation,ali president normally design,4.599999904632568,0.3215319321853976,1546,5183,-3637,13227769
4004,kill siberia suicide comber attack,kill siberia cattle market attack,1.399999976158142,0.45237515203763906,2320,1380,940,883600
4005,factbox security development ran february,factbox security development pakistan march,1.600000023841858,0.662679650934153,3872,1506,2366,5597956
4006,hrw jordan base palestinians syria,jordan base palestinians syria,4.199999809265137,0.794593689377728,4829,4908,-79,6241
4007,israel arm export world report,israel arm export importer,3.799999952316284,0.6166636994355243,3541,4328,-787,619369
4008,egyptians vote new president,somali elect new president,0.800000011920929,0.2945046022059912,1398,756,642,412164
4009,severer sin th wimbledon title,severer capture th wimbledon title,5.0,0.8100041530352743,4929,5711,-782,611524
4010,say leader call kidnap westerners egypt,ll said leader urge kidnapping westerners,3.5999999046325684,0.4203717889567714,2126,3824,-1698,2883204
4011,china stock close mixed friday,chinese stock close high midday friday,2.5999999046325684,0.457991441371844,2357,2380,-23,529
4012,kill bus crash,kill crash india,1.600000023841858,0.5970113659609105,3388,1472,1916,3671056
4013,ruin swear russian president,ruin swear russia president year,4.0,0.739634271017851,4452,4436,16,256
4014,china trade return surplus march,sense calm return south el iv,0.0,0.14614120208640058,765,254,511,261121
4015,highlight vice presidential debate,thing watch presidential debate,2.200000047683716,0.472501864104268,2462,2130,332,110224
4016,episode nightline katie holmes tom bruise divorce,custody image stake bruise holmes divorce,1.399999976158142,0.47601582681915,2492,1416,1076,1157776
4017,syrian regime deny role massacre,syria blame rebel massacre,3.0,0.24378174941652794,1140,3040,-1900,3610000
4018,south sudan accuse sudan coming ahead talk,sudan accuse sudan come blow talk,4.400000095367432,0.728400146481165,4346,5029,-683,466489
4019,line kill gun attack pakistan,million citizen unofficial salary ukraine,0.0,0.0,403,257,146,21316
4020,syria demand guarantee rebel peace plan doom,syria demand write guarantee troop pullback,3.200000047683716,0.4407314567941062,2252,3150,-898,806404
4021,inn terminal rope evacuation,inn terminal opens bag causes evacuation,3.799999952316284,0.6160028075596631,3531,4262,-731,534361
4022,wolf westwood take lead cuba desert classic,westwood cuba desert classic,4.0,0.8440520615187795,5128,4435,693,480249
4023,sudan locks youtube anti slam film,pakistan order youtube halt anti slam film,2.799999952316284,0.6491447632676377,3776,2643,1133,1283689
4024,poll open russian presidential election,poll close senegal presidential election,1.399999976158142,0.5658973609558556,3149,1404,1745,3045025
4025,leave cuba radiotherapy,set radiotherapy cuba,4.400000095367432,0.7859692244028788,4759,5121,-362,131044
4026,romanian president declare victory,chinese president conclude state visit denmark,0.6000000238418579,0.10139667174430492,539,649,-110,12100
4027,russians rally support orthodox church hussy riot controversy,russian orthodox church ally faithful criticism,3.5999999046325684,0.3051301565228308,1454,3818,-2364,5588496
4028,clinton land india breathe life tie,clinton warn undermining grameen bank,1.399999976158142,0.17982221615912025,913,1424,-511,261121
4029,ali interim leader take office,ali interim president wear office,4.199999809265137,0.7479534290778171,4511,4892,-381,145161
4030,ruin declares victory russian presidential note,ruin win russia presidential election,3.799999952316284,0.34075120738380427,1660,4248,-2588,6697744
4031,renew condemnation syria violence,close embassy damascus syria violence,1.600000023841858,0.3224856698421881,1552,1495,57,3249
4032,flap sanction sad family,sanction sad wife mortar hit,3.400000095367432,0.4344612343025064,2214,3650,-1436,2062096
4033,air force instructor face sentencing gape,woman testify air force instructor sentencing,1.7999999523162842,0.7113199254187242,4231,1668,2563,6568969
4034,strike miner kill,strike miner kill south africa,3.799999952316284,0.7755406340155634,4692,4241,451,203401
4035,iron intercept ricket,iron intercept ricket fire beersheba,2.5999999046325684,0.8286099528327622,5039,2501,2538,6441444
4036,ali islamists destroy timbuktu shrine,ali islamists destroy holy timbuktu site,4.5,0.709737099596814,4218,5144,-926,857476
4037,china stock end high pmi midday,chinese stock open high thursday,1.7999999523162842,0.27059808236551924,1285,1666,-381,145161
4038,scientist resurrect flower prehistoric need,intend trim red ink lower forecast year,0.0,0.0,372,260,112,12544
4039,convict vatican lead case,butler try vatileaks case,2.5999999046325684,0.1616211678902753,823,2497,-1674,2802276
4040,money paul vie maine caucus win,money narrow maine caucus win,2.799999952316284,0.6796695168598726,3987,2617,1370,1876900
4041,sectarian clash rock lebanese city tripoli,sectarian clash rock lebanese city kill,3.799999952316284,0.8483584963957976,5154,4288,866,749956
4042,eusol blast argentina nationalization ypf,eusol blast argentina oil nationalization,3.400000095367432,0.8113180979588674,4936,3634,1302,1695204
4043,dead injure argentina train crash,fear dead buenos fires train crash,1.399999976158142,0.37174536362724786,1821,1405,416,173056
4044,hung address british,bursa hung address parliament june visit,4.0,0.5325719270948718,2895,4472,-1577,2486929
4045,sheriff recover steal car year later,man recover car year theft,4.0,0.46407081747777046,2397,4475,-2078,4318084
4046,google ceo say android important critical,carry age say android important critical,4.0,0.6906431284612861,4071,4476,-405,164025
4047,ran cut oil export state,ran ready ban oil export state,3.5999999046325684,0.6849362245653335,4024,3810,214,45796
4048,factory fire pakistan,head pakistan sunlight,0.800000011920929,0.27336142151321907,1299,781,518,268324
4049,australian plane miss indonesia,cranial painter mansoureh hosseini die,0.0,0.0,376,237,139,19321
4050,money vow restore promise america,money promises restore america,3.799999952316284,0.5910899260770298,3336,4274,-938,879844
4051,antrum year old daughter hospitalize,bony director hospitalize,0.6000000238418579,0.28248717240182364,1338,625,713,508369
4052,angela release hospital,israel president release hospital,1.2000000476837158,0.6200176007119196,3563,1176,2387,5697769
4053,trade set join bjp,trade likely join bjp high decide,3.799999952316284,0.6761183743740805,3958,4273,-315,99225
4054,hezbollah nasrallah warn anti slam film,hezbollah call anti slam film protest,2.799999952316284,0.7414136269495175,4467,2608,1859,3455881
4055,canal top djokovic th french open title,tennis canal defeat djokovic carlo title,3.200000047683716,0.5363772429799953,2930,3156,-226,51076
4056,childcare cost rise nearly,childcare cost year,3.0,0.7284216628580039,4347,2777,1570,2464900
4057,drama urge decisive action europe debt crisis,drama urge europe act quickly crisis,3.400000095367432,0.5232089047550165,2815,3651,-836,698896
4058,beef burgher mix recall salmonella concern,powder recall salmonella concern,1.0,0.5943215455878362,3366,1040,2326,5410276
4059,drama money prepare debate,drama money prepare debate,4.199999809265137,1.0000000000000002,5725,4799,926,857476
4060,significant gas find offshore sonya,aide kill late land clash sonya,0.800000011920929,0.20551439111781614,1005,778,227,51529
4061,red cross worker kill pakistan,kidnap aid worker kill pakistan,2.200000047683716,0.48871125351895245,2573,2086,487,237169
4062,ricket fire papa southern israel hurt,men ricket papa land southern israel hurt,3.400000095367432,0.8321303356368073,5062,3676,1386,1920996
4063,soldier kill shoot incident afghanistan,nato soldier kill afghanistan,1.600000023841858,0.5459434941129405,3000,1466,1534,2353156
4064,poll close egyptian presidential election,dress release cement presidential election,0.800000011920929,0.3471462668421622,1697,774,923,851929
4065,police link vile claim,bbc face question pull vile case,1.2000000476837158,0.2914816830618184,1377,1177,200,40000
4066,eurozone unemployment stay record percent,eurozone unemployment hit record high,3.400000095367432,0.7018465594733074,4148,3664,484,234256
4067,james murdoch quit bskyb,james murdoch quit role bskyb,4.199999809265137,0.8841310795050498,5342,4832,510,260100
4068,ironic science fiction writer bradbury die,science fiction legend bradbury dead,4.800000190734863,0.5872198665893147,3300,5457,-2157,4652649
4069,egypt presidential election,presidential election,0.6000000238418579,0.8391648340132694,5101,619,4482,20088324
4070,french soldier kill afghan suicide blast,foreign soldier kill afghan east,3.400000095367432,0.4597758566698892,2367,3655,-1288,1658944
4071,observer find trace syrian massacre,team investigate syrian massacre,4.0,0.38912579177479467,1933,4386,-2453,6017209
4072,poll majority prejudice black,toll majority harbor prejudice lacks,3.5999999046325684,0.5498319813523995,3034,3780,-746,556516
4073,source redskin trade pick,redskin trade pick,4.199999809265137,0.8575375805334171,5207,4859,348,121104
4074,china say defense budget rise,china defence spending rise,4.0,0.3044704512445734,1445,4373,-2928,8573184
4075,string ran blast kill,strong italy hills,0.0,0.0,383,204,179,32041
4076,ecuador president cornea say decision assange asylum,ecuador decide assange asylum,3.799999952316284,0.6617269550131597,3863,4311,-448,200704
4077,offer mild pakistan militant,offer million pakistani militant chief,3.799999952316284,0.4215955374750577,2133,4312,-2179,4748041
4078,nato troop kill afghanistan ied attack,nato troop kill afghanistan,3.799999952316284,0.7336881505111121,4410,4313,97,9409
4079,laden give fail,laden movie fill india,0.800000011920929,0.4903211116726959,2587,773,1814,3290596
4080,egyptians vote landmark presidential election,egyptians poll historic election,4.0,0.4269049462436084,2161,4394,-2233,4986289
4081,jetblue pilot disrupt flight declare insane guilty,jetblue pilot cause disruption flight guilty,3.799999952316284,0.5693696436881928,3177,4327,-1150,1322500
4082,tsunami warning need panic,tsunami warn eh quaker,2.200000047683716,0.27170356607490986,1293,2118,-825,680625
4083,hands wagram prison afghan authority,transfer wagram prison afghan control,4.800000190734863,0.600230971895725,3405,5448,-2043,4173849
4084,enemy aunt distance adviser overstep mark,enemy aunt cling pad quit news email,2.0,0.3214706476559748,1544,1847,-303,91809
4085,drama praise america trade tie,drama secret service agent send home,0.4000000059604645,0.11823514716957263,639,466,173,29929
4086,blitzbokke dust iii,blitzbokke beat,2.0,0.4760515281484874,2493,1849,644,414736
4087,drama money focus swing state,team anna decide consist state poll,0.4000000059604645,0.0922442583202305,496,471,25,625
4088,grenade attack kill injury,ex attack woman investigate,0.2000000029802322,0.14549900842012295,758,414,344,118336
4089,score body find syria,right body find ship,1.399999976158142,0.328605762363783,1585,1394,191,36481
4090,shorter charge murder black,thought race relation black president,0.800000011920929,0.10989823144454124,597,804,-207,42849
4091,bonny bairstow join organ shine england lumbar,bairstow hit ton india tour match,1.7999999523162842,0.20510030158750858,1001,1696,-695,483025
4092,wind farm developer use camera trick turbine look small,mind farm developer trick turbine look small,4.400000095367432,0.7840387580851559,4745,5076,-331,109561
4093,drone kill militant pakistan official,missile kill pakistan official,2.400000095367432,0.5668351060089125,3158,2230,928,861184
4094,siberia iberian troop swarm kill student massacre,siberia police arrest college massacre,2.5999999046325684,0.3604034936180348,1755,2490,-735,540225
4095,nerves calmed markets jump relief spanish bank bailout,focus shifts greece pain secure bank bailout,2.200000047683716,0.23625833334559115,1111,2115,-1004,1008016
4096,heavy fighting report syria aleppo,heavy fighting report damascus,1.399999976158142,0.6463016344028603,3759,1397,2362,5579044
4097,france say greece credibility eurozone,france holland back greece urge incredible reform,1.7999999523162842,0.3182454542473875,1530,1691,-161,25921
4098,avenger set box office record,hunger james break box office record,1.2000000476837158,0.48803332441529645,2568,1179,1389,1929321
4099,french soldier report kill afghanistan,british soldier kill afghanistan,1.0,0.6059503697464996,3450,1036,2414,5827396
4100,spanish ballot dilemma get acute,spanish dilemma get acute,3.400000095367432,0.8944273400970304,5391,3579,1812,3283344
4101,nato soldier die afghanistan,soldier wound afghanistan,0.6000000238418579,0.5301208536993569,2860,651,2209,4879681
4102,chinese stock open low wednesday,china stock open lower friday,2.400000095367432,0.3380702896727996,1645,2228,-583,339889
4103,palestinian leadership condemn israel bias,palestinian leadership back path james oh deal,1.0,0.38622399324785517,1917,1046,871,758641
4104,pitt money win maryland gop primary,money win maryland republican primary,4.800000190734863,0.6853298407979849,4025,5447,-1422,2022084
4105,find car year steal,texas man find car year steal,3.5999999046325684,0.8165730605678514,4966,3752,1214,1473796
4106,sylvester stallone son find dead hollywood,sylvester s son age stallone find dead vol,3.400000095367432,0.695685460626167,4103,3577,526,276676
4107,nato aid worker rescue afghan insurgent,aid worker free operation afghanistan,2.799999952316284,0.3487085327747126,1703,2591,-888,788544
4108,russia jail hussy riot protest bunk year,russian court rule hussy riot trial,1.7999999523162842,0.4012205946363386,2015,1635,380,144400
4109,israel bar german writer grass visit poem,israel bar german author grass poem,4.400000095367432,0.7302402653340809,4370,5089,-719,516961
4110,note heads august,note heads wednesday july,1.7999999523162842,0.6363374652833541,3685,1630,2055,4223025
4111,nato troop detain shooting afghan civilian,say sadden shoot afghan civilian,2.400000095367432,0.35090190374373786,1716,2243,-527,277729
4112,holland win french presidential election,simon vote presidential election,1.600000023841858,0.36256500537163416,1766,1460,306,93636
4113,military syria chemical stock threaten israel,russia tell syria chemical arm threat unacceptable,1.7999999523162842,0.2553365386311286,1200,1661,-461,212521
4114,pitch upgrade word investment grade,pitch restore word credit investment grade,3.5999999046325684,0.7014836816173083,4144,3753,391,152881
4115,syria peace plan condition unacceptable opposition say,syria peace dash deadline pass,2.0,0.23110037430197872,1095,1845,-750,562500
4116,lash greeks protest cutback,lash erupt greek vote year,2.400000095367432,0.26927288607525757,1275,2262,-987,974169
4117,dead hurt miss wo not land avalanche,dead miss wo not land avalanche,2.400000095367432,0.9228015781503799,5491,2260,3231,10439361
4118,taliban pose attractive woman facebook spy,taliban soldier lose pretty woman facebook troop secret,4.599999904632568,0.3593503031356504,1749,5180,-3431,11771761
4119,china activist land,chinese activist renew fight injustice,1.2000000476837158,0.2758445051028881,1311,1181,130,16900
4120,city room empire state building shooting,dead shoot outside empire state building,3.200000047683716,0.5305403987650231,2866,3212,-346,119716
4121,ashamed dorsi swear egyptian president,bursa swear egyptian president,4.400000095367432,0.5781773178910126,3233,5095,-1862,3467044
4122,attack dato base afghanistan kill,worker free afghanistan raid,1.0,0.19560809473671234,968,1050,-82,6724
4123,semen suicide prone attack,pate ran attack kill,1.0,0.1493400034906786,780,1053,-273,74529
4124,horse move olympic bid fail,horse finish th miss sixth olympics,3.0,0.12248538875041126,665,2888,-2223,4941729
4125,pakistan begin desolation bin laden compound,pakistan demolish bin laden hideous,2.799999952316284,0.48321003740023405,2530,2594,-64,4096
4126,sudan blame israel khartoum arm fire,sudan accuse israel airstrike arm factory,3.5999999046325684,0.4440515160577921,2276,3768,-1492,2226064
4127,house senate deal reach patrol tax measure,negotiator reach deal congress patrol tax cut bill,3.799999952316284,0.5720752109386864,3196,4299,-1103,1216609
4128,tropical storm isaac drench haiti side cuba,tropical storm isaac threaten dam,1.399999976158142,0.5045923957333359,2691,1402,1289,1661521
4129,foreign pro palestinian activist seek enter west bank,pro palestinians seek enter israel allenby,2.200000047683716,0.44178038692543875,2260,2119,141,19881
4130,world stock rise hope stimulus,stock rise hope red stimulus,3.0,0.8487633179280344,5156,2881,2275,5175625
4131,widal dead legendary author playwright politician die,widal celebrate author playwright die,4.0,0.703794458183676,4170,4647,-477,227529
4132,world stock fall greek debt deal deadline,asia stock fall ahead greek debt deal deadline,2.400000095367432,0.7970386784985791,4844,2256,2588,6697744
4133,south africa police shoot dead miner,south africa police kill miner,4.199999809265137,0.8032826397991,4884,4848,36,1296
4134,isaac drench haiti head cuba florida,isaac year haiti homeless quaker population,2.400000095367432,0.39803334985425043,1989,2253,-264,69696
4135,britain reach syria opposition,care syrian people,1.2000000476837158,0.0,381,1183,-802,643204
4136,drama relax importation rule young immigrant,relax importation rule young people napolitano,4.0,0.6763013300500211,3960,4636,-676,456976
4137,microsoft surface big bet future analysis,microsoft surface tablet promising question remain,3.799999952316284,0.35763099459822734,1743,4296,-2553,6517809
4138,white ulcer girlfriend get year,lobster white ulcer girlfriend get year,3.5999999046325684,0.8236547659625492,5005,3763,1242,1542564
4139,mauritanian president shoot army unit,mauritanian president shoot,3.799999952316284,0.7644102231803764,4629,4293,336,112896
4140,set fire breivik trial,set self fire outside breivik trial,4.599999904632568,0.7765398033413817,4700,5178,-478,228484
4141,drone strike kill northwest pakistan,drone pakistan kill suspect militant,3.799999952316284,0.5297848095977984,2857,4289,-1432,2050624
4142,marines leave okinawa,marines okinawa statement,5.0,0.800506772656491,4868,5715,-847,717409
4143,boy r wife fee faraway program,pal lower fee holiday faraway program,1.7999999523162842,0.608278368942706,3473,1652,1821,3316041
4144,ran expand nuclear enrichment activity iaea report,ran step sensitive nuclear work iaea,3.0,0.38277930418482975,1898,2922,-1024,1048576
4145,donna summer queen disco die,donna summer queen disco,3.0,0.9430382178336376,5539,2920,2619,6859161
4146,iraqi attacks general police,attack ran kill general,4.0,0.29440566513223065,1396,4675,-3279,10751841
4147,dead northwest ran quaker,dead injure northwest ran earthquake,2.5999999046325684,0.6307730820521056,3639,2489,1150,1322500
4148,brazil pop star priest get mammoth new stage,brazil star priest get mammoth new stage,5.0,0.8921184430982321,5382,5716,-334,111556
4149,washington charge dedicate fraud weep,washington court upholds noting rights act alabama case,0.6000000238418579,0.1176362878713394,635,646,-11,121
4150,ruin claim victory russia presidential election,ruin claim victory presidential vote,4.199999809265137,0.7889494308363743,4792,4866,-74,5476
4151,clinton ready fight drama,clinton tough act drama follow,1.0,0.38566110367981565,1911,1041,870,756900
4152,money announce paul run mate,money choose gop running mate,4.400000095367432,0.40424917644257796,2034,5021,-2987,8922169
4153,european market rise greek ballot hope,european ministers noise approve greek rescue,2.200000047683716,0.29901792066088706,1422,2135,-713,508369
4154,edwards acquit count mistrial,edwards find guilty count mistrial,4.599999904632568,0.7844263546408838,4747,5177,-430,184900
4155,ukrainian weightlifter get year ban,ukraine korobka get year ban,4.199999809265137,0.34067651431389745,1659,4861,-3202,10252804
4156,human fill school massacre,miller fill france school shooting,3.0,0.24871944134211096,1163,2910,-1747,3052009
4157,long long stock close,long long stock open high,1.600000023841858,0.787909649937337,4780,1593,3187,10156969
4158,suicide bomber attack algerian security base,suicide bomber target iberian church,0.800000011920929,0.3460752722039586,1690,842,848,719104
4159,thailand iranians plan attack israelis,malaysia extradite cranial attack israelis,1.0,0.31596705065787767,1515,1009,506,256036
4160,israel military court reject appeal palestinian hunger striker,israel reach deal palestinian hunger striker,1.2000000476837158,0.6246630811596965,3589,1184,2405,5784025
4161,avenger set box office record,hunger james set box office record,1.600000023841858,0.6349270223064007,3672,1572,2100,4410000
4162,ruin sins russian presidential election,ruin win russia presidential election,4.199999809265137,0.563029608113158,3126,4856,-1730,2992900
4163,ruin cast ballot russians vote,ruin win russia presidential election,1.399999976158142,0.19208947177532273,955,1418,-463,214369
4164,chief kinds voice remain cautious china,insight chief find voice remain cautious china,4.800000190734863,0.7411042731789501,4465,5426,-961,923521
4165,libyans begin hand weapon,libyans transfer weapon army,3.200000047683716,0.5696566993459751,3178,3126,52,2704
4166,british archbishop canterbury change career cambridge,archbishop canterbury step amid rift,2.400000095367432,0.42629878048925807,2159,2250,-91,8281
4167,punjab nail detail near rohtak injure,punjab nail detail near rohtak haryana injure,4.199999809265137,0.8742262229588856,5299,4810,489,239121
4168,george zimmerman charge kill trayvon martin,george zimmerman charge trayvon martin case official say,4.0,0.8465407271187458,5143,4559,584,341056
4169,indian moist rebel offer talk free italian hostage,india moist rebel talk free italians,3.799999952316284,0.5532884576975913,3059,4286,-1227,1505529
4170,report dead shoot empire state building,city room empire state building shooting,2.799999952316284,0.5443804588087915,2986,2601,385,148225
4171,dead pakistan suicide blast,dead pakistan factory blaze,1.0,0.3639793058262094,1772,996,776,602176
4172,penn state football player react sanction,penn state football slam ncaa sanction,2.400000095367432,0.5850564626795288,3285,2248,1037,1075369
4173,israel release try palestinian prolong hunger strike,israel minister want palestinian leader outer,0.5,0.22115164402310394,1049,596,453,205209
4174,report say side syria abuse right,nato leader play risk turkey syria clash,1.0,0.1154560870140263,623,997,-374,139876
4175,girl accuse burn moran go hiding,girl accuse burn moran fail,3.200000047683716,0.734848223398864,4417,3090,1327,1760929
4176,france warn syria chemical weapon use,concern possible syria chemical weapon,2.200000047683716,0.4418909069115087,2264,2011,253,64009
4177,life threaten widest storm fear,life threaten storms feared widest,4.400000095367432,0.5601610706569566,3097,5002,-1905,3629025
4178,chicago teacher strike year end framework agreement place,general strike end histadrut treasury reach agreement,0.800000011920929,0.2947834937312344,1399,846,553,305809
4179,indonesian president visit,indonesian president visit australia,1.399999976158142,0.8587927991313735,5218,1395,3823,14615329
4180,storm delay start republican convention,storm lash florida delay republican convention,4.400000095367432,0.7412322554872744,4466,5003,-537,288369
4181,dato kill afghanistan helicopter crash military,kill afghan bomb attack official,0.800000011920929,0.08955426573813487,482,861,-379,143641
4182,president hills quit lecturer,president john evans tea hills design germany,2.5999999046325684,0.27140357642911983,1291,2492,-1201,1442401
4183,diam seat win nba final,diam seat clinch nba championship,5.0,0.6327170483983404,3656,5717,-2061,4247721
4184,japan close nuclear reactor,japan switch nuclear power plant weekend,4.199999809265137,0.30790504110782746,1470,4827,-3357,11269449
4185,ryanair new bid sinus,ryanair chief nail report finding,1.2000000476837158,0.31742114130348,1525,1186,339,114921
4186,russian air force celebrate anniversary,russian air force anniversary,4.400000095367432,0.8534179545881753,5183,5011,172,29584
4187,nato troop kill afghanistan,nato soldier kill afghanistan,2.200000047683716,0.7223165759144144,4308,1993,2315,5359225
4188,super tuesday pitt money,money lead antrum gop super tuesday contest,1.600000023841858,0.49049447693162196,2588,1512,1076,1157776
4189,ruin swear russian growth filter,ruin swear russia president year,2.400000095367432,0.4504428575282157,2307,2247,60,3600
4190,rule daiichi stop lung cancer trial share tank,rule stock plunge lung cancer study shell,3.400000095367432,0.4150627570385108,2100,3462,-1362,1855044
4191,teenager father kill crash,kill horror crash name,1.600000023841858,0.33701395963201775,1637,1559,78,6084
4192,magnitude quaker strike indonesia,magnitude quaker hit papa indonesia usgs,4.199999809265137,0.6370202095160689,3692,4820,-1128,1272384
4193,americans kill afghan unrest enters fifth,american officers murdered afghan unrest continue,4.199999809265137,0.2937855891077933,1388,4819,-3431,11771761
4194,official money secret service protection,drama address secret service scandal,0.6000000238418579,0.42861615440943973,2172,637,1535,2356225
4195,japan call quick tsunami waste processing,japan mark year quaker tsunami disaster,1.0,0.35266859738304784,1724,1089,635,403225
4196,syrian fighter pilot defect jordan,syrian defect jordan,1.399999976158142,0.7356383660946046,4421,1407,3014,9084196
4197,syrian arab republic syrian arab republic syrian refugees june,syrian arab republic kill syria ahead anna return,1.2000000476837158,0.5942665450460364,3365,1187,2178,4743684
4198,suicide bomber kill afghanistan,suicide bomber kill siberia church,1.2000000476837158,0.6188979517605866,3554,1188,2366,5597956
4199,airline cancel flytilla activist ticket,airline cancers flytilla rickets israel objection,3.200000047683716,0.35964968926832697,1753,3115,-1362,1855044
4200,pain ask bank rescue,spaniard trial cuban dissent death,0.2000000029802322,0.0,374,404,-30,900
4201,murky water south china tea,peace lie south china tea,1.399999976158142,0.5373030495390662,2935,1377,1558,2427364
4202,ri vanka seek day revival pakistan,senior journalist kill pakistan,0.6000000238418579,0.13121243151071127,703,639,64,4096
4203,space dock international space station public travel,space dragon locks international space station,3.799999952316284,0.6297803939195459,3626,4298,-672,451584
4204,million puppet march defend drama backing pbs,million puppet march plan defend backing pbs,4.0,0.9282068296872938,5506,4617,889,790321
4205,syrian opposition reconciliation talk,syrian opposition council establish envoy france,1.399999976158142,0.31979909569827614,1537,1393,144,20736
4206,sense point budget blue,money will volunteer budget difference,1.0,0.26343172143565047,1249,1062,187,34969
4207,facebook boot size ipo raise,facebook boot size ipo percent,3.5999999046325684,0.887128130622143,5352,3792,1560,2433600
4208,ran parliament questions dismissive ahmadinejad,ran parliament question president ahmadinejad,4.0,0.5483664015374646,3014,4621,-1607,2582449
4209,semen suicide attack kill soldier official,afghan suicide car bomb kill seven official,1.600000023841858,0.39294422084602054,1954,1584,370,136900
4210,presidential vote polarise egyptians,gop presidential hopeful clash southern race,0.800000011920929,0.14661475417450767,766,843,-77,5929
4211,soldier kill afghanistan,nato soldier kill afghanistan,1.7999999523162842,0.8116105446049781,4937,1729,3208,10291264
4212,police raise death toll bus accident,money king death rule accidental,0.4000000059604645,0.12774357848388906,689,509,180,32400
4213,foreign soldier kill afghan east,british soldier kill afghan insider attack,0.800000011920929,0.4506821432812882,2308,873,1435,2059225
4214,red cross worker kill pakistan,british red cross doctor kidnap pakistan find behead,3.5999999046325684,0.43827249990797945,2234,3799,-1565,2449225
4215,afghan goat sign deal controversial night raid,afghan sign deal night maid,3.799999952316284,0.5590943343418405,3093,4307,-1214,1473796
4216,china accident kill,china truck accident kill,1.600000023841858,0.7957448131144251,4833,1582,3251,10569001
4217,australia ellipse england indies,australian defiant pressure leadership,0.4000000059604645,0.0,371,512,-141,19881
4218,protest hussy riot verdict,hussy riot verdict greet defiance,3.400000095367432,0.6837740860415042,4016,3491,525,275625
4219,secret service see big scandal prostitute,secret service sex scandal regret,2.200000047683716,0.5480834539069294,3013,2015,998,996004
4220,wait activist storm syrian embassy injure,activist storm syria embassy wait,3.400000095367432,0.8151597109245603,4953,3523,1430,2044900
4221,detail hung visit ireland,rapturous welcome hung historic trip,3.400000095367432,0.2543523530815629,1197,3522,-2325,5405625
4222,key say marie visit lost opportunity,key want waitangi marie visit stay,2.200000047683716,0.4836767630827341,2532,2017,515,265225
4223,norway mark anniversary massacre,norway marks anniversary breivik massacre,3.799999952316284,0.6562558370692183,3828,4305,-477,227529
4224,woman kill fall debris,ally decline,0.0,0.0,393,222,171,29241
4225,share interest rate cut,rba deliver rate cut,1.0,0.4863977409699737,2547,1084,1463,2140369
4226,germany warn greece money reform,zone greece rescue reform,2.5999999046325684,0.48417657568307904,2536,2478,58,3364
4227,drama meet family shoot victim,drama meet batman gun victim,3.200000047683716,0.5167339027216267,2770,3092,-322,103684
4228,drama widen lead money despite job datum letters psoas poll,money take lead drama convention bounce letters psoas poll,1.0,0.6002839828378361,3406,923,2483,6165289
4229,kill injure toronto shooting,dead injure inland shooting,1.399999976158142,0.45379559180553686,2329,1425,904,817216
4230,hope butler see aide arrest vatican lead,hope butler arrest scandal vatican lead,3.400000095367432,0.8125849655961279,4940,3436,1504,2262016
4231,anti ruin protest form human chain moscow,anti ruin protest form human chain,3.799999952316284,0.9156363319542807,5466,4325,1141,1301881
4232,washington acts congress cell,george washington copy constitution cell,2.5999999046325684,0.37547773166138515,1850,2456,-606,367236
4233,maker fire coach like grown start,maker fire like grown start,4.400000095367432,0.8909452099957427,5374,4972,402,161604
4234,canadian muslims issue fate honor kill,canadian mass issue fate honour killing,3.400000095367432,0.5026892891994181,2675,3442,-767,588289
4235,syria resolution,assembly note syria resolution,3.5999999046325684,0.6431816746015215,3734,3805,-71,5041
4236,soldier recall massacre,soldier recall massacre,4.400000095367432,1.0,5696,4971,725,525625
4237,tibia name new cabinet protest original,libyan assembly reject new cabinet dismiss,1.2000000476837158,0.2861487318866357,1356,1189,167,27889
4238,foreign soldier kill afghan east,french soldier report kill afghanistan,3.799999952316284,0.3063080871378618,1463,4252,-2789,7778521
4239,syrian force storm central town,syrian force bombard russia warn civil war,2.5,0.24366837888057147,1139,2336,-1197,1432809
4240,oak dead anti slam film protest,injure anti slam film protest islamabad pakistan,2.200000047683716,0.6081842033177794,3471,2060,1411,1990921
4241,cause whitney houston death week,investigator seek answer whitney houston death,1.7999999523162842,0.5793803576368796,3245,1736,1509,2277081
4242,n warn retaliation south drill,north warn retaliation soul naval drill plan,3.5999999046325684,0.6330293687489572,3657,3828,-171,29241
4243,pale masses new work giants super bowl,lesser evil triumph super bowl,1.399999976158142,0.27296558575142976,1298,1408,-110,12100
4244,dead new israel strike papa,kill new israel strike papa medius,3.5999999046325684,0.6641597738684247,3886,3829,57,3249
4245,germany likely dress russia syrian crisis,russia think syria brief guide,1.0,0.10934655421976133,590,909,-319,101761
4246,seriously injure motorway crash,injure motorway crash,3.5999999046325684,0.8265049445740358,5021,3816,1205,1452025
4247,aid chief amos enter papa mr red crescent,syria besiege papa mr desert red cross say,2.0,0.3665009014796813,1792,1804,-12,144
4248,dozen kill iberian riot,dozen kill demyan clash,1.0,0.3809612671745421,1888,913,975,950625
4249,profile egypt main presidential candidate,second day egyptian presidential election,1.2000000476837158,0.16562345747354026,845,1190,-345,119025
4250,actor gazzara dead,actor men gazzara die,4.400000095367432,0.7417169085527651,4470,4978,-508,258064
4251,british gold rush silence grape cost,british soldier kill afghan insider attack,0.6000000238418579,0.1461401271010876,764,652,112,12544
4252,avalanche bury pakistani soldier,avalanche bury pakistani soldier,4.599999904632568,1.0,5656,5175,481,231361
4253,inflation fall month low analysis,inflation fall month low,4.599999904632568,0.8873492510381227,5353,5174,179,32041
4254,woman will cut planned parenthood funding,susan g women u turn planned parenthood funding cut,3.0,0.7223459392513739,4309,2849,1460,2131600
4255,amp old august,old july,2.200000047683716,0.2961575151073539,1406,2029,-623,388129
4256,ran say nuclear talk continue,ran say nuclear talk constructive,2.799999952316284,0.5902432974893422,3325,2604,721,519841
4257,agribusiness cow disease find california,usda confirm case disease california,4.199999809265137,0.4341852616246013,2211,4875,-2664,7096896
4258,cell gulf mexico asset bill,cell gulf mexico asset plains,3.5999999046325684,0.8516170117464218,5167,3759,1408,1982464
4259,potential jimmy vile victim police,potential vile abuse victim emerge,3.5999999046325684,0.5904233166325774,3328,3756,-428,183184
4260,armstrong step livestrong,armstrong stand livestrong,4.599999904632568,0.7918529270473365,4813,5173,-360,129600
4261,drone strike kill militant pakistan,drone strike kill suspect militant semen,1.7999999523162842,0.6939566356101545,4092,1717,2375,5640625
4262,syrian get will not stop attack,syrian opposition report massacre,1.0,0.2558151449873658,1201,918,283,80089
4263,chinese stock close high midday friday,chinese stock high midday friday,4.599999904632568,0.9359120350915093,5522,5172,350,122500
4264,myanmar opposition claim win,voter myanmar hopeful party claim win,3.200000047683716,0.554272722605211,3068,3298,-230,52900
4265,drama poll rating drop boost republican rival,drama big hispanic win worry republicans,1.0,0.08918811875705182,480,928,-448,200704
4266,soldier wound afghanistan,foreign soldier kill afghan east,1.2000000476837158,0.23945521479502363,1122,1191,-69,4761
4267,new syria opposition chief want string aid,syria opposition unite israel fire warn shot,1.0,0.22764147736835605,1075,892,183,33489
4268,south africa clash kill,south africa train crash kill,0.800000011920929,0.6461094994303118,3758,852,2906,8444836
4269,syrian force bombard russia warn civil war,syrian force bombard uvarov arrive talk,2.5999999046325684,0.46581499553092554,2412,2408,4,16
4270,egypt presidential election result delay,egyptian election result delay,4.199999809265137,0.7009131949791201,4139,4879,-740,547600
4271,headline pass new ran sanction,moves close new ran actions,1.600000023841858,0.21968146574168207,1047,1532,-485,235225
4272,arrest russian killer deny tie hussy riot,dozen arrest russian tower protest,0.800000011920929,0.2310039731388863,1094,855,239,57121
4273,norway memorial honour massacre victim,norway mark anniversary massacre,2.799999952316284,0.4765609995464596,2497,2602,-105,11025
4274,afghanistan general link petraeus scandal,senior general link petraeus scandal,3.799999952316284,0.8393532187336296,5102,4107,995,990025
4275,chinese stock fall rrr cut,chinese stock gain midday monday,2.0,0.3016067548170836,1434,1787,-353,124609
4276,chorea make significant nuclear reactor progress iaea,vow expand nuclear deter,2.799999952316284,0.09107879488443388,488,2619,-2131,4541161
4277,maldive president quit police mutiny protest,maldive president quit week protest,3.400000095367432,0.7175167838376867,4276,3652,624,389376
4278,nato strike kill civilian afghanistan,nato soldier kill afghanistan,0.800000011920929,0.6352308664511677,3674,856,2818,7941124
4279,ll said say capture cement soldier bryan battle,ll qaeda clash blast kill soldier semen,1.399999976158142,0.2456393593102183,1150,1399,-249,62001
4280,navy jet clash apartment pilot erect,navy met rashes virginia apartment building,3.400000095367432,0.3470644185039257,1696,3473,-1777,3157729
4281,china stock open high wednesday,stock open higher despite gdp miss,0.800000011920929,0.2724917490386165,1295,857,438,191844
4282,idf deploy iron central israel,major snowstorm barrel central plains,0.0,0.14553616953585533,759,228,531,281961
4283,kill prone strike pakistan,prone strike hills pakistan,3.0,0.7906332843238632,4802,2828,1974,3896676
4284,hold chicago car bomb plot,chicago arrest chicago car bomb plot,3.400000095367432,0.8464444882425279,5142,3525,1617,2614689
4285,david rathband twin brother fear beset mate,david miliband brother return old labour,0.2000000029802322,0.27974930851058366,1327,432,895,801025
4286,syrian force retaken aleppo,syrian regime lids city aleppo,4.400000095367432,0.4147159346382282,2098,4998,-2900,8410000
4287,member parliamentary trade team leave india,commerce secretary leave absence,0.0,0.1403847694241549,738,230,508,258064
4288,street opens power,street end fix,2.0,0.24717656173610802,1155,1776,-621,385641
4289,europe share bounce china stimulus see,oil price rise hope stimulus,0.800000011920929,0.2813550010338341,1335,864,471,221841
4290,stock index future point lower start,stock index future signal early loss,4.400000095367432,0.4501314495480966,2305,4966,-2661,7080921
4291,charge hurt attack,charge murder flat,1.399999976158142,0.2650013042007374,1259,1398,-139,19321
4292,foka apology face ad,wife rider oak aid,0.0,0.0,400,231,169,28561
4293,drone strike kill militant pakistan,prone strike kill suspect militant pakistan,3.0,0.6155058997684204,3530,2837,693,480249
4294,syria rebel leave besiege,syrian rebel retreat besiege district,4.400000095367432,0.5243335259917319,2821,5004,-2183,4765489
4295,order non essential staff leave sudan tunisia,order non essential staff leave tunisia sudan,4.0,1.0000000000000002,5723,4619,1104,1218816
4296,egypt mubarak critical,egypt mubarak critical condition,4.599999904632568,0.8690565544731742,5262,5197,65,4225
4297,sad say mercenary syria unrest,sad accuses duel syrian uprising,3.3333332538604736,0.19727810193502093,975,3421,-2446,5982916
4298,japan dissolve low house election,ran world power set nuclear talk,0.0,0.0,399,232,167,27889
4299,kill new israel strike papa medius,die strike papa militant carriage israel,2.0,0.412284619084962,2084,1794,290,84100
4300,navy jet clash virginia building injure,navy jet clash virginia hurt,3.200000047683716,0.7622685232632311,4615,3256,1359,1846881
4301,nato soldier kill afghanistan,british soldier kill southern afghanistan,3.200000047683716,0.5620857997485226,3117,3253,-136,18496
4302,pain bless rate hit new high,pain bless claim hit new high,4.199999809265137,0.8376169133817077,5091,4882,209,43681
4303,turkey scramble jet near border,turkey scramble jet syrian border,3.5999999046325684,0.8636123290931212,5239,3746,1493,2229049
4304,die syria violence monitor land,year ban contador,0.0,0.0,367,233,134,17956
4305,civilian detector kill syria say ngo,syria luman kill syrian officer ngo,1.0,0.4733234511422487,2470,945,1525,2325625
4306,taiwan rattle strong earthquake,china rock twin earthquake,1.2000000476837158,0.22692199503165753,1072,1194,-122,14884
4307,bank england paul pucker paint labor mess,bank england deputy deny order rate rigging,2.799999952316284,0.2313461664465038,1096,2606,-1510,2280100
4308,red cross say negotiate halt fighting syria aid,red cross negotiate syria ceasefire bring aid,4.400000095367432,0.6205656451325565,3567,4970,-1403,1968409
4309,syrian force shoot civilian bus,syrian force rebel clash near turkey,0.800000011920929,0.3091960171241189,1477,839,638,407044
4310,german parliament overwhelmingly back greek rescue deal,german parliament endorse greek ballot,4.400000095367432,0.4739074927804934,2475,4968,-2493,6215049
4311,coming clash continue syria,coming clash syria opposition seek arm,3.400000095367432,0.583591517664553,3276,3563,-287,82369
4312,bursa reform bring easing sanction,bursa activist slow ease sanction,2.400000095367432,0.37186537400360753,1823,2211,-388,150544
4313,say bolt win m reaction,facebook mobile gain drive revenue growth reaction,0.2000000029802322,0.25908121200183676,1220,409,811,657721
4314,dozen dead taliban resort attack,india police iranians embassy attack,0.4000000059604645,0.1123178312495037,611,487,124,15376
4315,heavy fighting rock eastern syria ahead poll,heavy fighting rock eastern syria resident,3.799999952316284,0.7416921244794734,4468,4104,364,132496
4316,china juan weaken usd monday,china juan retreat usd thursday,2.799999952316284,0.5734387645840333,3204,2609,595,354025
4317,dead christian school shooting,wound ohio school shooting,1.399999976158142,0.46128981186682017,2379,1390,989,978121
4318,indonesia anti terror squad kill suspect militant,indonesia police shoot dead suspect militant ali,3.200000047683716,0.4145755547659945,2097,3231,-1134,1285956
4319,election pitt money concede defeat track drama win second term,money concede election drama phone,4.0,0.54551823471912,2996,4605,-1609,2588881
4320,armenians vote parliamentary election,armenia parliamentary vote test president,3.200000047683716,0.42061969630276863,2128,3241,-1113,1238769
4321,machine tendulkar swear indian senator,machine tendulkar say got bungalow,1.600000023841858,0.4334674315861684,2206,1551,655,429025
4322,navy met rashes apartment building,navy met rashes virginia apartment building,3.5999999046325684,0.914676783074025,5464,3771,1693,2866249
4323,money win big huerta rico primary,money win illinois primary,1.5,0.5009886104603535,2663,1443,1220,1488400
4324,yahoo google layer ceo report,yahoo name google layer ceo,4.199999809265137,0.9482337990411379,5549,4815,734,538756
4325,soldier accuse afghan massacre fire prominent criminal lawyer,soldier accuse kill afghan civilian identify,2.0,0.3940896879295196,1960,1790,170,28900
4326,magnitude quaker hit northern italy usgs,magnitude quaker hit funds trait indonesia usgs,1.600000023841858,0.5486086373895223,3016,1549,1467,2152089
4327,officially designate haqqani network terrorist,designate haqqani network terrorist,4.400000095367432,0.8710252933510068,5277,4974,303,91809
4328,motor facing button fat year practice,button boat good time practice,3.0,0.45272242560061715,2323,2916,-593,351649
4329,danger vote division,danger vote division,4.800000190734863,1.0000000000000002,5710,5427,283,80089
4330,newark mayor save neighbor fire,newark mayor rescue neighbor burn house,4.199999809265137,0.6715448753269735,3929,4821,-892,795664
4331,protest bahrain,day rage bahrain,2.25,0.47654099606377204,2496,2160,336,112896
4332,new work stock exchange open wednesday,dealbook stock exchange prepare open,3.0,0.4649748327380149,2404,2899,-495,245025
4333,mortar fire kill,offensive kill,2.5999999046325684,0.1969792169475819,973,2445,-1472,2166784
4334,hundred honor student kill ohio shooting,funeral set ohio shoot victim,2.0,0.23757720019057477,1114,1872,-758,574564
4335,bomb southern thailand kill wind,bomb thailand kill wind,3.0,0.8782949051725655,5317,2875,2442,5963364
4336,lawmaker step new ran sanction,somalia lawmaker vote new president,0.2000000029802322,0.39932850743399184,1995,418,1577,2486929
4337,track drama admit nuclear weapon need,french german want die weapon hand,0.4000000059604645,0.13767743791396794,730,491,239,57121
4338,ricket hit eshkol region injury,ricket minute eshkol regional council,1.7999999523162842,0.4409491533308926,2254,1752,502,252004
4339,betrayed disabled worker protest employ closure,mark protest austerity cut,0.6000000238418579,0.10332553803258764,545,623,-78,6084
4340,long rebel kill park ranger,rebel kill park ranger eastern long,4.0,0.899921732200146,5411,4538,873,762129
4341,line pakistani troop kill militant ambush,trade pakistan india agree step ahead,0.800000011920929,0.0,332,883,-551,303601
4342,dead egypt soccer violence,die egyptian soccer pitch invasion,3.200000047683716,0.23848239847816857,1118,3293,-2175,4730625
4343,unrest tense siberia leave dead,southwest china quaker kill,0.2000000029802322,0.0,330,422,-92,8464
4344,hurricane bandy make windfall southwestern jamaica nhc,hurricane bandy reach jamaica,3.0,0.60040805771882,3408,2818,590,348100
4345,remark crime minister elkeib meeting,remark foreign minister koichiro emma,1.5,0.3384250306635319,1647,1440,207,42849
4346,patrick talk china firm african asset,drama aide hold talk china syria veto,1.2000000476837158,0.1781724198856699,906,1195,-289,83521
4347,attacker strategy,sonya attacker strategy,3.0,0.8522398288714794,5172,2886,2286,5225796
4348,weak earning drag stock low,weak earning drag stock lower street,3.799999952316284,0.7656936057988685,4637,4079,558,311364
4349,quaker strike solomon islands,magnitude quaker strike solomon islands usgs,3.200000047683716,0.8092139069497204,4921,3323,1598,2553604
4350,liquid ammonia leak kill shanghai,liquid ammonia leak kill shanghai,4.599999904632568,1.0,5650,5198,452,204304
4351,friend syria recognize opposition coalition legitimate representative syrian people,friends syria recognise opposition sole representative,4.0,0.3090127036052147,1476,4532,-3056,9339136
4352,rein stay nyc mayor race amid new setting scandal,rein shrug late online sex scandal,3.0,0.2943074463670065,1395,2891,-1496,2238016
4353,death toll rise russia plane crash,death toll rise italy coach crash,0.0,0.6058002929072125,3448,135,3313,10975969
4354,indian medium commonwealth summit,indian snub commonwealth summit,2.799999952316284,0.7160831996737563,4267,2598,1669,2785561
4355,syria military police chief defect opposition,syria military police chief defect rebel,5.0,0.8297755217558199,5046,5722,-676,456976
4356,dreamliner catch fire stock take beating,stock tumbler fire dreamliner,4.599999904632568,0.5008070305869641,2661,5221,-2560,6553600
4357,cette cooper back gay marriage bill,white house back gay marriage,2.5999999046325684,0.508886660215876,2718,2472,246,60516
4358,kill belgian coach crash,teenager dead belgian bus crash,3.799999952316284,0.5119537494839335,2744,4082,-1338,1790244
4359,luman abduct seven foreign worker siberia,foreign worker kidnap siberia,3.400000095367432,0.5309404499699557,2873,3557,-684,467856
4360,swiss tourist gang rapid india,swiss tourist gang rapid india police,5.0,0.9566491769526978,5565,5723,-158,24964
4361,palestinians clash israel force west bank jerusalem,palestinians clash security force bank,4.199999809265137,0.6566258058558754,3832,4811,-979,958441
4362,israel plane strike inside syria,israel launch airstrike syria,4.599999904632568,0.31198666727535085,1491,5220,-3729,13905441
4363,iranians note presidential election,deity sins ali presidential election,0.4000000059604645,0.3020004901294729,1435,567,868,753424
4364,kill new darfur trial clash,head new darfur trial clash,2.799999952316284,0.8729040271662336,5288,2595,2693,7252249
4365,protest drone strike oak postpone,kill drone strike pakistan,1.399999976158142,0.4376139595156505,2231,1419,812,659344
4366,kill bus accident pakistan,kill road accident pakistan,3.200000047683716,0.7073078598532643,4193,3228,965,931225
4367,warn set high bar change,warn set high bar change bank england,5.0,0.829451330948644,5044,5657,-613,375769
4368,arrest deadly bangladesh building collapse,arrest bangladesh building toll rise,2.400000095367432,0.582469767196241,3266,2190,1076,1157776
4369,suicide bomber kill base afghanistan,suicide comber attack base afghanistan,2.799999952316284,0.5895536155120826,3321,2592,729,531441
4370,afghan flock college taliban loom,afghan district governor defect taliban,0.6000000238418579,0.28810947937002385,1365,661,704,495616
4371,north postpone family unions south,north postpone family union south,5.0,0.7196444975146681,4294,5702,-1408,1982464
4372,apple revenue miss shine disappoint,trade agency rule samsung bank shine import,0.6000000238418579,0.22990062407073195,1088,712,376,141376
4373,luman kill foreign tourist northern pakistan,luman kill foreign limber pakistan,3.400000095367432,0.5895377643442816,3320,3564,-244,59536
4374,david beckham announce retirement soccer,david beckham retire football,4.400000095367432,0.4598766007493088,2368,4994,-2626,6895876
4375,watt smith leave doctor year,watt smith quit bbc doctor,4.0,0.6604650812738739,3855,4569,-714,509796
4376,generation divide gay marriage,summit end divide syria,0.0,0.305688794131136,1458,100,1358,1844164
4377,kill ran car coming,kill ran bomb attack,1.600000023841858,0.3675584343253282,1795,1536,259,67081
4378,meet fire national lies injuries,set ablaze national die,5.0,0.1911562004174304,952,5608,-4656,21678336
4379,taliban attack kill civilian afghanistan,series attack kill police afghanistan,1.399999976158142,0.471970196617565,2459,1409,1050,1102500
4380,egypt minister survive assassination attempt,syrian prime minister survive assassination attempt,1.600000023841858,0.7962320967388617,4837,1560,3277,10738729
4381,x lady barbara rush leave texas hospital,lady barbara rush leave hospital,4.599999904632568,0.9146422162538058,5463,5217,246,60516
4382,schumacher coma ski accident,michael schumacher coma fighting life follow skin accident,4.0,0.5626570836848153,3121,4563,-1442,2079364
4383,kill chinese police station attack,kill china police station attack,5.0,0.7794233440703574,4717,5587,-870,756900
4384,bradley cooper beams talk fill dance armstrong topic,bradley cooper talk play dance armstrong topic,4.0,0.8614625354208048,5226,4561,665,442225
4385,airline clash russia kill,airline clash russian city kazan kill,3.799999952316284,0.5724307357357912,3200,4100,-900,810000
4386,minister determine resolve horseman scandal,minister hold crisis talk horse meat scandal,4.400000095367432,0.29448031618890447,1397,4996,-3599,12952801
4387,opposition party boycott general election,opposition announce election boycott,4.800000190734863,0.6748682529677086,3950,5440,-1490,2220100
4388,bangladesh building collapse death toll hit army,bangladesh building collapse death toll pass,2.5999999046325684,0.7595767587340925,4598,2457,2141,4583881
4389,pagan eddy shift hospital power crisis continue seemandhra,telangana pagan spend thursday hospital blackest continue seemandhra,4.199999809265137,0.46958997704245725,2448,4809,-2361,5574321
4390,central african republic president overthrow rebel,central african republic president step,2.5999999046325684,0.6764777963327792,3961,2458,1503,2259009
4391,brazil tie england maracana open,brazil hold england maracana open,5.0,0.8445840044491288,5131,5588,-457,208849
4392,california wildlife line firefighter labor limit damage video,california wildlife grow official fire crew make progress,3.799999952316284,0.29656725973835907,1407,4096,-2689,7230721
4393,george rush warn bitter immigration debate,george w rush weigh immigration debate,3.0,0.7037814706722558,4169,2804,1365,1863225
4394,angela hospitalize respond treatment,angela hospitalise stop talk,3.400000095367432,0.17401326052408822,887,3566,-2679,7177041
4395,russia condemn north organ nuclear test,south confirm north conduct controversial nuclear test,1.2000000476837158,0.3980162688839519,1988,1197,791,625681
4396,hundred bangladesh clothe factory worker ill,hundred fall sick bangladesh factory,4.400000095367432,0.41791214749662164,2114,5001,-2887,8334769
4397,semen suicide come kill soldier,female suicide bomber kill russian station,2.0,0.26662437410058626,1268,1864,-596,355216
4398,wrap russian coal blast,man kill russia coal blast,2.799999952316284,0.6123840517955933,3509,2590,919,844561
4399,protest break army headquarters,protest storm army headquarter,4.599999904632568,0.3644128978250506,1773,5216,-3443,11854249
4400,israel conduct airstrike syria,israel launch new airstrike syria,4.400000095367432,0.6257751010700707,3600,5019,-1419,2013561
4401,police fire tear gas disperse protest gun,police fire tear gas protest cairo,2.200000047683716,0.6313838308141213,3646,2071,1575,2480625
4402,egypt main opposition reject president dialogue,egypt opposition mill response dorsi dialogue,3.799999952316284,0.5183513569057376,2782,4089,-1307,1708249
4403,tokyo host olympic james,rest feature tokyo olympics,1.399999976158142,0.2481509918387423,1159,1375,-216,46656
4404,rousing start,rousing start,4.599999904632568,1.0,5692,5215,477,227529
4405,gastro assume celac presidency,cuba gastro celac presidency,5.0,0.7922409786922764,4814,5589,-775,600625
4406,magnitude earthquake hit new zealand,magnitude earthquake shake ran,0.2000000029802322,0.4744190351791203,2479,416,2063,4255969
4407,dozen fear wrap india building collapse,rescuer race find wrap india building collapse,3.0,0.588397164990023,3306,2810,496,246016
4408,daily dress grieving south sudan,daily dress grieving syria,1.2000000476837158,0.7806825166937894,4726,1174,3552,12616704
4409,islamists attack north ali city suicide coming,islamist attack italian troop,3.200000047683716,0.11561759062411076,625,3249,-2624,6885376
4410,britain set report bu canada,britain lose bid report radical clerk bu canada,2.200000047683716,0.6016560411034219,3416,2074,1342,1800964
4411,french parliament back reform law restitution,russian parliament consider ban adoption,0.800000011920929,0.1869166782182253,937,868,69,4761
4412,shot explosion hear continue protest bangkok,gunshot explosion rock protest day ahead poll,2.5999999046325684,0.2521614856831201,1185,2519,-1334,1779556
4413,israel military focus northern border,egypt military take control slim brotherhood supporter,1.600000023841858,0.14205938887978914,746,1535,-789,622521
4414,north block kaesong access,north vow start nuclear facility,1.0,0.14120107448203773,740,944,-204,41616
4415,fan sentence year prison,cry gastro sentence year prison,0.4000000059604645,0.6425135581523251,3728,486,3242,10510564
4416,senate approve fiscal cliff deal,official real reach fiscal cliff,3.400000095367432,0.4825956437432789,2527,3675,-1148,1317904
4417,zimmerman stop speeding texas release warning,zimmerman pull texas speed give warn,5.0,0.3626962544710729,1767,5591,-3824,14622976
4418,ran rouhani warn talibanisation syria,russia china concerned israel airstrikes syria,1.399999976158142,0.08845647661766229,476,1348,-872,760384
4419,syria deny report deadly damascus nerve gas attack,ally help repel cranial computer attack,0.0,0.07465001126054134,437,36,401,160801
4420,china stock close high economic meeting,china stock close high wednesday,3.400000095367432,0.6265565224114342,3607,3671,-64,4096
4421,russia unveil billion oil link pacific,russia unveil oil link pacific,3.400000095367432,0.9299839852880578,5512,3619,1893,3583449
4422,police kill german find dead solo home,dead police standoff german barricade home,2.0,0.5399631062556427,2956,1791,1165,1357225
4423,gabbana convict tax invasion,gabbana lined italian tax case,3.0,0.4749036215146316,2485,2779,-294,86436
4424,magnitude quaker hit pakistan cenc,magnitude earthquake hit pakistan,3.799999952316284,0.5882653708090797,3304,4072,-768,589824
4425,osteoid lip earth satellite,osteoid pass earth fly,4.400000095367432,0.5935329073666937,3362,4964,-1602,2566404
4426,right ali effects islamist tactics,train ali army fight northern islamist militant,2.0,0.3241988141450832,1564,1796,-232,53824
4427,santa trace compete christmas,pain turn clock vista,0.0,0.0,317,37,280,78400
4428,ships brain syrian chemical weapons transport,syria roads chemical weapons bombs wait sad order,2.5999999046325684,0.25894728866314387,1219,2498,-1279,1635841
4429,kill wound attack ran,kill wound fresh attack ran,2.200000047683716,0.8167065598726806,4967,1987,2980,8880400
4430,trust syria hand chemical weapon,say syria satin gas chemical weapon,1.0,0.43092982430272603,2189,991,1198,1435204
4431,mexican singer penn river believe kill plane crash,penn river mexican music star die plane crash,3.400000095367432,0.6373331418254231,3694,3531,163,26569
4432,bangladesh court sentence lawmaker death war crime,british push ri vanka war crime,1.7999999523162842,0.28003927185621014,1328,1677,-349,121801
4433,mugabe declare winner dispute election,zimbabwe mugabe declare winner disputed vote,4.0,0.5790517802165275,3239,4694,-1455,2117025
4434,death toll limb indonesia boat sink,indonesia death toll rise indonesia boat capsule,3.5999999046325684,0.5970384749511017,3389,3822,-433,187489
4435,egyptian court bank slim brotherhood,egypt court bank slim brotherhood activity,3.799999952316284,0.7177746517076684,4280,4099,181,32761
4436,rouhani lead ran presidential vote preliminary result,rouhani lead initial ran count,4.199999809265137,0.4664545559684328,2422,4842,-2420,5856400
4437,police attack belfast flag protest,politician flag violence talk,0.6000000238418579,0.2793210712575323,1323,718,605,366025
4438,propose final talk kaesong,north propose high level talk,1.0,0.4118022934407788,2078,981,1097,1203409
4439,india gang rape victim struggle odd,indian rape victim die singapore hospital,1.7999999523162842,0.32598349780393165,1570,1679,-109,11881
4440,luman kill foreign tourist pakistani,lumen foreign tourist pakistan,2.799999952316284,0.4794843980329895,2508,2641,-133,17689
4441,statement spokesperson high representative catherine seton late state attack ran,statement spokesperson high representative catherine seton resumption execution ran,3.200000047683716,0.786216495191103,4761,3267,1494,2232036
4442,egypt increase security pro dorsi protest,egypt race massive protest,3.0,0.28509530072989236,1352,3045,-1693,2866249
4443,yacimovich urge cabinet approve palestinian prisoner release,israel agree free palestinian prisoner,2.0,0.31508515680767557,1509,1800,-291,84681
4444,palestinians build west bank tent protest,palestinians vote symbolic historic,0.4000000059604645,0.1706238784679797,874,483,391,152881
4445,bangladesh building collapse death toll hit,bangladesh building collapse death toll limb,3.5999999046325684,0.8098247137522803,4927,3825,1102,1214404
4446,israel envoy summon settlement plan,britain summon israel envoy settlement,2.5,0.855532170626476,5194,2354,2840,8065600
4447,dead injure nevada middle school shooting,nevada dead hurt middle school shooting,5.0,0.844903178579276,5135,5592,-457,208849
4448,james mixed sex school ban take effect,james mix sex school ban,4.199999809265137,0.6654675704461142,3890,4846,-956,913936
4449,arrest police officer shoot need,navy panel urge outer officer face death,0.4000000059604645,0.1701355707154484,871,481,390,152100
4450,ukrainian crime minister design amid protest,turkish crime minister signal return handle protest,0.6000000238418579,0.3678541320981878,1797,677,1120,1254400
4451,drama focus economy state union,factbox look drama state union speech,2.200000047683716,0.4157564201946937,2104,2045,59,3481
4452,google launch internet beam balloon,google play international tax game,1.0,0.21336411311818684,1026,974,52,2704
4453,ran back egypt crackdown dorsi supporter,ran back egypt crackdown ashamed dorsi supporter,4.800000190734863,0.8485397499890898,5155,5434,-279,77841
4454,russia give initial american adoption ban,russia give initial approval adoption ban,3.799999952316284,0.8068522451773875,4902,4108,794,630436
4455,convict kosovo organ trafficking case,kosovo jail time organ trafficking case,2.799999952316284,0.7438237072198917,4486,2647,1839,3381921
4456,hrithik shan wife sussanne way,hrithik shan sussanne divorce,4.400000095367432,0.7376089879871597,4435,5024,-589,346921
4457,human head florida apartment shooting,human dead apartment shootout,5.0,0.46710500953908496,2429,5593,-3164,10010896
4458,drama land progress gay right inaugural address,thousand protest gay marriage france,1.0,0.20587005156545798,1007,930,77,5929
4459,coming kill ran,war bomb kill ran,2.200000047683716,0.4085204478145399,2055,2026,29,841
4460,shock drama put syria strike hold,drama put syria strike hold,4.599999904632568,0.7567717252340077,4571,5212,-641,410881
4461,israel strike syria tension rise weapon,air strike wind civilian syria vera,1.7999999523162842,0.22361843191919994,1060,1681,-621,385641
4462,luman kill people northwest pakistan,militant kill soldier northwest pakistan,2.5999999046325684,0.5760119850301949,3219,2386,833,693889
4463,francisco plane crash glance,dead hurt francisco air crash,1.2000000476837158,0.4634049325611477,2391,1151,1240,1537600
4464,arrest deadly bangladesh building collapse,worker protest bangladesh building collapse,2.200000047683716,0.6101646844745585,3491,1975,1516,2298256
4465,cruise passenger hit noroviru,kiss cruise passenger nsw,0.0,0.4571086506314343,2351,41,2310,5336100
4466,murder claim diana death new information pass police relate death princess diana lodi gazed think include allegation murder,diana gazed death receive new death princess diana lodi ll gazed look police receive information,3.5,0.6562705267367414,3829,3702,127,16129
4467,dowden ask stay russia,dowden release russia video,1.399999976158142,0.4876231661313965,2565,1291,1274,1623076
4468,chinese share close low wednesday,chinese share close high friday,2.200000047683716,0.5641228908772792,3136,1991,1145,1311025
4469,stomach bug cause ail canal miss australian open,tafa canal miss australian open,3.400000095367432,0.5017074851918493,2670,3482,-812,659344
4470,narendra lodi pledge tough stand pakistan,india lodi promise tough stance pakistan,4.800000190734863,0.5107666478697686,2731,5430,-2699,7284601
4471,egyptian court consider mubarak release,egypt court order release mubarak,3.400000095367432,0.5914222233969685,3342,3516,-174,30276
4472,boy scouts delay decision admit day,boy scouts america delay vote lift ban day,5.0,0.5700031799876862,3179,5598,-2419,5851561
4473,car bomb kill southern ran,war come kill northern ran,1.399999976158142,0.2539215151437492,1194,1292,-98,9604
4474,der loot carry prison,moran loots plan met carried peru prison,4.0,0.12463766248712267,674,4658,-3984,15872256
4475,tokyo stock close,tokyo stock close,3.0,1.0,5598,3059,2539,6446521
4476,china stock index future close high,china stock index future close low,2.200000047683716,0.8199584061710733,4988,2114,2874,8259876
4477,picture day august,picture day april,2.799999952316284,0.6238905124805856,3583,2636,947,896809
4478,palestinians hit israel fire papa,palestinians kill israel air strike papa,2.799999952316284,0.6701045056105868,3920,2626,1294,1674436
4479,hesse jackson wife plead guilty fraud,hesse jackson life lead guilty fraud,4.599999904632568,0.7211214111228482,4304,5209,-905,819025
4480,usa expel venezuela diplomat row,expel venezuelan diplomat,4.400000095367432,0.5203067974741109,2798,5091,-2293,5257849
4481,bbc veteran admit child sex abuse,stuart admit ex assault child,3.400000095367432,0.2769023890643639,1315,3536,-2221,4932841
4482,kill injure south china road accident,kill injure philippine road accident,0.6000000238418579,0.7295924810124494,4361,671,3690,13616100
4483,ryanair report record profit warn growth likely slow year,taste ryanair report rise annual profit warn slow growth year,3.400000095367432,0.7111717790898199,4229,3514,715,511225
4484,stock watch close monday,stock watch close thursday,3.0,0.7128273283114948,4242,2951,1291,1666681
4485,anniversary jfk death remember,anniversary jfk death dallas hold memorial,4.0,0.5906256411729678,3330,4656,-1326,1758276
4486,magnitude earthquake hit taiwan,magnitude earthquake hit pakistan,1.2000000476837158,0.7500003465980866,4528,1152,3376,11397376
4487,look help lids talk boston marathon news,report explosion finish line boston marathon,0.800000011920929,0.3324823026315008,1611,866,745,555025
4488,lech sector seat google ibm strong earning,google share soar past strong earning,2.5999999046325684,0.4196661882750682,2123,2435,-312,97344
4489,profile sonya presidential candidate,italian journalist pick presidential candidate,1.0,0.4031015412267043,2025,901,1124,1263376
4490,israel free palestinian prisoner,committee approve release palestinian prisoner,3.400000095367432,0.45172354208194376,2313,3507,-1194,1425636
4491,philadelphia building collapse people wrap,philadelphia building collapse report people wrap,4.0,0.9427895732294709,5538,4635,903,815409
4492,drama meet angela family,drama meet yuma pay tribute angela,3.0,0.4945307215660881,2622,2961,-339,114921
4493,senate set gun control debate,senate set vote gun control bill,3.400000095367432,0.791731675510309,4810,3509,1301,1692601
4494,war come kill damascus,war coming kill civilian iraqi capital,1.399999976158142,0.2708626144969821,1286,1294,-8,64
4495,friends syria oh talk arm rebel,syria talk agree military aid rebel,2.5999999046325684,0.3712276002891246,1817,2441,-624,389376
4496,syria condemn israel air strike,series deadly attack strike ran,2.0,0.1703284344427935,872,1910,-1038,1077444
4497,egypt leader impose state emergency city,egypt president declare state emergency city,5.0,0.6315959487648286,3650,5599,-1949,3798601
4498,abvp protest clash police altar altar throw stone,protester clash police altar altar people detain,2.799999952316284,0.6464589018263881,3760,2624,1136,1290496
4499,turkish urge end protest istanbul,turkish police fire tear protest istanbul,2.799999952316284,0.6693359180690868,3911,2625,1286,1653796
4500,man charge terrorist offence,maude bear iberian charge terrorist new work,1.7999999523162842,0.33553961243692854,1627,1628,-1,1
4501,receive noble peace prize,receives noble peace prize,3.5999999046325684,0.7096325799515839,4216,3801,415,172225
4502,start german bull run festival briefly delay view obstruct casque flag,german bull run festival start,2.5999999046325684,0.6154418565367978,3528,2397,1131,1279161
4503,foreigner kill paul suicide attack,briton dead paul suicide attack,2.799999952316284,0.5397402311429447,2953,2629,324,104976
4504,lapd officer seek divine saying,cia officer sentence month prison leak,0.0,0.13096452878125855,701,44,657,431649
4505,tokyo share close low,singapore stock close low,0.800000011920929,0.4586239625293763,2361,844,1517,2301289
4506,pakistan court demand blasphemy damage answer,pakistan report reveal alarming level drug use,0.6000000238418579,0.09409642963006135,502,685,-183,33489
4507,mcafee loud base networked firewall specialist stonesoft m wash,mcafee acquire farewell stonesoft million,3.799999952316284,0.36495367487276104,1779,4202,-2423,5870929
4508,magnitude quaker strike,magnitude earthquake strike philippines,1.0,0.5339653756663751,2905,907,1998,3992004
4509,bangladesh opposition leader sentence death war crimes,bangladesh fugitive sentence death war crimes tribunal,3.5999999046325684,0.6687732889945023,3909,3802,107,11449
4510,alleged cop killer die shot head,alleged cop killer die gunshot,4.199999809265137,0.727279331110462,4338,4834,-496,246016
4511,war bomb swedish consult tibia benghazi casualty,war comb swedish consulate benghazi hurt,4.800000190734863,0.4381768415082763,2233,5442,-3209,10297681
4512,musharraf arrest pal masjid case,musharraf arrest pakistan,3.0,0.5266723550816959,2833,2991,-158,24964
4513,ran hope nuclear talk yield roadway,ran nuclear talks geneva spur high hopes,4.400000095367432,0.16837178587902518,858,5078,-4220,17808400
4514,militant kill afghan maid official,militant kill afghan maid ministry,2.799999952316284,0.7958455127914741,4834,2632,2202,4848804
4515,north reportedly test fire short range missile,north launch short range missile,4.0,0.7042898449313242,4172,4522,-350,122500
4516,protest obstruct vote dead violence,protest block polling station bangkok,2.799999952316284,0.11442281022997747,618,2633,-2015,4060225
4517,venezuela hugo die cancer,hugo venezuelan official unity,1.7999999523162842,0.34333699424724806,1677,1662,15,225
4518,north test bring close nuclear power status,nato say north nuclear test grave threat world peace,2.200000047683716,0.31298250473730216,1499,1996,-497,247009
4519,north conduct nuclear test,north confirm nuclear west,4.599999904632568,0.3868231616353823,1921,5208,-3287,10804369
4520,indian stock open flat,indian stock open low,3.5999999046325684,0.6541040596949776,3812,3788,24,576
4521,macau gambling revenue record,macau gambling revenue hit record,5.0,0.9385135938026795,5527,5600,-73,5329
4522,israelis palestinians resume talk,israelis palestinians begin talk,3.799999952316284,0.713868759620506,4248,4198,50,2500
4523,elson angela memorial service,elson angela die coverage,2.400000095367432,0.46262976448383997,2388,2202,186,34596
4524,county prepares ex carriages hearing,county official way sex marriage,3.799999952316284,0.16250592846711512,827,4197,-3370,11356900
4525,air force helicopter crew member kill crash,air force helicopter crew kill british crash,4.0,0.8550316000281762,5189,4359,830,688900
4526,tokyo host olympic james,tokyo win race host olympics,4.199999809265137,0.48151872874600427,2521,4867,-2346,5503716
4527,malaysia detail australian senator airport,malaysia detail australian lawmaker airport,4.0,0.7036203912518278,4167,4349,-182,33124
4528,south day north tired missiles,north launch short range missile,2.200000047683716,0.127979096489301,691,2002,-1311,1718721
4529,britain shut plant horse meat scandal reach france,minister determine resolve horseman scandal,3.0,0.1493071925118011,779,2972,-2193,4809249
4530,warn syria chemical weapon,concern grow syria chemical weapon,3.200000047683716,0.5650663974512599,3143,3330,-187,34969
4531,kill bus crash italy,kill bus accident pakistan,1.2000000476837158,0.3977623335195702,1987,1153,834,695556
4532,china juan strengthen usd,chinese juan weaken usd,3.0,0.5487617855569265,3017,2981,36,1296
4533,recognize syrian opposition,russia invite syrian opposition talk,2.0,0.41370999500814365,2091,1937,154,23716
4534,egypt vote new constitution,egyptians note new constitution,4.800000190734863,0.48926486466635255,2578,5418,-2840,8065600
4535,preston england legend tom dinner die,england great tom dinner die,4.400000095367432,0.6540862212344907,3811,5118,-1307,1708249
4536,war bomb kill wound benghazi,war bomb hit libyan foreign ministry benghazi,3.0,0.5400132832888371,2957,3009,-52,2704
4537,roadside bomb kill afghanistan,roadside bomb kill policeman afghanistan,3.400000095367432,0.8422122879332903,5115,3637,1478,2184484
4538,ri vanka family note greater autonomy,syria talk cameron ruin,0.4000000059604645,0.0,358,495,-137,18769
4539,french lead troop close timbuktu,french lead troop control access timbuktu,3.5999999046325684,0.7599572373212893,4604,3809,795,632025
4540,dato airstrike kill afghan kiss,dato soldier die afghanistan,1.2000000476837158,0.3514673078434382,1720,1154,566,320356
4541,lumen foreign tourist pakistan,luman kill foreign limber pakistan,4.0,0.33372983906391696,1619,4403,-2784,7750656
4542,n halt work joint industrial zone,north block access joint industrial zone,4.0,0.588970885747732,3316,4404,-1088,1183744
4543,delhi sang gape suspect beaten poisoned,delhi gang rape verdict defer,1.7999999523162842,0.1802690445373025,914,1731,-817,667489
4544,france pledge military aid ali,french support military operation ali,1.399999976158142,0.3574893873167382,1742,1298,444,197136
4545,egyptians vote division constitution,egyptians vote constitution change,4.0,0.7424417895973864,4474,4408,66,4356
4546,reid city tremendous progress debt ceiling talk,senate leader appear close debt ceiling deal,2.799999952316284,0.31449715615315554,1507,2654,-1147,1315609
4547,magnitude quaker bolt sarangani,magnitude earthquake bolt china,2.0,0.5333542031297168,2901,1948,953,908209
4548,dead hurt car chaos,dead hurt cotabato blast,1.2000000476837158,0.40246856416614213,2021,1156,865,748225
4549,chairman easyjet step,chairman british fill airline easyjet step,4.199999809265137,0.8158368436943813,4956,4869,87,7569
4550,drama renew offer cut social safety net big budget deal aide,japan urge quickly handle budget deadlock,0.800000011920929,0.1187992963307881,641,871,-230,52900
4551,suicide somber hills afghan province council,suicide somber hills afghanistan,2.400000095367432,0.6756320193929364,3955,2207,1748,3055504
4552,committee year final big immigration decision,senate judiciary committee near final big decision shape immigration bill,3.400000095367432,0.6871919166040122,4043,3678,365,133225
4553,troop kill afghan insider attack,nato troop kill afghan insider attack,3.799999952316284,0.8958065500334914,5396,4192,1204,1449616
4554,arrest suspicion manslaughter dog kill daughter,arrest suspicion murder stab suffolk,1.7999999523162842,0.32373753251284154,1561,1734,-173,29929
4555,dead miss canada train disaster,miss canadian train wreck,3.200000047683716,0.33613026283422454,1633,3289,-1656,2742336
4556,tunisian opposition politician shoot dead,tunisia opposition leader slay protest erupt,3.0,0.1344161803143715,718,2960,-2242,5026564
4557,press need major boost syrian aid,chief press major boost syrian aid,4.800000190734863,0.857055074705249,5202,5364,-162,26244
4558,stock soar lead,stock slump street,1.600000023841858,0.19799810168732151,976,1548,-572,327184
4559,george zimmerman find guilty trayvon martin murder,protest appeal calm zimmerman acquit trayvon martin murder,2.5999999046325684,0.5895257834674509,3319,2513,806,649636
4560,whistleblower edward dowden fly moscow,nsa whistleblower edward dowden leave long long flight moscow,3.5999999046325684,0.6284913452647416,3618,3774,-156,24336
4561,kill wound bomb attack northern ran,kill wound clash northern lebanon,0.6000000238418579,0.5711467192947789,3188,694,2494,6220036
4562,consider reveal election secret,eye caprices venezuela election met,1.2000000476837158,0.13490692614253688,721,1158,-437,190969
4563,royal sorrow nurse death,radio prankster tear nurse death,2.799999952316284,0.3489121945045229,1705,2577,-872,760384
4564,n say delay controversial rocket launch,look set delay controversial rocket launch,4.199999809265137,0.8414896867690378,5110,4853,257,66049
4565,critical rates memoir rock drama administration,rate blast rock drama administration,4.0,0.4859590607456312,2543,4381,-1838,3378244
4566,jeff bezos get million reviving washington,jeff bezos days million washington,4.199999809265137,0.7310388674127518,4380,4833,-453,205209
4567,brooks plead guilty hack charge,brooks plead guilty phone hacking hearing,3.799999952316284,0.5840738032672981,3278,4191,-913,833569
4568,urge send shilling message north elite,urge uncle send shilling message north elite,4.0,0.9129938232140583,5454,4387,1067,1138489
4569,south africans mark ail angela birthday,south africa elson angela hospital,1.399999976158142,0.2634291645081807,1248,1300,-52,2704
4570,drama declare health care law work,drama pledge new health care law work,3.0,0.7643840243255421,4628,3021,1607,2582449
4571,heavy rain raise threat christmas flooding,fresh rain bring flooding,3.0,0.46930940123950937,2443,3012,-569,323761
4572,thousand protest gay marriage,thousand protest gay marriage paris,3.5999999046325684,0.8704404595609416,5272,3762,1510,2280100
4573,taiwan gang leader name airport year,labia arrest ex leader oil deal,0.4000000059604645,0.14578682144281713,762,507,255,65025
4574,ran duke talk begin amid hope progress,ran nuclear talk start geneva,3.0,0.2120639447598293,1021,3043,-2022,4088484
4575,political protest paralyse minister,protest besiege minister,4.199999809265137,0.3773336443361487,1866,4831,-2965,8791225
4576,amazon bezos buy washington million,amazon bezos busy washington m,4.599999904632568,0.6987111866696161,4121,5202,-1081,1168561
4577,drama economic tour suffer low expectation,drama encourage boy scouts end ban day,1.7999999523162842,0.09641611829083087,511,1753,-1242,1542564
4578,israel vow deny hezbollah air strike,war bomb kill hezbollah beirut action minister,0.6000000238418579,0.20503683039237644,1000,662,338,114244
4579,france welcomes russia real syria,arab league welcome russian deal syria,2.400000095367432,0.09270325623425349,498,2186,-1688,2849344
4580,french soldier central african republic,run battle central african capital create fresh panic,2.0,0.3237570533244608,1562,1931,-369,136161
4581,resolution order syria chemical arm destroy,germany ready help syria chemical mission,1.0,0.22986210678128652,1087,1085,2,4
4582,exclusive update egypt pro bursa alliance signal flexibility talk,exclusive update egypt pro bursa alliance signal flexibility talk,4.599999904632568,1.0000000000000002,5744,5200,544,295936
4583,david beckham retire end season,david beckham retires football,4.199999809265137,0.44450847384478265,2278,4807,-2529,6395841
4584,tibia abruptly close border country,tibia close border declare martial law south,3.400000095367432,0.4533060411922653,2327,3592,-1265,1600225
4585,magnitude quaker hit greece usgs,magnitude quaker bolt japan,1.0,0.41424690176221396,2094,1094,1000,1000000
4586,search man sweep sea,vara plan visit real,0.2000000029802322,0.0,345,396,-51,2601
4587,militant stage pakistan jailbreak,taliban prison break militant escape attack pakistan jail,3.0,0.2562079591056069,1204,3020,-1816,3297856
4588,meteorite hit central russia people hurt,meteorite hit central russia hurt,3.0,0.9534240949620194,5561,3022,2539,6446521
4589,blizzard bring northeast halt,blizzard gallop northeast close road,4.199999809265137,0.5456313591195224,2997,4805,-1808,3268864
4590,nato protest acquit terrorist charge,nato protest convict non terrorist charge,1.600000023841858,0.6302809107329558,3633,1534,2099,4405801
4591,credibility line syria,drama congress world credibility line,1.399999976158142,0.6535188870450717,3804,1305,2499,6245001
4592,taliban agenda pakistan,dead big quaker hit pakistan,0.0,0.19176803969174602,954,65,889,790321
4593,egypt interior minister survive bomb,egypt interior minister survive bomb attack,5.0,0.9502074982347938,5553,5585,-32,1024
4594,china juan weaken usd thursday,china juan weaken usd tuesday,2.0,0.835816102402061,5081,1918,3163,10004569
4595,drama hold talk syria action,cameron lose parliamentary vote syria military action,1.399999976158142,0.30029114057193224,1429,1306,123,15129
4596,egypt freeze slim brotherhood asset,egypt freeze slim brotherhood fund,5.0,0.75980542544611,4600,5584,-984,968256
4597,men report easy high maintenance,russian meteorite leave build gape open,0.0,0.0,364,52,312,97344
4598,bony abbott swear new australian,bony abbott worn australia,4.599999904632568,0.5111058840742854,2737,5199,-2462,6061444
4599,egypt army crack brotherhood,egypt military crack slim brotherhood,4.0,0.6857831668129962,4031,4347,-316,99856
4600,venezuela assembly meet amid health crisis,assembly meet amid crisis,3.400000095367432,0.8085357922565767,4915,3672,1243,1545049
4601,syria opposition threaten quit talk,syria opposition agree talk,2.0,0.546837387709392,3004,1942,1062,1127844
4602,suicide bomber kill policeman pakistan,suicide combers soldier pakistan,2.5999999046325684,0.3470168167638149,1695,2391,-696,484416
4603,anti government protest storm street iv,ukraine protest couple vein statue,0.800000011920929,0.11662612873452496,631,862,-231,53361
4604,chicago man sentence terror conviction,paul bank heads sentence corruption,1.0,0.17426155981920466,889,1102,-213,45369
4605,drone strike kill northwest pakistan,drone strike kill seven north waziristan,2.400000095367432,0.4261584034743524,2158,2197,-39,1521
4606,track fault disrupt train service baffled place marina,brain service disrupt baffled place marina,4.199999809265137,0.7567451806421607,4570,4798,-228,51984
4607,fan sentence year leak government secret,briton jail year sell face bomb detector,1.0,0.07312743818666191,433,1017,-584,341056
4608,police terrorist link helicopter crash,china police seek suspect crash,1.0,0.3356478302716083,1629,1024,605,366025
4609,suicide bomber kill russia south,suicide bomber kill russia volgograd,1.7999999523162842,0.6927882581850171,4086,1766,2320,5382400
4610,kill wound violent attack ran,kill wound fresh attack ran,1.7999999523162842,0.6540752754681517,3809,1768,2041,4165681
4611,merry visit jordan israel palestinian peace agenda,merry postpone visit israel week,2.5,0.438453552313906,2236,2349,-113,12769
4612,eurozone bless hit fresh record high,bless hit fresh record,4.400000095367432,0.8141091100646123,4945,5036,-91,8281
4613,elson angela real hero gandhi peru,elson angela health unstable,1.399999976158142,0.2913211331259726,1375,1308,67,4489
4614,face bailout tax cypriots cry met wash rank,bailout term prompt run typhus bank,3.0,0.19380641003349702,961,2969,-2008,4032064
4615,drama sign obamacare,americans scramble sign obamacare deadline,1.2000000476837158,0.5488132180788601,3018,1161,1857,3448449
4616,dance armstrong confess pray,dance armstrong confess pray interview,4.199999809265137,0.8908118706649154,5370,4813,557,310249
4617,andy murray deserve knighthood david cameron say,david cameron andy murray deserve knighthood,5.0,0.9826167406401993,5578,5564,14,196
4618,rush index close high act,rush index close low march,2.0,0.5561374731430477,3077,1881,1196,1430416
4619,state department fail benghazi,state keep security chief design benghazi,2.400000095367432,0.43964927812103566,2245,2221,24,576
4620,soccer france host australia time october,nra official face question time controversial remark,0.0,0.10915791896013037,589,56,533,284089
4621,honduras ambassador colombia sack wild party,honduras ambassador design allege embassy org,3.5999999046325684,0.35358416341153875,1728,3754,-2026,4104676
4622,syria destroy chemical weapon,tibia destroy chemical weapon,2.400000095367432,0.765239206474006,4633,2217,2416,5837056
4623,moderate tremor central mediterranean,ran moderate candidate win presidential vote,0.0,0.27507454919813584,1307,57,1250,1562500
4624,afghan kill suicide attack,afghan dead new blast base east afghanistan,3.5999999046325684,0.22024356238305037,1048,3800,-2752,7573504
4625,suicide bombs egypt military final,suicide bomb hit egypt military final kill,2.799999952316284,0.6341217479579758,3666,2724,942,887364
4626,sign market gain beat economic datum,sign market lift positive china datum,3.400000095367432,0.4610639933635601,2377,3432,-1055,1113025
4627,suicide bomber kill pakistan political rally,suicide bomber kill guard embassy turkey,1.600000023841858,0.41787578565916483,2113,1518,595,354025
4628,dorsi supporter kill egypt clash,dozen injure dorsi supporter clash security force,2.200000047683716,0.5924809004906293,3354,2094,1260,1587600
4629,student ride airwave,magnitude quaker hit taiwan,0.0,0.0,154,58,96,9216
4630,histories officer drop case,history officer attempt murder charge,2.200000047683716,0.19557476179819547,967,2092,-1125,1265625
4631,vinnie bones reveal cancer battle new,vinnie bones reveal skin cancer,4.0,0.7863890625882124,4762,4489,273,74529
4632,pakistani taliban chief hakimullah mehsud kill drone strike,pakistan taliban vow revenge repay hakimullah killing bloodshed,2.5999999046325684,0.2695122767624764,1277,2436,-1159,1343281
4633,dozen kill air strike baker central syria,dozen kill syrian air strike baker,5.0,0.8000218512264164,4865,5566,-701,491401
4634,luman kill soldier injure pakistan,luman kill folio worker pakistan,2.0,0.5015761759863786,2669,1900,769,591361
4635,police confirm suspect capture,say boston marathon come suspect capture film,2.200000047683716,0.4106180168670062,2071,2099,-28,784
4636,destruction syria chemical weapon begin,destruction syria chemical weapons drove difficult,2.799999952316284,0.47073553319571726,2454,2726,-272,73984
4637,flood canada force evacuation city,california wildlife force evacuation home university,0.800000011920929,0.34151651847229053,1664,841,823,677329
4638,say drone violate pakistan sovereignty,drone strike violate pakistan sovereignty,4.400000095367432,0.9038154522835153,5427,5049,378,142884
4639,drama praises angela inspiration,drama nail angela inspiration effect,4.800000190734863,0.583390761821854,3273,5419,-2146,4605316
4640,drama come listen israel palestinians,merry welcomes arab plan israel palestinian talks,0.800000011920929,0.09480896014886615,506,840,-334,111556
4641,e mail oil firm ask trader meet minister,oil firm ask rogue trader meet minister,4.199999809265137,0.7929752547198914,4816,4825,-9,81
4642,death toll siberia police attack rise,death toll sonya bus attack rise,1.399999976158142,0.5989470973584512,3398,1376,2022,4088484
4643,syria declare chemical weapon sign convention,russia syria work concrete chemical weapons plan,2.5999999046325684,0.23238698687999892,1099,2425,-1326,1758276
4644,australia scrap soar national debt ceiling,australian insist argument indonesia,0.0,0.0,97,59,38,1444
4645,sign market hit high hope debt deal,sign stock hit week high hope debt deal,4.800000190734863,0.8184191654830236,4976,5410,-434,188356
4646,italian crime minister paris anti design,palestinian crime minister fayyad design,1.399999976158142,0.5031348177393224,2681,1316,1365,1863225
4647,south africa admit mistake schizophrenic angela signer,south africa admit possible mistake deaf signer angela memorial,3.200000047683716,0.7045342229086998,4173,3227,946,894916
4648,ran say issue remain nuclear talk,ran vow preserve peaceful nuclear program,1.600000023841858,0.22610727658317664,1066,1519,-453,205209
4649,crowd father bethlehem christmas,oh little town bethlehem real,2.0,0.3010581733341501,1433,1957,-524,274576
4650,peacekeeper kill sudan darfur,peacekeeper kill bye clash,1.600000023841858,0.42084299862527186,2130,1521,609,370881
4651,nato patriot missile battery operational syrian border,drama patriot missile battery troop stay jordan near syrian border,3.200000047683716,0.6213529627108466,3571,3221,350,122500
4652,stock tumble day shutdown,stock fall day government shutdown,4.599999904632568,0.6097898177060661,3484,5277,-1793,3214849
4653,guinea vote long delay legislative poll,equatoguinean vote legislative poll,3.400000095367432,0.5549744791945437,3071,3448,-377,142129
4654,nato troop kill afghanistan attack,nato troop kill afghan insider attack,3.0,0.6599472381197997,3849,3028,821,674041
4655,israel soldier hit palestinian child neuron,israel soldier kill palestinian woman west bank,1.2000000476837158,0.4356104278975259,2217,1162,1055,1113025
4656,voice alarm israel strike syria,israel official confirm second air strike syria,2.200000047683716,0.3504532924265201,1712,2023,-311,96721
4657,egypt army haunches new air maids final militant,egypt launch new assault final militant,3.400000095367432,0.44697111418220853,2293,3426,-1133,1283689
4658,french force attack al qaeda ali ally,battle retaken north ali hundred french troop drive al say link rebel,2.5999999046325684,0.3512774587059944,1719,2373,-654,427716
4659,egyptian police fire tear gas brotherhood protest,india dear tired sing gape protesters,1.2000000476837158,0.0,88,1163,-1075,1155625
4660,syria regime agree attend peace conference,syria opposition agree principle attend peace conference,3.0,0.6941024778310785,4095,3023,1072,1149184
4661,dozen injure jet crash land francisco airport,guiana air crash land francisco airport,3.799999952316284,0.593457218699303,3360,4181,-821,674041
4662,child die fire myanmar mosque fire,myanmar police child die electrical fire mosque,4.599999904632568,0.7849384237711852,4750,5279,-529,279841
4663,senate vote fiscal cliff deal deadline year,fiscal cliff house delay vote fiscal cliff deal live,2.799999952316284,0.6474498723794431,3767,2730,1037,1075369
4664,knife arrest entrance buckingham palace,charged buckingham palace arrest,2.200000047683716,0.6286311319107832,3619,2068,1551,2405601
4665,people bury colorado avalanche,snowboarder kill colorado avalanche,2.799999952316284,0.6028433703430354,3425,2735,690,476100
4666,moon review syria chemical arms accord,review syria chemical arm accord,3.5999999046325684,0.6770896251491647,3970,3817,153,23409
4667,iraqi president hospital health problem,iraqi president hospital suffer stroke,3.5999999046325684,0.5049661682039177,2696,3826,-1130,1276900
4668,malaysia long rule coalition hang power,malaysia rule coalition win majority,3.799999952316284,0.5672198236250586,3160,4180,-1020,1040400
4669,explosion dear cranial embassy beirut,blast near cranial embassy beirut,4.199999809265137,0.6466633026690753,3762,4817,-1055,1113025
4670,hurt new orleans shooting,police hurt nola shooting,4.199999809265137,0.45475862212222606,2337,4816,-2479,6145441
4671,age lament political change defence budget,age depend propose cut defense spending,2.400000095367432,0.13894417686615143,733,2176,-1443,2082249
4672,bank carry liquid get flight russia,bank carry liquid direct flight russia,4.400000095367432,0.8853679888977253,5348,5061,287,82369
4673,egypt brotherhood stand ground kill,egypt slim brotherhood stand dorsi,2.400000095367432,0.5603834592532955,3100,2189,911,829921
4674,dato troop kill afghan child,nato strike kill afghan child,3.0,0.48457340547787353,2537,3046,-509,259081
4675,cranial president call new nuclear talk,cranial minister blame west fail duke talk,2.0,0.33723664385137786,1640,1777,-137,18769
4676,flood kill force salary home,flood forces canada come,3.400000095367432,0.2949134035411813,1400,3464,-2064,4260096
4677,nato troop kill afghanistan,right nato troop kill afghanistan,2.5999999046325684,0.890516795295414,5366,2370,2996,8976016
4678,typhoon widow make windfall east china,typhoon widow slum southwestern china,3.799999952316284,0.5431177467092065,2977,4179,-1202,1444804
4679,angela spend christmas hospital,angela movie open month south africa,0.2000000029802322,0.17135227242190745,878,401,477,227529
4680,exit poll suggest ruin ally win moscow vote,exit poll show ruin ally win moscow vote cavalry cry foul,3.400000095367432,0.7353994535112429,4419,3463,956,913936
4681,judge enter guilty plea james holmes,guilty plea james holmes insanity option table,4.0,0.6282476529773066,3614,4510,-896,802816
4682,kill pain train crash,kill triple car coming ran diyala,1.0,0.08393323266971972,461,1056,-595,354025
4683,chris room ride de france engage,chris grown concert cancel new,0.0,0.2633033753293813,1247,62,1185,1404225
4684,apple pp direct driver alaska airport runaway,apple pp send driver airport,3.5999999046325684,0.6743949406045682,3946,3821,125,15625
4685,suspect drone kill militant pakistan,drone kill militant pakistan,3.400000095367432,0.881690875551179,5333,3453,1880,3534400
4686,francis begin papa prayer,hope francis lips vatican prayer,3.5999999046325684,0.5243041597947444,2820,3820,-1000,1000000
4687,senate meet path fiscal impulse elusive,senate sunday session days amid fiscal masse,3.5999999046325684,0.25628625047738574,1205,3819,-2614,6832996
4688,egypt brotherhood beleaguered leader,egypt slim brotherhood met pass march,1.7999999523162842,0.3273904682860616,1577,1671,-94,8836
4689,china new stealth frigate commission,belarus latvia set border commission,0.2000000029802322,0.17659955900674212,897,406,491,241081
4690,ran violence kill,ran violence kill seven,2.200000047683716,0.8008999891385333,4872,1980,2892,8363664
4691,protest continue tense ukraine capital,protest continue brazil,1.600000023841858,0.42224495305989096,2139,1525,614,376996
4692,prison release kidnap egypt final,bedouin release prisons seize egypt final,3.200000047683716,0.4001687960876906,2004,3261,-1257,1580049
4693,syria welcome ran nuclear deal,ran world power clinch breakthrough nuclear deal,3.0,0.37188938228033575,1824,2788,-964,929296
4694,israel face european backwash settlement plan,israel call account late settlement plan european country,3.5999999046325684,0.5590132597333772,3092,3814,-722,521284
4695,drama joke reporter dinner,drama joke fun critic press dinner,2.200000047683716,0.5357053320786407,2923,2006,917,840889
4696,ellen respond marrow abuse claim letter,ellen depend self marrow abuse claim,4.199999809265137,0.6684478145551827,3908,4902,-994,988036
4697,inmate escape tibia al kweifiya prison,prisoner escape libyan jail,4.400000095367432,0.22379414644849926,1062,5051,-3989,15912121
4698,nuclear option,shot nuclear readiness,1.2000000476837158,0.2215116448493905,1051,1164,-113,12769
4699,amp old march,old march,2.5999999046325684,0.7034509700854579,4165,2494,1671,2792241
4700,islamist kill suicide attack tiger,war bomb kill turkish town near syrian border,1.0,0.06871587782182698,427,1033,-606,367236
4701,determine syria chemical weapon,vote eliminate syria chemical weapon,2.799999952316284,0.5094683654859935,2720,2744,-24,576
4702,dowden father arrive moscow,edward dowden father moscow,4.199999809265137,0.7311343983974284,4382,4901,-519,269361
4703,pakistani taliban name new leader drone strike,pakistani taleban chief kill drone strike,2.200000047683716,0.5001464378300582,2657,2106,551,303601
4704,win coming pakistan kill,militant battle pakistani police,1.2000000476837158,0.0,134,1165,-1031,1062961
4705,slim brotherhood supporter die cairo clash,slim brotherhood supporter die egypt clash,3.5999999046325684,0.8274711327594019,5030,3808,1222,1493284
4706,facebook earning jump mobile accelerate,facebook profit jump user base expand,3.400000095367432,0.3175656659853505,1526,3679,-2153,4635409
4707,syria envoy call national unity government,syria envoy call political change end conflict,2.200000047683716,0.3337587330750251,1620,2113,-493,243049
4708,thirty head italy plunge,thirty head italian plunge,3.200000047683716,0.7845706859787325,4748,3250,1498,2244004
4709,roger videotron extend reach network share deal,roger videotron reach network sharing spectrum deal,4.199999809265137,0.6670307451223917,3898,4883,-985,970225
4710,china stock end low thursday,china stock close lower thursday,5.0,0.5392428019155449,2952,5570,-2618,6853924
4711,hopeless women protest berlusconi notes election,bulgaria president backs protesters oppose snap elections,0.6000000238418579,0.0,118,707,-589,346921
4712,indonesia schoolchildren kill indonesia volcano eruption,indonesia dead indonesian volcanic eruption,2.799999952316284,0.4531636991629359,2326,2699,-373,139129
4713,real reach new italian government,italy swear new coalition government,3.400000095367432,0.2573615704724896,1211,3669,-2458,6041764
4714,drama mourn death icon elson angela,south africans mourn celebrate angela,1.7999999523162842,0.3647221185174152,1775,1694,81,6561
4715,boa step boris march delhi,time history technion teach engineering russia,0.0,0.0,131,63,68,4624
4716,singapore stock close high,indian stock open high,1.7999999523162842,0.43640306828304753,2224,1690,534,285156
4717,maldive hold fresh election president,maldive hold fresh presidential election,4.599999904632568,0.8563024019302905,5200,5309,-109,11881
4718,egypt announce arrest slim brotherhood supporter,egypt order arrest brotherhood chief,1.7999999523162842,0.49529012297594166,2629,1639,990,980100
4719,new world trade enter declare table build,world trade enter name small building,4.199999809265137,0.5256171499699283,2828,4885,-2057,4231249
4720,papers war,papers june,1.7999999523162842,0.6340678409029367,3664,1638,2026,4104676
4721,israel green light settler home,israel unveil settler home,3.200000047683716,0.640517933293941,3716,3327,389,151321
4722,piers organ question police,pier organ interview police packing case,3.5999999046325684,0.25952724257688065,1224,3751,-2527,6385729
4723,lumbar photojournalist gangrene case crack accuse arrest,lumbar journalist gang rape case accuse arrest,4.800000190734863,0.46609513041972145,2415,5348,-2933,8602489
4724,israel arrest semen tossed spy,israel force detain neuron arrest raid,1.600000023841858,0.21175632717085416,1020,1527,-507,257049
4725,pakistani girl learn hard lesson,pakistani girl shoot taliban appear video,1.7999999523162842,0.2587990722604301,1218,1626,-408,166464
4726,egypt interim president appoint adviser,egypt interim president swear new cabinet,2.799999952316284,0.4518929163440526,2314,2749,-435,189225
4727,china launch air air missile copper,china court sentence fili life imprisonment corruption,0.6000000238418579,0.06830727396033069,426,710,-284,80656
4728,confirm fear syria chemical weapon,near syria chemical weapon,1.399999976158142,0.5955331806992215,3380,1267,2113,4464769
4729,egypt crackdown draw condemnation,egypt egypt crackdown spark global outrage,4.599999904632568,0.4023400249309017,2019,5311,-3292,10837264
4730,egypt swear new interim leader,egypt army crack brotherhood,0.6000000238418579,0.15876341368465594,812,709,103,10609
4731,war come kill pakistan,suicide bomber kill pakistan,2.5999999046325684,0.3733013525586514,1835,2468,-633,400689
4732,senior pakistani taliban commander capture afghanistan,pakistan demand protection militant,0.6000000238418579,0.0,19,708,-689,474721
4733,river spanish train crash face question judge,brain driver pain crash question judge,5.0,0.44178491251475327,2261,5572,-3311,10962721
4734,stock close high,singapore stock close low,1.600000023841858,0.4910798154699555,2594,1528,1066,1136356
4735,release initial report cracking impart water,man china detain take girl hotel,0.0,0.0,3,34,-31,961
4736,russia blame syrian rebel chemical attack,russia ask consider inquiry syria chemical arm use,2.5999999046325684,0.24222035176741896,1134,2482,-1348,1817104
4737,philippine rebel reach wealth share deal,philippine rebel reach wealth deal,5.0,0.9451091960136457,5544,5574,-30,900
4738,death toll west things violence rise,urgent death toll china fire rise,1.2000000476837158,0.39677095590566086,1983,1166,817,667489
4739,man contest seat,man contest election seat,4.75,0.8928411190554205,5384,5334,50,2500
4740,trailblaze israel electric car company letter place fold,trailblaze israel electric car company fold,4.400000095367432,0.8730950220176317,5294,5033,261,68121
4741,houston texans head coach mary kubiak hospitalize collapse game,texans coach mary kubiak stable condition collapse,2.799999952316284,0.6674733559259682,3903,2721,1182,1397124
4742,fro oak taliban parlor kill drone strike,taliban commander kill drone strike,4.400000095367432,0.5391676564562079,2949,5037,-2088,4359744
4743,war bomb kill northwest syria,war bomb northern syria kill,4.599999904632568,0.6776388634238468,3973,5307,-1334,1779556
4744,south organ soldier kill man try cross border north,north hut remaining outline south,1.0,0.20018079604847872,985,1031,-46,2116
4745,dead spanish train crash,dead spanish high speed train crash,3.400000095367432,0.7924350119993829,4815,3582,1233,1520289
4746,foreigner sentence death drug smuggling egypt,egypt sentence pakistani amid death drug smuggling,4.199999809265137,0.7253850967605903,4326,4886,-560,313600
4747,french train detail south paris,french train passenger tell crash ordeal,1.2000000476837158,0.34659894378639355,1694,1167,527,277729
4748,spokesman president donald began die,began spokesman carry speaker die,4.199999809265137,0.5947610866194462,3372,4889,-1517,2301289
4749,egypt vote new constitution,egyptians vote division constitution,3.799999952316284,0.5225538559432854,2810,4231,-1421,2019241
4750,drama meet angela family icon remain hospital,drama meet angela family will not visit hospital,2.799999952316284,0.7128444859122427,4243,2665,1578,2490084
4751,weak earning drag stock lower early trade,weak earning drag stock lower street,3.799999952316284,0.8229971569234491,5002,4229,773,597529
4752,fear dead helicopter clash pub,fear dead helicopter pub crash,5.0,0.8544810053067934,5184,5576,-392,153664
4753,siberia lawmaker charge allege bribery,iberian charge accept bribe,3.400000095367432,0.1266349107358176,684,3613,-2929,8579041
4754,super raise vs dollar early trade,super raise dollar early trade,1.7999999523162842,0.861501137005332,5227,1751,3476,12082576
4755,israel teres urge return peace talk,israel teres call return peace talk,5.0,0.9138840993887458,5457,5579,-122,14884
4756,drama set speak syria white house edt,drama deliver statement syria white house,5.0,0.4694713749678373,2447,5580,-3133,9815689
4757,indian stock open low,indian stock close low,1.7999999523162842,0.7854604656978588,4754,1763,2991,8946081
4758,read possible solo action syria,make case action syria,3.400000095367432,0.3445375355434953,1682,3588,-1906,3632836
4759,grief clash police belfast,corner clash police tunisia,1.2000000476837158,0.28719670019123683,1361,1168,193,37249
4760,china quaker death toll rise,china fly death toll rise,1.399999976158142,0.741698164550679,4469,1271,3198,10227204
4761,arrest bangladesh building toll rise,owner arrest bangladesh building toll reach,2.5999999046325684,0.6873349035246312,4044,2502,1542,2377764
4762,condemn use chemical weapon syria,question arise chemical weapon claim syria,2.5999999046325684,0.4221170975544192,2136,2506,-370,136900
4763,strong new quaker hit shatter oak region,powerful new earthquake hit shatter pakistan region,4.800000190734863,0.5635267324160462,3132,5443,-2311,5340721
4764,indian troop kill pakistani soldier kashmir line control,indian troop raid pakistani military post,1.2000000476837158,0.44185483824512983,2262,1170,1092,1192464
4765,hope benedict xvi days goodby cardinal,hope benedict xvi depart vatican time,3.5999999046325684,0.48302682401089836,2528,3760,-1232,1517824
4766,china new carrier extend military modernization drive,chinese vice premier meet australian governor general,1.2000000476837158,0.0,12,1199,-1187,1408969
4767,brazilian leader hold crisis talk street protest,brazil leader promise reform vote,1.600000023841858,0.13387938278200254,714,1555,-841,707281
4768,tropical storm andrew lip coast,tropical storm andrew slide coast,4.0,0.8196249244392588,4983,4456,527,277729
4769,dead indonesia train accident,dead indonesia train collide fuel truck,3.400000095367432,0.4983595153659208,2650,3591,-941,885481
4770,israel advance plan build settlement home,israel unveil plan new settler home,3.799999952316284,0.38139833163533443,1889,4227,-2338,5466244
4771,miss new work win miss america crown,miss new work crown miss america,5.0,0.9530333580991461,5558,5582,-24,576
4772,austrian find harding steal skull home museum,austrian man charge human skull find home,4.400000095367432,0.5628187794916714,3123,5079,-1956,3825936
4773,set drama inauguration,house back new sanction ran inauguration,0.4000000059604645,0.4604226850880653,2374,515,1859,3455881
4774,suspect maude militant die lebanese custody,suspect drone kill militant semen,0.4000000059604645,0.3271418206862582,1574,529,1045,1092025
4775,set fire national,set fire washington national,4.800000190734863,0.7977103006875106,4848,5417,-569,323761
4776,kill attack ran,kill attack ran,2.0,1.0000000000000004,5748,1853,3895,15171025
4777,thousand protest gay marriage,thousand protest gay marriage france,3.200000047683716,0.9064017577387566,5433,3297,2136,4562496
4778,india ink image january,india ink image march,1.0,0.7338643916763901,4411,1038,3373,11377129
4779,capitol lockdown shot fire,watch live capitol lockdown report shot fire,4.800000190734863,0.796864307847321,4842,5412,-570,324900
4780,china st pilot free trade opens,shanghai free trade begin operation,3.799999952316284,0.3082622804124917,1471,4224,-2753,7579009
4781,kill injure bomb blast pakistan,kill injure blast pakista,2.5999999046325684,0.5568636109470968,3084,2461,623,388129
4782,select image bangladesh building collapse,kill bangladesh building collapse,1.399999976158142,0.6622222314122074,3865,1273,2592,6718464
4783,chinese court uphold death penalty belong murderer,court uphold death sentence belong murderer,4.400000095367432,0.8149873509331323,4951,5092,-141,19881
4784,egypt protest disperse,abduction teacher sentence,0.0,0.0,37,2,35,1225
4785,cylinder blast pakistan school bus kill,deadly cylinder pakistan school,3.799999952316284,0.6709460597807879,3927,4222,-295,87025
4786,north organ cargo reveal missile repair trade cuba,n organ ship carry cuba missile seize,2.799999952316284,0.387331952298001,1922,2701,-779,606841
4787,israel force detain palestinians west bank,israel forces arrest palestinians west bank,4.800000190734863,0.6094155794529024,3478,5414,-1936,3748096
4788,protest sweep brazil despite concession,protest plan brazil despite concession,4.0,0.8223323163054277,4999,4441,558,311364
4789,angela jerk win term german election,jerked sins fig germany election,3.799999952316284,0.11167655643464959,607,4221,-3614,13060996
4790,south organ worker start leave joint factory,south organ worker set leave joint factory zone,3.799999952316284,0.7790626344493671,4714,4220,494,244036
4791,senate vote move ahead age nod,benedict come home new house new hope,0.0,0.0,39,3,36,1296
4792,kill score injure suicide come russian train station,suicide bomber kill russian train station,3.200000047683716,0.643243694648131,3735,3237,498,248004
4793,cambodian opposition leader mainly return stir election,cambodia opposition head turn parliament poll bid,3.0,0.1043853686609041,551,2909,-2358,5560164
4794,west nail syria opposition vote join peace talk,syrian opposition delegation talk,2.5999999046325684,0.27449669514678077,1303,2521,-1218,1483524
4795,drama travel tornado ravage oklahoma,drama visit tornado hit oklahoma,4.599999904632568,0.6150209043483951,3523,5283,-1760,3097600
4796,deal fiscal cliff drama go holiday,john boehner humble origin fiscal cliff undo,1.0,0.3219794831749804,1550,1044,506,256036
4797,syria car bomb kill rebel hold town,final car bomb kill egyptian soldier,1.7999999523162842,0.3893748601692032,1934,1744,190,36100
4798,merry b palestinian economic plan work,merry deal nuclear talk ran,0.0,0.2502371425192208,1173,4,1169,1366561
4799,bangladesh building collapse death toll hit,indian building collapse death toll rise,0.800000011920929,0.6561621176209189,3826,780,3046,9278116
4800,dozen dead central african republic fighting,dead central african republic clash,3.400000095367432,0.7252741583768606,4325,3551,774,599076
4801,tibia threaten army action oil protest,comb threat force evacuation princeton,0.800000011920929,0.0,62,782,-720,518400
4802,turkish union strike monday protest police violence,turkey unrest union strike police crackdown,3.400000095367432,0.3732026233385607,1833,3570,-1737,3017169
4803,wicker pitch upgrade greek credit rating,moody upgrade greek credit rating,3.400000095367432,0.6779677230484065,3978,3674,304,92416
4804,lumen ambush police boat siberia oil region,sudanese police block protest human right commission,0.0,0.07711414329626189,443,5,438,191844
4805,russians leave syria cross lebanon,russia deliver humanitarian aid syrian refugee lebanon,2.200000047683716,0.18973359441976986,946,2020,-1074,1153476
4806,soldier kill insider attack afghanistan,soldier kill bomb attack pakistan,0.800000011920929,0.486627304990484,2550,785,1765,3115225
4807,south african icon elson angela hospitalize,south africa elson angela hospitalize,5.0,0.6779674794610758,3977,5635,-1658,2748964
4808,hope francis condemn global indifference suffer,hope francis commemorate dead emigrant lampedusa,1.399999976158142,0.29779661681523834,1415,1274,141,19881
4809,judge mansour swear egypt interim president,justice idly mansour swear egypt interim president,4.400000095367432,0.7237246914271481,4316,5077,-761,579121
4810,kill young girl eastern afghanistan,kill southern afghanistan official,2.799999952316284,0.3521751574786838,1722,2656,-934,872356
4811,demyan police arrest key ll shabaab recruit financier,sonya hair arrest anti terror police,3.200000047683716,0.16609569595866894,847,3243,-2396,5740816
4812,drama announce gun control plan wednesday,drama set gun control plan,3.5999999046325684,0.7281867620219409,4345,3787,558,311364
4813,bomb kill people wound dozen boston marathon,bomb find boston marathon attack,2.200000047683716,0.6535850534462907,3805,2034,1771,3136441
4814,syria chemical weapon end sea,destroy syria chemical weapon stockpile sea,2.400000095367432,0.6477522368800406,3769,2178,1591,2531281
4815,president early conclusion co partnership ri vanka,pakistan deep economic tie ri vanka,2.5999999046325684,0.3807011671441464,1887,2401,-514,264196
4816,free centre abuse probe,story building collapse bute beta,0.0,0.0,71,7,64,4096
4817,comb explode greek shopping mall people injure,comb explode athens shopping mall wound,4.400000095367432,0.6658598553000141,3893,5112,-1219,1485961
4818,australians kill plane crash,dozen kill plane crash,3.0,0.5789615645898513,3238,2821,417,173889
4819,dead include german maryland mall shooting,dead maryland mall shooting,4.199999809265137,0.8490511090646197,5157,4722,435,189225
4820,confirm satin syria attack,war crime find satin syria chemical weapon attack,3.400000095367432,0.5775241404298845,3230,3488,-258,66564
4821,kill monster truck crash,kill mexico monster truck crash,3.200000047683716,0.8791130920482555,5320,3316,2004,4016016
4822,jerked lies rd term office germany elections,jerked sins fig germany election,3.25,0.3412943288503073,1662,3387,-1725,2975625
4823,x virginia governor mob mcdonnell charge corruption,virginia ex sov mob mcdonnell wife charge corruption,3.799999952316284,0.7251759662393569,4323,4214,109,11881
4824,printer son sofa lowell test positive banner substance,sprinter son test positive banner substance,3.400000095367432,0.6782508824501056,3981,3479,502,252004
4825,magnitude quaker hit honshu japan cenc,quaker bolt santa cruz islands cenc,1.7999999523162842,0.3197657930225765,1536,1758,-222,49284
4826,pakistan release senior afghan taliban prisoner,pakistan release senior taliban commander saturday,3.799999952316284,0.6295293744768431,3625,4213,-588,345744
4827,egypt court order release mubarak,egypt court order mubarak free,5.0,0.7983446558980845,4854,5637,-783,613089
4828,american investigator wait question arrest boston bomber,police converge street search boston bomb suspect,1.7999999523162842,0.14047162005312605,739,1750,-1011,1022121
4829,dead injure china road accident,dead injure e china road accident,1.75,1.0,5702,1623,4079,16638241
4830,bollywood cut cost rule collapse bite,bollywood cut cost rule crisis bite,4.199999809265137,0.8556478135289429,5196,4705,491,241081
4831,woman face high car insurance premium,woman driver face insurance premium rise,5.0,0.7096930200921312,4217,5638,-1421,2019241
4832,tornado rip widest kill devastating neighborhood,tornado damaging storm hit widest kill,3.200000047683716,0.4315045887611551,2195,3321,-1126,1267876
4833,china give regulatory access audit record,china oppose arm sale taiwan,0.800000011920929,0.0982115709246377,520,766,-246,60516
4834,singapore stock end percent,singapore stock end,2.0,0.9073826251227812,5436,1803,3633,13198689
4835,ran atomic agency talk rowhani election,iaea ran hold nuclear talk rohans election,4.800000190734863,0.29279763664238323,1381,5468,-4087,16703569
4836,china new reject hack claim,china premier reject groundless hack accusation,5.0,0.5118582469640806,2743,5640,-2897,8392609
4837,dzhokhar tsarnaev plead guilty boston come charge,dzhokhar tsarnaev charge boston marathon come,2.5999999046325684,0.7702358972386963,4656,2407,2249,5058001
4838,picture day august,picture,2.799999952316284,0.6019007192577766,3417,2717,700,490000
4839,chinese general son get year jail rape,chinese army singer get year jail gang rape,3.400000095367432,0.560645064096527,3104,3605,-501,251001
4840,police seek driver crash kill child,police seek luman new orleans parade shooting,0.0,0.24972553081793225,1169,8,1161,1347921
4841,egypt hold presidential election parliamentary poll,egypt interim president swear new cabinet,1.399999976158142,0.12374102215347296,671,1288,-617,380689
4842,pentagon adjust plan intense attack syria,hope thank public join syria vigil,1.0,0.07329666295891872,434,1051,-617,380689
4843,simon bank martial art club amid kill,simon dans partial arts schools amid willing,5.0,0.2597695425215101,1227,5644,-4417,19509889
4844,afghan legislator approve new election law,afghan president approve new election law,2.5999999046325684,0.779136736136256,4715,2437,2278,5189284
4845,pakistan army adamant fight taliban,oak army adamant fight taleban,4.800000190734863,0.5955695278325419,3381,5477,-2096,4393216
4846,egyptian army push attack kidnap,egypt dorsi rule talk hostage video appear,1.399999976158142,0.0,56,1278,-1222,1493284
4847,south africans mourn angela bury,south africa hold state funeral angela,2.799999952316284,0.2701281670687113,1282,2720,-1438,2067844
4848,witness hear loud boot boston marathon,report explosion finish line boston marathon,3.0,0.3254068887222189,1567,2847,-1280,1638400
4849,cryptic crossword saturday april,ruin crossword saturday april,2.799999952316284,0.7247051333637287,4321,2723,1598,2553604
4850,costa concordia captain try manslaughter,costa concordia survivor detail experience year later,1.2000000476837158,0.42108721091557955,2131,1211,920,846400
4851,israel minister laws merry boycott warning,israel minister slum merry boycott warning,4.599999904632568,0.7656411464769268,4636,5285,-649,421201
4852,angelina police aunt die breast cancer,angelina police complex truth breast cancer,2.799999952316284,0.6450994011220256,3750,2712,1038,1077444
4853,myanmar urge party unity amid squabble,urge party unity amid squabble,5.0,0.9267100702069814,5500,5645,-145,21025
4854,thing wednesday,thing today,3.0,0.5387565794245526,2944,2859,85,7225
4855,white house defense contractor discuss harm automatic spending cut,white house defense firm discuss automatic spending cut,4.400000095367432,0.7403229213124369,4459,5060,-601,361201
4856,venezuela hugo die cancer,venezuelan president hugo die cancer,3.799999952316284,0.6774140265662588,3972,4237,-265,70225
4857,zambian president arrest,labia ex president rupia arrest,4.0,0.282685876678034,1339,4498,-3159,9979281
4858,senate confirm ellen red chair,senate confirm janet ellen new central bank chief,4.199999809265137,0.5253325515986264,2827,4779,-1952,3810304
4859,palestinian prisoner release israel prison,palestinian prisoner die cancer unrest israel jail,1.0,0.4559668008395562,2344,1054,1290,1664100
4860,sign share rally string beat datum,sign markets strong sobs data,4.0,0.10907550700192223,586,4500,-3914,15319396
4861,kill wound bomb attack northern ran,kill wound fresh attack ran,2.799999952316284,0.6128611900748249,3512,2708,804,646416
4862,officer injure india anti rape protest die,indian policeman injure gang rape protest die,4.199999809265137,0.5293376314441999,2855,4782,-1927,3713329
4863,typhus ballot remark alarm market,typhus ballot usual neuro nonsense,2.5999999046325684,0.37676750254244507,1861,2522,-661,436921
4864,action james diana ojukwu apga national leader,diana ojukwu apga national leader,4.199999809265137,0.8903745116698851,5365,4783,582,338724
4865,conclusively determine chemical weapons use syria,see conclusive evidence chemical arms use syria,4.800000190734863,0.3204624988207715,1542,5453,-3911,15295921
4866,kill luman raid village,kill lasts india,0.2000000029802322,0.10544201267034725,556,394,162,26244
4867,egypt shut slim brotherhood newspaper,egypt slim brotherhood deputy head arrest,1.399999976158142,0.5068924608076789,2704,1279,1425,2030625
4868,strong earthquake western china kill people,strong earthquake western china kill,3.0,0.940726696868257,5532,2865,2667,7112889
4869,dowden thank russia asylum,dowden thank russia grant asylum,5.0,0.8850884992152682,5346,5648,-302,91204
4870,senate confirm ellen red head,senate confirm ellen red chair,4.199999809265137,0.8176981561980856,4973,4791,182,33124
4871,french force key ali town,french force seize key town,3.799999952316284,0.7629714453352864,4618,4174,444,197136
4872,boston come suspect bury virginia,boston bomb suspect bury virginia cemetery,5.0,0.7440186319893718,4490,5649,-1159,1343281
4873,large extremely dangerous tornado head oklahoma city,tom baby kill torpedo rake oklahoma city area,1.600000023841858,0.25056183468032683,1176,1583,-407,165649
4874,postage drama drag alabama school bus shooting,nevada dead hurt middle school shooting,0.800000011920929,0.2566212162367395,1207,761,446,198916
4875,palestinian president assign academic form west bank,palestinian president want israelis talk peace,1.7999999523162842,0.21654663900914406,1034,1735,-701,491401
4876,pakistan balaga leave hospital await surgery,balaga leave british hospital,3.5999999046325684,0.6252526402278031,3596,3785,-189,35721
4877,find dead swim pool essex hotel,woman find dead essex hotel swimming pool,4.0,0.7867855970573938,4766,4517,249,62001
4878,pakistan condemn drone strike shawl area,pakistan condemn drone strike miranshah,3.200000047683716,0.5779512381249939,3231,3123,108,11664
4879,resident return texas blast site,resident return fallujah,0.0,0.4955934561713027,2631,18,2613,6827769
4880,south africa ray elson angela,south africa unite prayer song elson angela,4.199999809265137,0.5514199889467274,3046,4741,-1695,2873025
4881,ran ahmadinejad face charge election appearance aide,ahmadinejad face charge election appearance,4.199999809265137,0.8552185723966133,5192,4742,450,202500
4882,miliband pledge strengthen minimum wage,portugal china strengthen scientific research tie,0.0,0.18170569978397164,918,19,899,808201
4883,singapore stock close low,singapore stock close high,2.5999999046325684,0.7440917802780757,4492,2474,2018,4072324
4884,dnieper wait result appeal,new glory china strive renewal,0.0,0.0,45,20,25,625
4885,apple share hit hard shone disappointment,apple stock plunge earning disappointment,3.200000047683716,0.43321019223435797,2205,3091,-886,784996
4886,renew sanction zimbabwe,lift diamond sanction zimbabwe,3.0,0.534634408052588,2912,2824,88,7744
4887,occupy palestinian territory palestinians rebuff peace talk blueprint,occupy palestinian territory palestinians face route,1.399999976158142,0.570195192335869,3182,1285,1897,3598609
4888,owner charge bangladesh factory fire,survivor find bangladesh factory,1.7999999523162842,0.5302003114296234,2861,1741,1120,1254400
4889,egypt set lure gulf investor,egypt seek lure investor,3.400000095367432,0.7300669948890478,4365,3535,830,688900
4890,russia reach agreement syria,russia reach agreement syria weapon,3.400000095367432,0.8997771167176893,5410,3499,1911,3651921
4891,palestinians jordan coordinate stance peace talk,james senior deny papa coordinate peace talk,1.7999999523162842,0.43661587704782034,2225,1663,562,315844
4892,note cancel province tense election,cambodian opposition reject run men election win,0.0,0.10907864522299276,587,21,566,320356
4893,drama cancer moscow meeting ruin,drama cancel meeting ruin,4.0,0.5903182440203427,3327,4474,-1147,1315609
4894,klci sutures trade mix mid day,share mix mid day,3.5999999046325684,0.5772184891216652,3228,3793,-565,319225
4895,suspect drone strike kill pakistan,drone strike kill pakistan,2.799999952316284,0.8748064357478162,5301,2674,2627,6901129
4896,egypt court order mubarak release,egypt court turn mubarak release request,2.0,0.6741235432482243,3942,1873,2069,4280761
4897,holland threaten legal action affair allegation,françois holland threaten legal action affair claim,4.0,0.745447894537952,4498,4482,16,256
4898,cranial exile report death ran camp,cranial exile kill ran camp sheaf,3.0,0.7071489672342809,4190,2839,1351,1825201
4899,blade gunner histories dispute murder charge,history cop seven attempt murder charge,2.0,0.2087028354066394,1013,1813,-800,640000
4900,israel force detain neuron arrest raid,israel credibility line ran nuclear challenge,2.25,0.0964636677629554,512,2156,-1644,2702736
4901,egyptians vote islamist back constitution,judge poll direct voter egypt constitution vote,1.399999976158142,0.34305418239777746,1673,1286,387,149769
4902,mexico swear president amid violent protest,new mexico sov richardson press north organ test ban,0.0,0.14999754574022306,784,26,758,574564
4903,helicopter clash near rail station london,helicopter clash london,4.0,0.6829901499609372,4010,4490,-480,230400
4904,indonesian capital ray retro ease traffic chaos,makarka ray retro ease traffic chaos,3.799999952316284,0.7752364315919407,4687,4135,552,304704
4905,japanese plane fly china new defense zone,japan s organ military plane defy china new defence zone,4.0,0.44154560629518,2258,4491,-2233,4986289
4906,typhoon survivor raid philippine store,typhoon alpha kill philippines,1.2000000476837158,0.2709007010444687,1287,1231,56,3136
4907,war comb wound hezbollah stronghold lebanon,war bomb rock hezbollah stronghold lebanon,3.200000047683716,0.7152239393155699,4257,3093,1164,1354896
4908,urge syrian opposition assist immediate release foreigner capture syria,s opposition candidate close poll gap,0.6000000238418579,0.11922620681894787,644,695,-51,2601
4909,dead miss canada train disaster,dead miss china landslide,0.6000000238418579,0.3662648102730244,1788,696,1092,1192464
4910,senate confirm janet ellen federal reserve chief,senate confirm janet ellen federal reserve hair,4.599999904632568,0.8828254926403483,5335,5286,49,2401
4911,say name new pakistani taliban leader hakimullah mehsud kill drone strike,pakistani taliban chief hakimullah mehsud kill drone strike,3.400000095367432,0.861539468894064,5228,3567,1661,2758921
4912,kill comb lasts ran,kill baquba last,2.200000047683716,0.12100313394520473,651,2001,-1350,1822500
4913,russia destroy chemical weapons stockpile,britain see evidence sad use chemical weapons,1.0,0.35098132204981614,1717,1020,697,485809
4914,ran earthquake death toll rise,algeria hostage death toll rise,0.6000000238418579,0.4862496012793015,2546,670,1876,3519376
4915,suarez set comeback,french set ali ground combat,0.800000011920929,0.16222777154182702,826,820,6,36
4916,maldive team india observe election,testimony trial iberian begin,0.6000000238418579,0.0,155,669,-514,264196
4917,death toll rise storm waver matter northern europe,storm death toll rise wind rain matter north europe,3.200000047683716,0.6233882471342138,3581,3189,392,153664
4918,pakistan release afghan taliban prisoner,pakistan release seven afghan taliban fighter,3.5999999046325684,0.6481611803994426,3770,3755,15,225
4919,fix reaction sex marriage,new zealand legalize sex marriage,2.200000047683716,0.3944923854011033,1966,2070,-104,10816
4920,weatherman red ballot arrest sex claim,weatherman red ballot hold ex abuse,3.799999952316284,0.5700869328171987,3180,4131,-951,904401
4921,drone strike kill pakistan,pakistan drone strike kill,3.0,1.0,5652,2911,2741,7513081
4922,building collapse india fear wrap,india building collapse kill dozen wrap,3.0,0.7401972763490743,4457,2915,1542,2377764
4923,somalia shebab claim responsibility nairobi mall attack,syrian rebel claim responsibility kill lebanon,1.2000000476837158,0.32867478868418426,1587,1234,353,124609
4924,syrian troop push strategic rebelheld town,syrian army push assault rebel hold town,4.0,0.43163415355992474,2197,4354,-2157,4652649
4925,israel agree release palestinian prisoner,israel release palestinian prisoner,2.799999952316284,0.877956605127297,5314,2671,2643,6985449
4926,dozen die clash erupt dorsi rally cairo,dead clash dorsi ally egypt,3.5999999046325684,0.3224968657415559,1553,3758,-2205,4862025
4927,opposition protest begin bangkok shutdown,protest launch bangkok shutdown,4.800000190734863,0.7177006802246049,4278,5351,-1073,1151329
4928,spanish train crash driver question,spanish train driver pardon question judge,3.799999952316284,0.6976802735117088,4117,4128,-11,121
4929,france nails breakthrough real syria weapons,france welcomes russia real syria,4.0,0.40954074377614097,2064,4365,-2301,5294601
4930,isaf soldier kill afghan insider attack,british soldier shoot dead afghan insider attack,4.0,0.6051821397956455,3444,4346,-902,813604
4931,rush death ivory coast stampede,dead ivory coast stampede,3.400000095367432,0.814471607067858,4947,3586,1361,1852321
4932,glasgow helicopter crash search end,glasgow helicopter crash head,2.799999952316284,0.728526371063493,4349,2686,1663,2765569
4933,dead marathon bomb,taliban deny involvement boston marathon come,1.2000000476837158,0.30096568146727776,1432,1235,197,38809
4934,swiss tourist gang rapid india,swiss tourist gang rapid india,5.0,1.0,5653,5650,3,9
4935,india trace passive cyclone,india issue red alert cycle hamlin,2.799999952316284,0.11919721548332768,643,2663,-2020,4080400
4936,discipline student german thought spare colorado shooting,discipline student think key motive,3.400000095367432,0.3749398324170481,1846,3604,-1758,3090564
4937,kill japan road tunnel collapse,kill syrian air strike,1.2000000476837158,0.10847692439461262,578,1236,-658,432964
4938,plan shut petrol pump night oily,india get reject proposal shut petrol pump night,3.799999952316284,0.6594557414206872,3848,4126,-278,77284
4939,clinton testify month benghazi attack,clinton return work plan testify benghazi attack,3.799999952316284,0.7536387665388935,4551,4139,412,169744
4940,ten thousand ukrainian protest iv,ten thousand line cast vote human,0.6000000238418579,0.21078120464482455,1017,664,353,124609
4941,karzai visit pakistan taliban peace talk,afghan president extend visit pakistan taliban talk,3.5999999046325684,0.5286948248831403,2849,3776,-927,859329
4942,thief snatch english channel swimmer custom wheelchair,thief steal channel swimmer wheelchair,4.0,0.6940565793177716,4093,4409,-316,99856
4943,die car crash,kill crash tiananmen square,4.599999904632568,0.2493083539295696,1167,5308,-4141,17147881
4944,singapore share open lower friday,singapore share open higher thursday,2.200000047683716,0.5213428352948533,2803,2088,715,511225
4945,drama pledge reign economy,drama press congress act economy,2.5999999046325684,0.3777436655785974,1870,2452,-582,338724
4946,earthquake northwest china head,win quaker kill china,2.400000095367432,0.17130616090339187,877,2246,-1369,1874161
4947,white ulcer give consecutive life term,white ulcer get life racketeering kill,3.200000047683716,0.5640836183683186,3134,3201,-67,4489
4948,demyan force cause mall collapse,official say demyan force cause mall collapse,5.0,0.9193456737764775,5480,5651,-171,29241
4949,oak mission uae gear election,islamist party egypt unite election,1.399999976158142,0.11997158672693009,647,1281,-634,401956
4950,bangladesh building disaster death toll pass,bangladesh building collapse death toll limb,3.0,0.589645031207956,3322,2763,559,312481
4951,algeria hostage crisis end death toll unclear,algeria hostage crisis end bloodbath,3.799999952316284,0.6444914504911416,3745,4123,-378,142884
4952,egypt ministry urge end pro dorsi protest,egypt child kill cairo clash pro dorsi protest,2.799999952316284,0.5511238545321104,3042,2732,310,96100
4953,south africa angela take hospital,south africa angela remain hospital,3.200000047683716,0.8788311411253037,5319,3195,2124,4511376
4954,china juan strengthen usd,china juan strengthen new high usd,3.0,0.8870146884843229,5351,2760,2591,6713281
4955,police question man deadly boardwalk crash,police arrest suspect deadly drive attack,2.200000047683716,0.3507703611472843,1715,2098,-383,146689
4956,turkish riot police tear gas maksim square protest,turkish riot police enter maksim square,3.0,0.766521634086657,4640,2759,1881,3538161
4957,chicago shooting show cap step noticing,chicago shooting show gap step policy,5.0,0.5215659717028895,2806,5652,-2846,8099716
4958,bed require car car safety communication,guatemala overturn dictator genocide conviction,0.0,0.0,258,109,149,22201
4959,north shut offer talk,north shoot ricket,1.2000000476837158,0.2184391956161366,1041,1244,-203,41209
4960,prince charles compare ruin,prince charles compare vladimir ruin wolf,5.0,0.796146152154406,4836,5653,-817,667489
4961,ran warn military intervention ran,explosion near damascus military airport,0.0,0.1412079506377226,742,112,630,396900
4962,israel accuse ran president hypocrisy,greek accuse coalition hypocrisy,1.2000000476837158,0.5772010661175208,3227,1238,1989,3956121
4963,police clash youth cairo anti dorsi protest,egypt police clash pro dorsi protest,2.799999952316284,0.5177392697416039,2773,2682,91,8281
4964,diplomats feet munich critical time,diplomats discuss ran nuclear program,2.400000095367432,0.2920076052463032,1380,2231,-851,724201
4965,dowden give refugee document ecuador,dowden pose fly moscow,1.2000000476837158,0.2581371822707779,1216,1240,-24,576
4966,message world dress freedom,pakistan mark world dress freedom,2.200000047683716,0.6634081026780986,3877,2081,1796,3225616
4967,foreign minister discuss syria arm embargo,foreign minister seek solution syria arm,3.5999999046325684,0.5330532543726808,2898,3770,-872,760384
4968,death toll philippine earthquake rise,death toll philippines quaker rise,3.5999999046325684,0.4964222078992405,2638,3804,-1166,1359556
4969,stock watch close monday,stock watch monday,4.0,0.890934107639752,5373,4371,1002,1004004
4970,army jet kill militant pakistan air maid,drone kill militant pakistan,3.200000047683716,0.45558089563107934,2342,3147,-805,648025
4971,egyptian police fire tear gas protest cairo,police fire tear gas protest cairo,4.0,0.9030329558628987,5419,4399,1020,1040400
4972,philippines hold second senator corruption,philippine recover powerful typhoid,1.399999976158142,0.0,265,1313,-1048,1098304
4973,german envoy optimistic ran talk,ran cautiously optimistic future nuclear talk,1.399999976158142,0.501115971832438,2665,1360,1305,1703025
4974,renowned spanish flamenco guitarist face lucia die,spanish flamenco guitarist face de lucia die,4.599999904632568,0.8936713260027489,5387,5288,99,9801
4975,chinese icebreaker change course suspicious object,chinese search plane find suspicious object,2.0,0.5909782753068745,3334,1784,1550,2402500
4976,dowden bundle search asylum,dowden hit bundle search asylum,5.0,0.9372967148562921,5524,5632,-108,11664
4977,death toll building collapse south india mount,kill building collapse southern india,2.799999952316284,0.49790902502415624,2648,2729,-81,6561
4978,pakistan impose temporary ban channel,pakistan dismissed case fbi agent,1.399999976158142,0.10788934597763229,576,1318,-742,550564
4979,palestinian prisoner arrive muqata ramallah,pakistani prisoner assault mamma jail,1.0,0.1558071774274929,800,1070,-270,72900
4980,dead injure china road accident,hurt papa city car accident,1.0,0.2360656211101844,1110,1073,37,1369
4981,mass security force smother bangkok protest,security force stay barrack protest dwindle,1.7999999523162842,0.2952405125663149,1403,1709,-306,93636
4982,refuse resign gaze comment,spanish refuse resign corruption scandal,0.2000000029802322,0.4493706961743915,2300,375,1925,3705625
4983,explosion kill outside mosque lebanon tripoli,explosion rock city northern lebanon,2.0,0.3980809707258749,1990,1806,184,33856
4984,pakistan fighter jet bomb taliban hideous,pakistan want arm supply syrian side stop,1.600000023841858,0.10830349033956774,577,1558,-981,962361
4985,lumen right second sonya attack,luman second sonya attack,3.0,0.6049965211660098,3441,2780,661,436921
4986,resume search miss british sailor public,coast guard suspend search miss british sailor,2.400000095367432,0.6120504588118638,3507,2238,1269,1610361
4987,iraqi comb attacks,iraqi war comb dear church hills,3.0,0.45228242108374117,2318,2785,-467,218089
4988,egypt force set block access dorsi protest camp,egyptian force clear pro dorsi protest camp,2.400000095367432,0.4804096563487771,2516,2240,276,76176
4989,noble author boris passing die,noble laureate boris passing die,5.0,0.7431629421946847,4481,5631,-1150,1322500
4990,japan opposition party chief criticize economic policy,opposition mdc party challenge robert election win,0.0,0.2336397215456933,1103,119,984,968256
4991,suspect take custody boston coming case,boston police take custody marathon come,4.800000190734863,0.47264396403701503,2463,5344,-2881,8300161
4992,ukraine opposition chief want protest,ukraine protest couple vein statue,2.400000095367432,0.31360967675409046,1501,2241,-740,547600
4993,queen pay tribute elson angela,south africa rugby fraternity mourn angela,1.0,0.1218756108718151,655,1016,-361,130321
4994,decline stock market moderate,lech sell send sign stock market low,0.4000000059604645,0.2805711157702677,1331,521,810,656100
4995,late anti slim violence bursa hills injury,world grieving asia myanmar deadly anti slim violence flare,2.5999999046325684,0.3286080987406841,1586,2503,-917,840889
4996,suspect drone strike kill pakistan,drone strike kill pakistan,3.799999952316284,0.8748064357478162,5302,4113,1189,1413721
4997,note heads friday,note heads tuesday october,2.0,0.6388910280663935,3705,1808,1897,3598609
4998,kill accident southwestern china,kill dozen injure blast southwest pakistan,0.6000000238418579,0.0899699620487293,484,716,-232,53824
4999,nypd twitter outreach backfires badly,nypd twitter campaign backfire,4.800000190734863,0.45564469684876446,2343,5346,-3003,9018009
5000,turkish search end miss miner find,turkish search ends kissing miners round,5.0,0.30297235926026195,1439,5611,-4172,17405584
5001,ran predict failure israel palestinian peace talk,tentative real reach resume israel palestinian talks,1.399999976158142,0.18693271817387755,938,1350,-412,169744
5002,livid woman win second bafta ward,matas livid woman pick award,4.400000095367432,0.2985178119263697,1419,5087,-3668,13454224
5003,titanic violin cabs record million,titanic violin cell million,3.799999952316284,0.667854979625421,3906,4112,-206,42436
5004,ankeet haven grant conditional bail marriage,ankeet haven grant bail marry,5.0,0.7323674392943368,4393,5612,-1219,1485961
5005,jal order virus blow,japan airline order virus value,3.0,0.40489039047075204,2039,2790,-751,564001
5006,vienna miller testify phone hack trial,vienna miller attack press report hack trial,3.0,0.6786573009728402,3985,2791,1194,1425636
5007,israelis attack palestinians jerusalem area,settler seat palestinian jerusalem,2.5999999046325684,0.2875232650123298,1364,2378,-1014,1028196
5008,extend sanction russia,siberia drop arm trafficking charge russian sailor,0.4000000059604645,0.0,240,539,-299,89401
5009,cuba see major role foreign investment,house set vote plan open government,0.0,0.0,241,123,118,13924
5010,star tory monteith find dead hotel room,tory monteith find dead canadian star,3.400000095367432,0.74926514272489,4521,3457,1064,1132096
5011,lebanon form unity cabinet lebanon prime minister form cabinet month take office take wide range political group bridge division,beirut lebanon prime minister form cabinet month take office yesterday include wide range political group bridge division,4.599999904632568,0.8357338220547356,5080,5290,-210,44100
5012,cranial president make debut world stage,ran presidential candidate say western sanction break,0.6000000238418579,0.0,242,675,-433,187489
5013,cameron concern hall meat,veteran health probe confirm cover care delay,0.0,0.0,243,126,117,13689
5014,world old man die,world old man die aged,4.599999904632568,0.7746133319713786,4683,5291,-608,369664
5015,slow recall congress record show,mobile world congress future smartphone,0.0,0.18857468158530427,941,127,814,662596
5016,death toll lebanon coming rise,suspect arrest lebanon car coming kill,2.799999952316284,0.4936021552374242,2613,2742,-129,16641
5017,greek far right leader imprison pende trial,greek war right leader imprisoned sending trial,5.0,0.43121842618672496,2193,5613,-3420,11696400
5018,bangladesh factory owner arrest death toll year,bangladesh factory owner arrest,3.200000047683716,0.832226823038834,5063,3158,1905,3629025
5019,egyptian soldier kill final ambush,egyptian soldier kill final car come,3.200000047683716,0.6750189715098902,3952,3160,792,627264
5020,seizing aircraft barrier return south china tea,china send carrier south china tea,2.400000095367432,0.4143590008035175,2095,2292,-197,38809
5021,egypt court hear case mubarak islamists,egypt court temporarily release mubarak illicit gain,1.7999999523162842,0.3894179898896248,1935,1673,262,68644
5022,moscow crimea success lead draw ukraine eastern border,jerk russian action lead catastrophe,2.5999999046325684,0.12236322423069662,660,2382,-1722,2965284
5023,elson angela die aged,elson angela lie age,5.0,0.47478278085224945,2482,5614,-3132,9809424
5024,belgian king albert step favor son,belgium king albert abdicate,4.199999809265137,0.3924313161500147,1951,4764,-2813,7912969
5025,gaze gestapo chief bury jewish cemetery,gaze chief bury jewish cemetery,4.800000190734863,0.8780367690889257,5315,5398,-83,6889
5026,swiss vote high minimum wage,swiss cast ballot world high minimum wage,4.599999904632568,0.7313493674558094,4383,5293,-910,828100
5027,mud swear australian prime minister,mud swear australia new crime minister,5.0,0.5726030898550774,3201,5616,-2415,5832225
5028,donet region protesters retain trunks carry government pocket domo,say protest leader anti government riot grow,0.800000011920929,0.07291816073083913,432,803,-371,137641
5029,easy wide star aren black die age,easy wide actress aren black lies cancer,4.199999809265137,0.5887843538678557,3310,4737,-1427,2036329
5030,coronation street coach arrest,coronation street star hail amazing new set,1.2000000476837158,0.4183233156311581,2118,1241,877,769129
5031,red box beat tiger reach world series,red box beat tigers advance world series,4.400000095367432,0.6544348547176695,3815,4976,-1161,1347921
5032,head china earthquake,dead china earthquake,2.799999952316284,0.6822937956115441,4006,2694,1312,1721344
5033,news business,new come,0.2000000029802322,0.0,272,435,-163,26569
5034,glasgow helicopter death toll rise,earthquake death toll rise,0.6000000238418579,0.5556389818650108,3074,687,2387,5697769
5035,david beckham retire end season,david beckham retires football,4.400000095367432,0.44450847384478265,2279,4979,-2700,7290000
5036,afghanistan suicide bomber kill military bus blast,roadside bomb kill afghan soldier,3.799999952316284,0.07621332942393735,441,4170,-3729,13905441
5037,nail execution powerful uncle,north see packing powerful uncle,4.599999904632568,0.5459288921782018,2999,5306,-2307,5322249
5038,myanmar work investment protection agreement,china long investment destination poll,1.399999976158142,0.22946259557537363,1085,1353,-268,71824
5039,tehelka editor embroil sex assault scar,tehelka editor step allegation sexual misconduct,4.199999809265137,0.38516982053491056,1907,4752,-2845,8094025
5040,iron lady margaret thatched die,british margaret thatched die,4.599999904632568,0.7012689271254028,4142,5294,-1152,1327104
5041,dorsi supporter kill egypt clash,thousand dorsi supporter gather egypt,2.200000047683716,0.6300855281514433,3629,2120,1509,2277081
5042,condemn ethnic killing south sudan oil town,condemn ethnic willings south sudan,4.599999904632568,0.6230715352944324,3580,5295,-1715,2941225
5043,bed drop morning pill appeal,allow morning pill girl age,2.5999999046325684,0.4860454629084344,2545,2422,123,15129
5044,police fire tear gas protest bangkok,police fire tear gas protest,3.0,0.8409261512219156,5106,3062,2044,4177936
5045,shooting protest vote,protest disrupt advance voting,3.5999999046325684,0.18056808741372685,915,3803,-2888,8340544
5046,china stock index future close low april,china stock index future close high,2.200000047683716,0.7424683267674899,4475,2090,2385,5688225
5047,filipinos slay semen attack,syrian soldier kill bomb attack,0.800000011920929,0.1337832787562453,713,798,-85,7225
5048,israel end airstrike case palestinians critical,israel gunboat fire palestinian fisherman,1.399999976158142,0.10494114642189072,554,1354,-800,640000
5049,protester couple vein statue kiev,ukraine protest couple vein statue kiev,4.400000095367432,0.7868386969678072,4768,5005,-237,56169
5050,ran thwart nuclear sabotage attempt,ran say defect sabotage nuclear facility,3.5999999046325684,0.4957866434955389,2634,3794,-1160,1345600
5051,china juan strengthen usd tuesday,china juan strengthen usd monday,3.200000047683716,0.8395664992476523,5104,3144,1960,3841600
5052,protester gather brazil despite concession,protest continue ukraine despite concession,1.2000000476837158,0.4672430191308537,2431,1226,1205,1452025
5053,queen visit london soldier attack scene,queen elizabeth visit barrack soldier slay week,4.199999809265137,0.3996767446488724,2001,4758,-2757,7601049
5054,india china troop retreat de facto border face deal,india say china agree retreat de facto border faceoff deal,4.199999809265137,0.7166416864698235,4269,4761,-492,242064
5055,relief boston second suspect capture,police confirm suspect capture,2.400000095367432,0.46572633878263164,2411,2284,127,16129
5056,syrian army retake crusade castle rebel,syrian army retake historic crusade castle,4.599999904632568,0.8578226154876857,5208,5296,-88,7744
5057,maude lebanese army billion,maude arabia grant lebanese army billion,5.0,0.7918326503859293,4812,5618,-806,649636
5058,red cross worker release ukraine,red cross member kidnap syria,0.800000011920929,0.3836445121787623,1903,795,1108,1227664
5059,syria envoy say peace talk opposition,syria cameron drama west close intervention,0.6000000238418579,0.10086982483249415,533,679,-146,21316
5060,queen big carrier,queen name giant aircraft carrier,4.199999809265137,0.6268032602730939,3609,4735,-1126,1267876
5061,angle militant escape prison van bomb ambush,bangladesh prison van amuse,3.400000095367432,0.33617988163721974,1635,3502,-1867,3485689
5062,wreckage air algerie plane carry people find ali,wreckage airalgerie flight find ali,3.400000095367432,0.40325944385868084,2026,3503,-1477,2181529
5063,influential palestinians week democratic state,arab league back palestinian stance peace talks,0.6000000238418579,0.0,289,686,-397,157609
5064,dozen kill russian plane crash,man kill alaska plane crash,1.399999976158142,0.5142774270491645,2755,1355,1400,1960000
5065,retainer agree bangladesh plant safety,retainer agree new bangladesh factory safety,4.0,0.7777224215019255,4708,4553,155,24025
5066,government shutdown begin live update,government shutdown begin health head,3.200000047683716,0.5873155799059117,3301,3197,104,10816
5067,suicide bomber kill afghanistan,suicide blast kill afghan capital,3.0,0.34959714679303583,1707,2963,-1256,1577536
5068,china launch probe rover moon,china launch moon rover mission,4.0,0.7852100699434691,4752,4557,195,38025
5069,eye trip,finance talks b,1.7999999523162842,0.0,276,1632,-1356,1838736
5070,australia cut rate record low,australia cut interest rate record low,3.799999952316284,1.0000000000000002,5737,4167,1570,2464900
5071,chinese news agency laws relays search met,men chinese vessel stand jet search,3.200000047683716,0.2612681252667963,1232,3200,-1968,3873024
5072,classic crossword saturday st june,classic crossword saturday april,1.600000023841858,0.714925871692792,4253,1566,2687,7219969
5073,n test fire short range missile,fire short range missile,3.400000095367432,0.8813122872095301,5330,3500,1830,3348900
5074,palestinian diplomat die prague blast,palestinian diplomat kill explosion prague,5.0,0.7184569522503699,4284,5620,-1336,1784896
5075,novice steer south ferry,south ferry captain arrest,2.400000095367432,0.4175152101415997,2109,2267,-158,24964
5076,chinese president meet indian vice president,chinese president meet state secretary,1.600000023841858,0.579131035218491,3242,1567,1675,2805625
5077,teenage girl kill east london theresa harsh shoot neck police,lackey shooting teenager theresa harsh bleed death shoot neck,4.599999904632568,0.4870285453590844,2556,5298,-2742,7518564
5078,death toll nairobi attack rise,death toll egypt violence rise,1.600000023841858,0.5276630722783227,2842,1568,1274,1623076
5079,china peace ark depart philippines thursday,china send aid team philippines,4.0,0.28309994206457745,1343,4568,-3225,10400625
5080,ran dissident kill ran,france lose influence europe,0.0,0.0,221,101,120,14400
5081,james gandolfini die aged,elson angela die aged,0.4000000059604645,0.4951215493795551,2628,548,2080,4326400
5082,early million people severe debt,britain debt timebomb line million debt,4.199999809265137,0.4581727145232047,2359,4749,-2390,5712100
5083,updated explosion near finish line boston marathon,report explosion finish line boston marathon,5.0,0.7798473203554295,4720,5621,-901,811801
5084,kill bomb blast pakistani train,kill bomb blast india,1.0,0.6319496676209861,3654,971,2683,7198489
5085,new old war,new old war,4.800000190734863,1.0,5660,5386,274,75076
5086,cuba ladies pick prize year late,cuba ladies sick prize year later,5.0,0.7089743264972036,4208,5623,-1415,2002225
5087,fourteen kill brazil bus accident,kill arizona skydiving accident,0.6000000238418579,0.26549191752456425,1261,673,588,345744
5088,sad chemical weapon syria rebel,sad agree hand chemical weapon,1.7999999523162842,0.6373502606642867,3695,1659,2036,4145296
5089,death toll bangladesh collapse,kill bangladesh building collapse,3.400000095367432,0.5896722762315956,3323,3530,-207,42849
5090,israel tens miss west bank,israel find body miss ten west bank,2.799999952316284,0.6981615237648553,4119,2741,1378,1898884
5091,president mourn death angela,world mourn pass angela,3.400000095367432,0.6032920848807538,3427,3467,-40,1600
5092,blast near cranial embassy beirut kill,near ran embassy beirut,3.200000047683716,0.7109763507929034,4227,3214,1013,1026169
5093,singapore share open high monday,singapore share open lower monday,2.200000047683716,0.7817838418344714,4735,2137,2598,6749604
5094,suicide bomber kill iraqi army recruit,suicide bomber kill iraqi army recruit baghdad,2.400000095367432,0.9048496319184144,5431,2273,3158,9972964
5095,deaf customer sue starbucks mock,deaf starbucks patron sue mock,4.599999904632568,0.8210888277177175,4993,5299,-306,93636
5096,thousand evacuate moscow retro fire,thousand evacuate fire break moscow retro,4.800000190734863,0.9159797962712994,5470,5381,89,7921
5097,kill rain flash flood pakistan,kill brazil stadium collapse,0.4000000059604645,0.08014766957814953,450,543,-93,8649
5098,kill white al south fighter northern semen,kill sectarian conflict north semen,3.0,0.26162606102593333,1234,2967,-1733,3003289
5099,ran exclude syria peace talk,kill syrian air strike,0.4000000059604645,0.0,175,546,-371,137641
5100,merry congress end shutdown,brazil congress approve internet legislation,0.4000000059604645,0.20731798516324262,1011,551,460,211600
5101,canada train plot suspect reject charge,canadian release egypt head home,1.0,0.0,174,992,-818,669124
5102,ukraine separatists ask join russia,crimean parliament notes join russia,2.799999952316284,0.308698678112619,1473,2728,-1255,1575025
5103,mud swear new australian,muslims hide sectarian,0.0,0.0,159,73,86,7396
5104,soon rock indicate earth orb bear collision,indian minister kill head collision,0.0,0.2402429887137347,1126,79,1047,1096209
5105,blackberry lose m,blackberry lose m quarter,5.0,0.8574545188922694,5206,5625,-419,175561
5106,egypt strongly oppose military action syria,reaction prospect military action syria,1.600000023841858,0.3767816508663636,1862,1571,291,84681
5107,fro russia rebel down malaysian plane ukraine,russia preparing counterproposals ukraine,1.7999999523162842,0.2510949438043048,1178,1757,-579,335241
5108,argument makarka boat abbott,agreement ran nuclear talk,0.4000000059604645,0.0,161,525,-364,132496
5109,believe syria probably chemical weapon,believe syrian government chemical weapon,4.599999904632568,0.5953189946988672,3378,5301,-1923,3697929
5110,egypt opposition criticize president speech,pakistan opposition party boycott presidential election,0.0,0.16735864295798097,853,81,772,595984
5111,syrian war see drag year,syria regime release hundred prisoner,1.0,0.0,168,987,-819,670761
5112,russia say ballistic missile fire mediterranean,israel say carry joint missile test mediterranean,1.0,0.47967528555938216,2510,990,1520,2310400
5113,volcano erupt indonesia evacuate airport close,volcanic eruption close airport,3.0,0.27396554182669397,1301,2984,-1683,2832489
5114,kill wound violent attack ran,kill wound attack ran,1.399999976158142,0.8008693790461509,4870,1359,3511,12327121
5115,ukraine yanukovych say plan resign,ukraine opposition demand yanukovich resign,1.399999976158142,0.39716084616677194,1985,1361,624,389376
5116,clash flood kill eastern afghanistan,comb wound eastern afghanistan,0.800000011920929,0.44470435215838217,2282,768,1514,2292196
5117,investigator probe motive lax airport short,investigator probe motive os angeles airport shorter,5.0,0.5633020796111765,3127,5627,-2500,6250000
5118,outrage report emerge year old indian girl rapid school,outrage indian girl gape school,5.0,0.5512698413612487,3043,5628,-2585,6682225
5119,janet ellen woman lead federal reserve,senate confirm janet ellen federal reserve chief,4.599999904632568,0.7330245010945409,4401,5303,-902,813604
5120,world power ran rouhani revive nuclear talk,world power seek rare progress ran nuclear talk,3.799999952316284,0.4787592715636172,2504,4157,-1653,2732409
5121,slim brotherhood banner egypt,military hold upper hand egypt,1.2000000476837158,0.14228882728384748,748,1200,-452,204304
5122,death expect canada oil brain explosion,dead canada train crash,2.799999952316284,0.2463705714318295,1152,2658,-1506,2268036
5123,philippines refer comment taiwan fish attack,laden continue sway show sonya mall attack,0.4000000059604645,0.08124060988788187,452,590,-138,19044
5124,crowd dignitaries father angela memorial service,drama take self angela funeral service,1.600000023841858,0.2705008973238402,1284,1573,-289,83521
5125,drama urge restraint israelis palestinians,drama meet israel palestinian negotiator,1.7999999523162842,0.1342480095685453,715,1737,-1022,1044484
5126,russia release greenpeace doctor,russian court release greenpeace ship doctor bail,4.199999809265137,0.6451562737506507,3751,4732,-981,962361
5127,russian aircraft wreckage find year,russia evacuate embassy tibia attack,0.2000000029802322,0.0,220,395,-175,30625
5128,kill drone attack semen wedding party,drone mistaken kill semen wedding convoy,4.0,0.6119789247841598,3506,4622,-1116,1245456
5129,china manufacturing index month low hsbc,china manufacturing expand september,1.0,0.34748631080380205,1700,936,764,583696
5130,france ban child beauty agent,facebook test mobile payment service,0.4000000059604645,0.0,224,579,-355,126025
5131,today history,today history april,1.7999999523162842,0.8315860561168982,5056,1764,3292,10837264
5132,ships brain syrian chemical weapons transport,adopt syrian chemical weapons resolution,1.7999999523162842,0.4516113715609835,2312,1721,591,349281
5133,death toll rise india lumbar building collapse,death toll rise indonesia collapse,0.6000000238418579,0.6108057011261273,3496,705,2791,7789681
5134,extremist claim responsibility tiger attack,greek militant group claim responsibility golden dawn kill,1.399999976158142,0.32727800694451586,1575,1363,212,44944
5135,fro russians force enter ukrainian naval base crimea,crimean force storm ukrainian navy headquarter,3.799999952316284,0.23084285811356628,1091,4152,-3061,9369721
5136,body miss south organ shipping tucson find field,jewel ferry disaster body south organ shipping tucson find,4.199999809265137,0.6670343579257455,3899,4720,-821,674041
5137,update elson angela condition,elson angela condition improve,2.200000047683716,0.6902062529002216,4069,2061,2008,4032064
5138,ukraine line people die iv clash,ukraine pressure kiev clash,2.0,0.33321038842518236,1616,1917,-301,90601
5139,lie surveillance missions help mind kidnap iberian girl,surveillance aircraft join hunt kidnap iberian girl,4.199999809265137,0.510661212329339,2729,4717,-1988,3952144
5140,prince george christen james palace,prince george christen london,3.799999952316284,0.7083259538370256,4205,4151,54,2916
5141,python reunite new,python reunite stage,4.0,0.8340323664440596,5071,4580,491,241081
5142,italian foreign minister confer,belgian crime minister send condolence victim,0.2000000029802322,0.13324360001825084,708,410,298,88804
5143,human hold suburban atlanta firefighter hostage dead police,video human take firefighters postage georgia,1.399999976158142,0.1273565534928768,688,1364,-676,456976
5144,bradley fanning wikileaks case turn sentence,fanning wikileaks case turn sentencing phase,5.0,0.6333580484145359,3658,5629,-1971,3884841
5145,egypt poll cent vote yes new constitution,egypt hold key vote constitution,2.400000095367432,0.5234740648540954,2816,2263,553,305809
5146,ran global power sign landmark nuclear deal,ran world power agree nuclear deal,4.599999904632568,0.5321563005740017,2888,5171,-2283,5212089
5147,israel force arrest palestinians overnight west bank maid,israel classify jerusalem native noncitizen,1.0,0.07723042345913078,444,960,-516,266256
5148,vague concern conduct zimbabwe election,zimbabwe grave concerns election,2.799999952316284,0.353547422140395,1727,2731,-1004,1008016
5149,long long stock end high,indian stock open high,0.6000000238418579,0.335496136527765,1626,699,927,859329
5150,dignitary pay tribute paul desmarais,star pay tribute james earner,0.4000000059604645,0.37453366437373686,1842,465,1377,1896129
5151,southwest ground flight computer pitch,southwest flight delay cancel computer pitch,4.199999809265137,0.732200195961198,4390,4730,-340,115600
5152,vatican embassy syria hit mortar fire,vatican embassy syria hit mortar injury,3.5999999046325684,0.8902752016733724,5363,3772,1591,2531281
5153,north block access joint industrial zone,north locks access key industrial,4.199999809265137,0.48871866420940024,2574,4716,-2142,4588164
5154,islamic militant kill foreign tourist pakistani,lumen foreign tourist pakistan,2.799999952316284,0.4418859623349626,2263,2747,-484,234256
5155,western force attack islamic militant base somalia,western power scramble befriend lodi,1.0,0.1648510288174375,842,953,-111,12321
5156,long long set huge democracy rally hanover anniversary,long long set huge democracy rally,3.799999952316284,0.8431173163724427,5124,4146,978,956484
5157,suicide bomber kill ran,suicide bomber attack primary school ran kill,3.0,0.7174985876989635,4275,3026,1249,1560001
5158,child bury alive fool landslide,line child die attack afghanistan attack,0.4000000059604645,0.10761610211644591,574,463,111,12321
5159,kill cava indonesia volcano erupts,dead indonesian eruption,3.0,0.0,199,3014,-2815,7924225
5160,kill india building collapse,kill comb lasts ran,0.6000000238418579,0.11130016940339722,602,701,-99,9801
5161,egypt presidential election begin,egypt issue long wait presidential election law,2.799999952316284,0.5201241940820835,2796,2719,77,5929
5162,evangelist kill son popular evangelist sick warren kill,popular evangelist warren kill,4.400000095367432,0.861452904397799,5225,4982,243,59049
5163,italian parliament back new,brain derailment hills new work,0.0,0.13366384728605585,711,92,619,383161
5164,russian lawmaker pass new bill restrict internet,russia say ballistic object fire mediterranean,0.4000000059604645,0.0,204,497,-293,85849
5165,super typhoon haiyan strong reason laws philippines,super typhoid haiyan close philippines,3.400000095367432,0.54904483492791,3022,3596,-574,329476
5166,dato condemn ukraine crackdown,bond well region,0.0,0.0,207,93,114,12996
5167,china investigate wine export,christine investigation heat,1.2000000476837158,0.0,208,1201,-993,986049
5168,conan white house correspondent dinner,drama versions white house correspondent dinner,3.5999999046325684,0.6527715290661489,3796,3831,-35,1225
5169,boston bomb suspect charge religious motive see,boston come suspect charge hospital bed,3.0,0.44044638736021996,2251,3029,-778,605284
5170,sign market mix china trade datum,sign market slump central bank stimulus fear,1.399999976158142,0.24342766848812003,1138,1367,-229,52441
5171,world old person die japan,jiroemon kimura world old person die aged,4.800000190734863,0.491965652215213,2598,5445,-2847,8105409
5172,foreign exchange rate india,foreign exchange rate singapore,1.399999976158142,0.7484705519368808,4514,1368,3146,9897316
5173,colorado wildlife destroy home wind bad,colorado wildlife big property destroy state history,3.5999999046325684,0.5313527272788428,2883,3749,-866,749956
5174,earthquake magnitude strike indonesia island,earthquake magnitude strike thailand,2.0,0.5923266619818162,3353,1944,1409,1985281
5175,afghan get hold peace talk taliban,pakistan hold direct talk taliban,2.0,0.5449188621896363,2991,1943,1048,1098304
5176,news terrorist israel palestinian conflict january,news terrorist israel palestinian conflict july august,3.0,0.7144884494329171,4250,2973,1277,1630729
5177,late early intervene syria,chief inspector need day conclude probe syria,1.600000023841858,0.09495735965753563,507,1470,-963,927369
5178,ran nuclear negotiating team leave kazakhstan,ran nuclear quest cost tehran billion,1.0,0.16757455214538147,855,958,-103,10609
5179,factory order january,german factory order rebound january,0.800000011920929,0.7512463317621382,4536,772,3764,14167696
5180,lumen surround tibia foreign ministry rush demands,luman surround libyan foreign ministry push demand,5.0,0.40235847884873993,2020,5624,-3604,12988816
5181,typhoon death toll rise,egyptian death toll rise,0.6000000238418579,0.6250892845835531,3593,713,2880,8294400
5182,agenda president sign anti gay bill,agenda president sign harsh anti gay law,4.199999809265137,0.8243874026816976,5008,4765,243,59049
5183,russian parliament allow ruin use military ukraine,russia intention incorporate southwestern ukraine,1.7999999523162842,0.1278877768833493,690,1660,-970,940900
5184,bradley fanning acquit aid enemy,wikileak soldier bradley fanning acquit aid enemy,4.400000095367432,0.8524216308342009,5177,4989,188,35344
5185,intensify russia sanction,ukraine years russian invasion,0.6000000238418579,0.0,205,660,-455,207025
5186,lock band plane make emergency landing,lock hands lane take emergency landing,5.0,0.5540181589442147,3064,5622,-2558,6543364
5187,russian crime minister second crimea visit,russia warn set precondition syria,0.800000011920929,0.0,202,863,-661,436921
5188,judge force feed california inmate,judge approve force feed californian inmate hunger strike,4.599999904632568,0.6135431691212512,3515,5167,-1652,2729104
5189,sang violence kill venezuelan prison,sixteen kill venezuela prison,4.0,0.25601427667357746,1202,4560,-3358,11276164
5190,military deaths afghanistan,military deaths afghanistan,3.400000095367432,1.0,5671,3495,2176,4734976
5191,israel palestinians seek meeting monday official,palestinians want merry mission nail,1.399999976158142,0.18589002232691543,932,1370,-438,191844
5192,tropical storm aren target gulf coast,tropical storm aren pose windfall,3.799999952316284,0.5523233638258772,3053,4168,-1115,1243225
5193,beam lean irish poet soil strife lie,beam lean irish poet noble winner die,4.800000190734863,0.6153171693825614,3527,5374,-1847,3411409
5194,bangladesh islamists rally atheist bagger,bangladeshi islamists rally demand action atheist bagger,4.599999904632568,0.7265380868322421,4333,5157,-824,678976
5195,crash malaysia airline light eastern ukraine,malaysia airline plane clash ukraine russia border,4.0,0.49568891186145747,2632,4672,-2040,4161600
5196,suicide bomber kill restaurant central somalia,suicide bomber kill paul,1.7999999523162842,0.5083110125461648,2717,1711,1006,1012036
5197,anthony reined slip fourth place new poll,rein fall fourth new nyc moral poll,5.0,0.3229250973778276,1556,5617,-4061,16491721
5198,india accuse china cross de facto border,senate house collision course border money,0.6000000238418579,0.15715559893440154,806,711,95,9025
5199,pregnant sudan woman marry christian man sentence death apostasy,sudan free christian woman sentence death apostasy,2.799999952316284,0.7313841322307251,4384,2662,1722,2965284
5200,diplomat merry wife rush hospital,secretary state john wife rush hospital,5.0,0.5272986633794527,2839,5615,-2776,7706176
5201,merry pursue quiet strategy ideas peace process,merry meet israel leader push ideas peace,3.799999952316284,0.40784570792077046,2051,4141,-2090,4368100
5202,north say start nuclear reactor,north offer talk complex open,3.5999999046325684,0.15882233697681136,813,3783,-2970,8820900
5203,egyptian court consider release,egypt court order mubarak release,4.0,0.37453591711621326,1843,4637,-2794,7806436
5204,suicide bomber kill wound afghan capital police,suicide bomb kill syrian capital old city,0.800000011920929,0.3996191764684637,1999,787,1212,1468944
5205,boston come suspect charge hospital bed,week later boston honor come victim suspect unable speak,1.2000000476837158,0.35958172591453774,1751,1202,549,301401
5206,rain hamper indian flood rescue,tourist gang rapid northern india police,0.4000000059604645,0.0,227,462,-235,55225
5207,look major terror attack africa,security council slum deadly terrorist attack demyan capital,1.600000023841858,0.09143269171492448,491,1465,-974,948676
5208,russia respond ukraine ceasefire,typhus prove ukraine asset,0.800000011920929,0.17274706218757485,882,750,132,17424
5209,long un execute horse dog uncle,chorea execute long uncle,3.5,0.7217646458197418,4307,3711,596,355216
5210,colourful support world brazil,jerk attend world final,1.2000000476837158,0.16064287664914886,822,1203,-381,145161
5211,angela remain hospital,angela remain intensive care,3.5999999046325684,0.5048911803385521,2695,3779,-1084,1175056
5212,south merry grow member stand trial,jewel ferry crew face trial,4.400000095367432,0.1568863008025974,805,5119,-4314,18610596
5213,egypt vote new constitution,egyptians note new constitution,5.0,0.48926486466635255,2579,5633,-3054,9326916
5214,drone strike kill pakistan official,drone kill militant pakistan,2.799999952316284,0.6458741830238731,3756,2703,1053,1108809
5215,vietnam defect signal miss plane,china expand search area miss plane,2.0,0.30569570519496314,1459,1855,-396,156816
5216,cricket england v australia fourth test scoreboard,cricket england v australia fourth test tea,4.0,0.7895711154352478,4796,4385,411,168921
5217,birthday dprk celebrate peru,curiosity celebrates dear war,0.4000000059604645,0.0,230,576,-346,119716
5218,powerful quaker strike solomon,powerful quaker strike california coast,2.200000047683716,0.6150565972382417,3524,2072,1452,2108304
5219,india ink image,india ink image january,1.7999999523162842,0.8384258290266856,5096,1650,3446,11874916
5220,australia leader dust snap leadership vote,australian millard dust leadership vote,4.0,0.5498079659865025,3033,4351,-1318,1737124
5221,drama condemn egypt violence cancer military exercise,pakistan condemn violence egypt,0.800000011920929,0.5858366197680767,3289,832,2457,6036849
5222,argentina declare mourn flood victim,parent demand common form nursery admission,0.0,0.0,218,367,-149,22201
5223,prince christen blend old new,prince george christening baptism plan royal baby godparent detail,2.200000047683716,0.14588546149089354,763,2058,-1295,1677025
5224,papers,papers sov,2.3299999237060547,0.7373123874018873,4432,2165,2267,5139289
5225,google release nexus phone,google design search result,1.0,0.2461920055872582,1151,986,165,27225
5226,coming aim hezbollah southern beirut,explosion hezbollah area south beirut,4.199999809265137,0.46135655352720184,2380,4792,-2412,5817744
5227,ally add sanction russia ukraine,flaps new actions russia ukraine,3.0,0.2897566726905586,1368,2857,-1489,2217121
5228,factory run organ cooperation silent,north south break silence talk,1.0,0.0,216,984,-768,589824
5229,chinese premier meet indian vice president,hezbollah urge elect new lebanese president,0.0,0.09728819822336533,515,360,155,24025
5230,algerian president france medical test,algerian president france medical test minor stroke,3.5999999046325684,0.7773885410122849,4703,3830,873,762129
5231,islamist hold hostage sonya mall standoff continue,death toll rise sonya mall siege continue,3.200000047683716,0.4320150652303392,2200,3258,-1058,1119364
5232,manchester city win second premier league title year,manchester city win english premier league title,3.799999952316284,0.8415201765710619,5111,4208,903,815409
5233,body crash victim fly netherlands,dead fly netherlands,4.800000190734863,0.6114806364297836,3501,5475,-1974,3896676
5234,egypt policeman kill final attack,egyptian soldier kill final attack,3.400000095367432,0.48644716284569867,2548,3609,-1061,1125721
5235,extension likely ran nuclear talk,oil slip ahead ran nuclear talk,1.399999976158142,0.35383585358872655,1729,1347,382,145924
5236,fire kill russian psychiatric institution,fear dead russian psychiatric hospital fire,3.5999999046325684,0.5098776837378171,2725,3815,-1090,1188100
5237,russia warn sign landmarks arms treaty,close landmark arm treaty,1.600000023841858,0.16959621071066341,868,1468,-600,360000
5238,wider renders syria,drama day crime time syria,1.600000023841858,0.12240313906966498,661,1462,-801,641601
5239,north expert dialogue china play,north cut tie south bar joint industrial park,0.800000011920929,0.11646894743538198,628,815,-187,34969
5240,china stock open high monday,china stock close lower thursday,1.0,0.31537237371953153,1512,965,547,299209
5241,bony peri x series veil,court order political ban berlusconi,0.0,0.0,179,293,-114,12996
5242,new coronavirus probably pass person,new virus probably pass person person,3.799999952316284,0.6784200735995171,3983,4219,-236,55696
5243,angela hospital condition,elson angela return hospital condition,5.0,0.7540272420558074,4554,5634,-1080,1166400
5244,harlem explosion death toll rise,mexico storm death toll continue rise,0.0,0.4059908117405015,2041,295,1746,3048516
5245,ukrainian crime minister design amid protest,british crime minister condemn murder ten,0.0,0.3421699515318254,1670,300,1370,1876900
5246,royal hoax takes action station,taliban bomb base afghanistan,0.0,0.0,281,302,-21,441
5247,arsenal v stoke city live,tottenham v manchester city live,2.200000047683716,0.34298500905496476,1672,2064,-392,153664
5248,business news market happen april,business news market happen june,2.400000095367432,0.8009393069652685,4873,2216,2657,7059649
5249,ran world power begin new round nuclear talk,ran world power pledge new nuclear talk,4.199999809265137,0.7095421847634928,4213,4896,-683,466489
5250,tropical storm aren target gulf coast,tropical storm aren weaken year gulf coast,2.5999999046325684,0.7999257775560971,4863,2486,2377,5650129
5251,worker kill india building collapse,kill bangladesh building collapse,3.0,0.6113647576404448,3500,2921,579,335241
5252,north fire short range missile,fire short range missile,3.799999952316284,0.9104113992272709,5447,4226,1221,1490841
5253,war comb hills northwest pakistan,comb kill northwest pakistan,2.5999999046325684,0.7382217836352427,4441,2470,1971,3884841
5254,malaysia airline lose contact plane carry seizing,malaysia airline plane vanishe flight seizing,4.0,0.5819473386641982,3260,4459,-1199,1437601
5255,microsoft say cut job,microsoft cut job overhaul,5.0,0.739089849251732,4446,5581,-1135,1288225
5256,malaysians vote poll stability change,malaysia election malaysians vote power stake time,3.400000095367432,0.36654653505995205,1793,3614,-1821,3316041
5257,fire destroy ancient tibetan town china,fire destroy tibetan town china,4.400000095367432,0.8688513074745198,5259,5120,139,19321
5258,yahoo agree buy number billion cash,yahoo buy number million,5.0,0.6667085261420301,3895,5578,-1683,2832489
5259,india start vote world large election,india voter kick big election,5.0,0.3102738260574908,1483,5577,-4094,16760836
5260,war bomb northern syria kill,syrian airstrike kill aleppo,2.0,0.10036708483493512,528,1811,-1283,1646089
5261,philippine quaker death toll limb,death toll philippines quaker jump,2.799999952316284,0.5323935629755064,2893,2715,178,31684
5262,search end miss asylum seeker,search narrow miss man,1.399999976158142,0.42895321341500187,2174,1345,829,687241
5263,ukrainian president order day ceasefire east,agenda president museveni agree sign anti day,0.2000000029802322,0.19465128511381635,964,376,588,345744
5264,icc champions trophy india vs south africa,champions trophy india v south africalive,4.329999923706055,0.6020284283825481,3420,4951,-1531,2343961
5265,supreme court take affirmative action michigan ban case,supreme court hear michigan affirmative action case,4.400000095367432,0.8602403327690908,5222,5047,175,30625
5266,headline major cranial newspaper kept,headline major cranial newspaper sov,3.0,0.7730458840148282,4672,2764,1908,3640464
5267,cyclone leave trail destruction india,cyclone hamlin evacuation keep indian villager alive,2.400000095367432,0.2167720379561472,1035,2205,-1170,1368900
5268,taliban kill police west afghanistan,drone kill eastern afghanistan,0.6000000238418579,0.33053297806113713,1597,692,905,819025
5269,thousand rally support battle tunisia government,thousand gather support islamist government tunisia,4.599999904632568,0.6304950933607674,3635,5169,-1534,2353156
5270,south africa angela take hospital,elson angela take hospital,4.800000190734863,0.542768416066707,2972,5391,-2419,5851561
5271,updated explosion near finish line boston marathon,explosion boston marathon finish line,5.0,0.8216422071554997,4995,5571,-576,331776
5272,kill southern egypt clash,kill north caucasus train station blast,0.4000000059604645,0.09195470138237141,495,528,-33,1089
5273,winter storm state state,winter storm anus state state,3.0,0.8387369252551125,5098,2778,2320,5382400
5274,corpse men round south baghdad,iraqi official body find south baghdad,3.5999999046325684,0.3611859994443273,1759,3823,-2064,4260096
5275,comb attack kill baghdad christian area,bomb baghdad christian area,3.0,0.7090087570795162,4209,3038,1171,1371241
5276,china set fili trial date,china fili trial fourth day,3.200000047683716,0.5980171835509684,3392,3246,146,21316
5277,muslims prepare start ramadan,muslims pray end division,0.800000011920929,0.2631808927515376,1244,811,433,187489
5278,japan scramble jet russian military plane,separatists ukraine military plane dead,0.800000011920929,0.29091073598127254,1373,828,545,297025
5279,thousand prisons claim dole germany,thousand white clothe amsterdammers march,1.0,0.160304068719367,820,1099,-279,77841
5280,suspect drone strike kill pakistan,suspect drone target islamic seminary pakistan,2.200000047683716,0.499800501522068,2656,2112,544,295936
5281,drama sign obamacare,drama visit tornado hit oklahoma,0.4000000059604645,0.16407642409977555,834,536,298,88804
5282,general electric post profit drop quarter,post profit drop quarter,5.0,0.7899217484380244,4798,5565,-767,588289
5283,china juan weaken usd,china juan strengthen new high usd,2.0,0.6097645342757608,3482,1888,1594,2540836
5284,russia find dead lawyer magnitski guilty posthumous trial,russia convict dead lawyer magnitski posthumous trial,5.0,0.8623321621219603,5232,5583,-351,123201
5285,trayvon,trayvon martin,2.799999952316284,0.7071067811865476,4189,2669,1520,2310400
5286,china send large fleet dispute island,china ship enter water dispute island,3.400000095367432,0.5288977818951832,2851,3659,-808,652864
5287,merry plan start talk call release palestinian inmate,merry plan include prisoner release settlement freeze,3.400000095367432,0.3830042684433843,1899,3556,-1657,2745649
5288,police explosion belfast cathedral quarter,explosion paul suicide attack diplomatic area,2.0,0.18303637245362253,923,1922,-999,998001
5289,syrian protest erdogan paris venezuelan stress support syria,turkey erdogan ran mend tie split syria,1.399999976158142,0.23999748224657824,1124,1320,-196,38416
5290,crime minister seek nuclear deal investment japan visit,manmohan hope clinch nuclear deal japan,3.0,0.3308372626926639,1602,3037,-1435,2059225
5291,postpone missile test n tension,embassy staying despite tension,1.2000000476837158,0.2781140800291949,1320,1205,115,13225
5292,drama meet privately family elson angela,drama meet angela family,4.599999904632568,0.7291478963633489,4358,5162,-804,646416
5293,dead shoot damage,dead somalia attack,0.4000000059604645,0.2495995340676053,1168,553,615,378225
5294,luman kill philippine political violence,kill philippines volcano eruption,0.6000000238418579,0.07724275995713056,445,721,-276,76176
5295,israel drone lebanon,israel shoot drone lebanon,5.0,0.8733800304970829,5295,5604,-309,95481
5296,israel approve release group palestinian prisoner ahead peace talk,syrian opposition confirm participation peace talk,1.0,0.22634525227958713,1070,1010,60,3600
5297,deadly clash egypt mark anniversary,violent clash mark anniversary egypt uprise,4.599999904632568,0.6169170419800665,3545,5158,-1613,2601769
5298,nato americans kill southern afghanistan,roadside bomb kill policeman southern afghanistan,1.600000023841858,0.43994847875607834,2249,1457,792,627264
5299,woman dress woman steal cash,cctv work come dress woman trick pensioner,3.799999952316284,0.2484025001810154,1160,4195,-3035,9211225
5300,cleveland kidnapped cry gastro round hanged prison,cleveland kidnap cry gastro find hang cell,5.0,0.3736374527826488,1837,5602,-3765,14175225
5301,google unveils prototype self driving war,google unveils concept self driving war,5.0,0.7886813737527099,4788,5601,-813,660969
5302,bangladesh garment factory fire kill,bangladesh garment factory collapse kill,2.0,0.9121284416671681,5451,1939,3512,12334144
5303,seek reassure wary gulf ally ran deal,age seek reassure battery gulf ally ran deal,4.0,0.7400663720327324,4455,4571,-116,13456
5304,ukraine host unity,hope hit war sell syria,0.0,0.0,259,346,-87,7569
5305,pakistan musharraf arrest bhutto assassination,pakistan musharraf arrive court time,2.400000095367432,0.39733894103544526,1986,2195,-209,43681
5306,trial late met egypt slim brotherhood chief,syria slim brotherhood face uphill battle,2.200000047683716,0.336055235593687,1630,2107,-477,227529
5307,red short live escape,march war,0.0,0.0,256,280,-24,576
5308,israel doctor try abroad force feed palestinian prisoner,israel west bank control cost palestinian economy billion,0.2000000029802322,0.17569707752958386,896,387,509,259081
5309,washington shops prepare historic tales,washington pot shop prepare historic sale,5.0,0.512943989237169,2749,5607,-2858,8168164
5310,rio airport worker strike eve fifa world,rio de janeiro airport worker strike eve world,5.0,0.7810364049489208,4728,5597,-869,755161
5311,slim brotherhood leader kill,egypt arrest slim brotherhood leader,1.399999976158142,0.7796403373005613,4719,1322,3397,11539609
5312,ran global power sign landmark nuclear deal,ran world power clinch breakthrough nuclear deal,5.0,0.4226268999092719,2143,5595,-3452,11916304
5313,air balloon patches fire virginia,air balloon patches fire rashes,2.799999952316284,0.7480370325310679,4512,2649,1863,3470769
5314,quote leader family angela memorial,world unite angela memorial,2.400000095367432,0.4436593657777395,2271,2187,84,7056
5315,lumbar indians put place,indonesians vote president tight race,0.0,0.0,115,284,-169,28561
5316,share remain high mid afternoon,share continue trend mid afternoon,4.400000095367432,0.6026076158424829,3421,5028,-1607,2582449
5317,papers sov,papers act,2.799999952316284,0.5641669551754692,3137,2652,485,235225
5318,amazon launch new device streaming video,amazon unveil new fire stream video box,4.199999809265137,0.412632702312128,2085,4849,-2764,7639696
5319,palestinian president receive jordanian foreign minister,palestinian arrest sexually harass young girl,0.0,0.1312963295596926,704,286,418,174724
5320,drama nominate new transportation secretary,drama foot battle veterans secretary,0.2000000029802322,0.32004796393108165,1540,400,1140,1299600
5321,china juan weaken usd,china juan strengthen usd friday,1.600000023841858,0.6287402677981225,3620,1494,2126,4519876
5322,french raid wine cellar austerity auction,praise ukraine deal call concrete action,0.2000000029802322,0.0,53,377,-324,104976
5323,russia agree seizure syria chemical weapon,syrian rebel skeptically chemical weapon deal,1.399999976158142,0.2665338782823293,1267,1323,-56,3136
5324,s visit kaesong complex,demand talk closed factory,1.399999976158142,0.0,52,1324,-1272,1617984
5325,algerian priest lecture christian heritage africa,telstra apply list china site,0.0,0.0,51,326,-275,75625
5326,headline major cranial newspaper april,headline major cranial newspaper august,3.0,0.8147241707661844,4950,2800,2150,4622500
5327,complication palestinian reconciliation,belgian king address nation amid indication speculation,0.6000000238418579,0.0,49,702,-653,426409
5328,hijacker arrest plane land geneva airport,hijacked aircraft land geneva,3.0,0.4015499511280842,2016,2794,-778,605284
5329,pcb appoint makar wounds head coach,makar wounds pakistan coach,5.0,0.6885726644071241,4057,5656,-1599,2556801
5330,make case action syria,maude urge action israel strikes syria,2.400000095367432,0.3299488900535275,1593,2225,-632,399424
5331,ankara protest clash police,peru protest clash police,1.7999999523162842,0.5306257639580839,2870,1651,1219,1485961
5332,kill wound violent attack ran,kill wound fresh attack ran,2.200000047683716,0.6540752754681517,3808,2132,1676,2808976
5333,huerta arrest production child pornography,indian arrest suspicion rape,0.4000000059604645,0.13042153071687082,698,580,118,13924
5334,ukraine sign trade russia finalize crimea annexation,ukraine court dismiss crimea independence unconstitutional,2.0,0.28175491581440054,1336,1828,-492,242064
5335,sad warn turkey heavy price back syrian rebel,cabinet war arm syrian rebel,1.0,0.28115288373264014,1334,1052,282,79524
5336,indian stock close low,long long stock close high,1.7999999523162842,0.3159362982821664,1514,1655,-141,19881
5337,kill wound violent attack ran,kill wound attack ran,2.799999952316284,0.8008693790461509,4871,2599,2272,5161984
5338,indian rape accuse face verdict,indian rape accuse find guilty,3.799999952316284,0.6593679204625269,3846,4067,-221,48841
5339,ran nuclear deal agree talk,ran nuclear real heal decades long dispute,3.5999999046325684,0.21304377515841566,1023,3766,-2743,7524049
5340,egyptian military spokesman denounce incitement army,labor ministry announcement monday,0.0,0.0,42,331,-289,83521
5341,dowden see chance fair trial,dowden see chance fair trial,5.0,1.0000000000000004,5749,5720,29,841
5342,headline major cranial newspaper dec,headline major cranial newspaper july,2.200000047683716,0.7544979779607704,4557,2024,2533,6416089
5343,dozen injure connecticut train collision,indian minister kill head collision,0.2000000029802322,0.30439381486326234,1444,415,1029,1058841
5344,queen visit britain new prince,queen meet britain new baby prince,5.0,0.752986972952441,4547,5718,-1171,1371241
5345,ukraine kill parliament protest,ukraine president walls talks protest,1.0,0.37398665061012726,1838,1043,795,632025
5346,operator charge fair accident,state hair ride operator arrest accident,4.400000095367432,0.5138801937725246,2753,5008,-2255,5085025
5347,transcript reveal confusion evacuation south organ ferry,transcript reveal confusion merry evacuation,3.5999999046325684,0.7641268289210963,4626,3775,851,724201
5348,fall firefighter bring home,street end slightly low,0.2000000029802322,0.0,40,419,-379,143641
5349,syria regime agree attend peace conference,russia syria agrees participate conference,4.800000190734863,0.2807882415443871,1332,5416,-4084,16679056
5350,vote reject military action,britain reject syria military action,3.400000095367432,0.7139087187771826,4249,3648,601,361201
5351,new zealand set realise gay marriage,new zealand vote realise sex marriage,4.400000095367432,0.7183492423508842,4283,5018,-735,540225
5352,singapore stock end,singapore stock close high,3.0,0.6277674542523621,3611,2906,705,497025
5353,venezuelan president visit china,senegalese president visit china,1.7999999523162842,0.5320857893468158,2887,1657,1230,1512900
5354,cairo protest defy crackdown threat,cairo camps protesters fig,3.5999999046325684,0.21947602557498308,1045,3765,-2720,7398400
5355,kiss plane search turn vietnamese island,kiss malaysia airline plane clash vietnam,3.0,0.27933873690938166,1324,2901,-1577,2486929
5356,official malaysia airline brief relative miss flight passenger search progress,malaysia airline investigation co pilot miss flight,1.0,0.4936589803145716,2614,1083,1531,2343961
5357,star pay tribute tory monteith,star pay tribute james earner,2.200000047683716,0.5813822659888896,3254,2083,1171,1371241
5358,os angeles airport worker charge make threat,os angeles airport worker charge threat,5.0,0.9403408911022013,5531,5714,-183,33489
5359,note heads friday,note heads friday august,2.200000047683716,0.86860581597333,5258,2082,3176,10086976
5360,cristiano donald hat trick fire portugal world final,donald hat trick fire portugal world,4.800000190734863,0.8170063208802665,4969,5425,-456,207936
5361,britain prince philip set exploratory surgery,prince philip hospitalize,3.0,0.48828589113413845,2570,2758,-188,35344
5362,japan start hear sale tax ex bank deputy urge gradual rise,japan start hearing propose tax like,3.5999999046325684,0.3430570949658308,1674,3778,-2104,4426816
5363,bomb attack kill soldier civilian,school bomb attack kill southern thailand,1.0,0.404675912508497,2037,1028,1009,1018081
5364,italian pilgrim die bus plunge,passenger dead italy bus plunge,3.799999952316284,0.4087697150784872,2056,4254,-2198,4831204
5365,strong new quaker hit shatter oak region,powerful new earthquake hit shatter pakistan region,5.0,0.5635267324160462,3131,5712,-2581,6661561
5366,syrian opposition offer sad truce duration ramadan,syrian opposition offer sad force truce duration ramadan,4.599999904632568,0.9616170896428133,5572,5164,408,166464
5367,dead somalia attack,die ran prison attack,2.200000047683716,0.2102281432101925,1016,1970,-954,910116
5368,estate mall attacker spend month plan nairobi,estate attacker spend month plan nairobi say official,4.599999904632568,0.8651012097331493,5247,5155,92,8464
5369,security council call humanitarian ceasefire papa,security council walls unconditional ease fire papa,4.800000190734863,0.3874607685023148,1924,5469,-3545,12567025
5370,magnitude quaker hit honshu japan cenc,magnitude earthquake bolt taiwan cenc,2.0,0.3951647265474627,1969,1960,9,81
5371,chinese share close high tuesday,chinese share close lower wednesday,2.200000047683716,0.5490429955672977,3021,1989,1032,1065024
5372,war bombs iraqi capital,war coming kill civilian iraqi capital,2.400000095367432,0.5807302552629694,3252,2298,954,910116
5373,ukrainian protest street anti government rally,ukraine protest couple vein statue kiev,2.5999999046325684,0.10123722169852241,538,2434,-1896,3594816
5374,canadian freight train blast death toll hit rise,canadian government monitoring train blast situation,2.200000047683716,0.40086972193469406,2012,2108,-96,9216
5375,nigel garage call government let syrian refugee,plan settle syrian refugee,2.400000095367432,0.3558162133094338,1738,2268,-530,280900
5376,israel teres urge return peace talk,gonsalves keep pressure tom rep,0.2000000029802322,0.0,68,405,-337,113569
5377,china juan strengthen usd tuesday,china juan weaken usd,1.7999999523162842,0.6298815677390316,3627,1649,1978,3912484
5378,radio israel set increase palestinian prisoner release,israel delay palestinian prisoner release,1.600000023841858,0.6051443713767791,3442,1499,1943,3775249
5379,dorsi supporter reject plan,dorsi supporter march egypt,2.400000095367432,0.567343451407327,3162,2282,880,774400
5380,egypt court sentence brotherhood supporter death source,turkish tell supporter prepare ally,0.2000000029802322,0.19505649839799674,965,403,562,315844
5381,drama condemn kill israel ten,body miss israel ten find west bank,1.399999976158142,0.1697925029636992,869,1326,-457,208849
5382,man try beheld soldier london street court hear,australia speed indonesia president report,0.0,0.0,67,342,-275,75625
5383,ukraine protest rebuild barricade,ruin speak ukraine protest rebuild barricade,3.400000095367432,0.8426720229094729,5121,3661,1460,2131600
5384,el smith dead mourn comedy favourite,tariff bone el smith force life,2.400000095367432,0.3360989955849004,1632,2233,-601,361201
5385,dead hurt new work building collapse,dead hurt french building collapse,1.600000023841858,0.7601876444332173,4605,1502,3103,9628609
5386,chinese share close high tuesday,chinese stock close low thursday,1.600000023841858,0.389903587004097,1939,1510,429,184041
5387,india ink image july,india ink image march,3.0,0.7633553639949702,4619,2936,1683,2832489
5388,sign muslims celebrate kill afghanistan,sign muslims celebrate die pakistan afghanistan,3.5999999046325684,0.8301704093495936,5050,3965,1085,1177225
5389,russian coal mine seek new outlet china,russian foreign minister meet chief,0.4000000059604645,0.14520486465809207,757,500,257,66049
5390,pro russia protest demand great autonomy,sudanese protest demand regime outer,1.399999976158142,0.24765405101788796,1157,1327,-170,28900
5391,ran army fight retaken tikrit,ran army claim victory tikrit,3.200000047683716,0.5822123703318469,3262,3081,181,32761
5392,ran condemn allege israel airstrike syria,democrats face divide strike syria,1.2000000476837158,0.10200157403651813,541,1210,-669,447561
5393,israel agree extend papa truce hour,israel james reportedly agree hour truce,2.5999999046325684,0.6154464115473398,3529,2389,1140,1299600
5394,fire south organ bus terminal kill,s bus station fire kill seven,3.200000047683716,0.31620967232783176,1517,3102,-1585,2512225
5395,civilian nato soldier kill afghanistan,nato soldier kill afghanistan,3.400000095367432,0.8533120273361126,5181,3621,1560,2433600
5396,protester swamp street reclaim revolution,egypt protester storm slim brotherhood,1.600000023841858,0.24925488444028512,1165,1504,-339,114921
5397,tokyo stock open,tokyo stock open,2.799999952316284,1.0000000000000002,5708,2627,3081,9492561
5398,australia return asylum seeker ri vanka sea transfer,australia australia hand asylum seeker ri vanka,4.599999904632568,0.7494969267878837,4526,5165,-639,408321
5399,shankill blast victim remember,crocodile victim body recover,0.2000000029802322,0.1781600417918028,905,402,503,253009
5400,people kill twin blast siberia,man kill new blast russia,1.399999976158142,0.3717570650829512,1822,1328,494,244036
5401,lee star tory monteith find dead hotel room canada,lee star tory monteith find dead,4.400000095367432,0.8274322981603881,5029,5027,2,4
5402,poland death toll limb,sonya red cross say death toll rise,0.4000000059604645,0.3182259965351456,1529,513,1016,1032256
5403,tokyo stock close,tokyo stock close,1.7999999523162842,1.0,5681,1664,4017,16136289
5404,ran say ready fresh round nuclear talk,ran khamenei renew support nuclear talk,3.5999999046325684,0.28741232996205324,1363,3833,-2470,6100900
5405,lash continue police protest turkey,turkish police fight protest clear square,4.400000095367432,0.22628500835974047,1069,5065,-3996,15968016
5406,refuse medical card urge contact hse,hse boss depend medical card plan,1.2000000476837158,0.5344431704053871,2910,1212,1698,2883204
5407,large building open west china,centre leave splinter presidential vote,0.0,0.0,18,314,-296,87616
5408,israel lightly hurt stone west bank,israel troop kill palestinian west bank raid,1.2000000476837158,0.381547681647588,1892,1223,669,447561
5409,death toll egypt protest rise,death toll egypt violence rise,3.200000047683716,0.7670312755871442,4641,3141,1500,2250000
5410,syrian opposition agree landmark peace talk,syria opposition press attend talk,3.0,0.29792447149681794,1417,3069,-1652,2729104
5411,poverty state doubt lodi development claim,start take recall compensation claim dug,0.0,0.12161953388254414,654,317,337,113569
5412,fro russia rebel hold vote ukraine,syria rebel kill hezbollah man lebanon,0.0,0.18161069130210689,917,319,598,357604
5413,georgian vote new president,ally georgia millionaire president poll,2.5999999046325684,0.12217620443278711,658,2375,-1717,2948089
5414,mer respiratory illness find official confirm,case mer sars like respiratory illness report north america,4.199999809265137,0.6033165864591481,3428,4718,-1290,1664100
5415,declare hezbollah military wing terror group,put hezbollah military wing terror list,4.800000190734863,0.756843134648175,4572,5368,-796,633616
5416,germany welcome ran nuclear agreement,syria welcome ran nuclear deal,1.7999999523162842,0.5976924879496874,3390,1676,1714,2937796
5417,papers june,papers dug,2.200000047683716,0.5473617862983993,3005,2046,959,919681
5418,luman kill foreigner pakistan,luman kill tourist pakistan,4.800000190734863,0.6162295008795119,3535,5359,-1824,3326976
5419,indian trader strange china send home,indian nurse strange ran return home,1.7999999523162842,0.5311152777928007,2878,1683,1195,1428025
5420,california governor declare drought emergency,california governor declare drought emergency wildfire continue burn,3.5999999046325684,0.7746871605934522,4684,3850,834,695556
5421,peace talk palestinians month israel official,myo palestinian girl kill israel raid,0.4000000059604645,0.115563475684366,624,480,144,20736
5422,kill ran car coming,child kill syria coming,0.6000000238418579,0.5445752987153889,2988,726,2262,5116644
5423,dead wrap late lumbar building collapse,wrap building collapse,1.2000000476837158,0.7024931943576801,4156,1213,2943,8661249
5424,air strike kill dozen northern syria,ukraine inch crimea,0.0,0.0,13,324,-311,96721
5425,chinese tourist abduct malaysia,china return child abduct vietnam,1.399999976158142,0.3356337641698293,1628,1332,296,87616
5426,inspector hail progress syria chemical weapon,conclude syria chemical weapon house,2.200000047683716,0.3782512356760933,1871,2021,-150,22500
5427,arrest protest nigel garage,merry vow progress late intensive ideas trip,0.0,0.0,11,323,-312,97344
5428,luman kill libyan soldier,luman kill lebanese troop near syria,2.400000095367432,0.3554411890447514,1736,2239,-503,253009
5429,picture complete costa concordia operation,timelapse costa concordia operation,4.400000095367432,0.6561883528675523,3827,5041,-1214,1473796
5430,ran nuclear talks enter,ran nuclear talk enter crucial day,5.0,0.5076471903212253,2713,5735,-3022,9132484
5431,protester gather brazil despite concession,protest sweep brazil despite concession,5.0,0.6247749293315252,3591,5734,-2143,4592449
5432,australian mud call election september,australian mud call kept poll,4.599999904632568,0.5104998207242961,2728,5166,-2438,5943844
5433,ran nuclear talk expect resume week,ran nuclear talk point,3.0,0.511456318405519,2740,2793,-53,2809
5434,bangkok tense election eve,bangladesh crackdown escalate head election,2.200000047683716,0.12660697684669636,683,2093,-1410,1988100
5435,china protect foreign business,drama confrontation ruin ukraine,0.0,0.0,7,321,-314,98596
5436,notes decriminalize marijuana,vote decriminalize pot,5.0,0.42742943106554104,2163,5731,-3568,12730624
5437,dead asylum boat sink australia,angela spend day hospital,0.0,0.0,6,320,-314,98596
5438,north nail execution powerful uncle,north organ intrigue execution power,2.5999999046325684,0.32432924809301333,1565,2517,-952,906304
5439,margaret thatched die stroke,margaret thatched die,4.199999809265137,0.8447079807921137,5133,4835,298,88804
5440,chinese president arrive netherlands state visit nuclear summit,chinese president arrive venezuela state visit,2.400000095367432,0.6354051451106553,3677,2245,1432,2050624
5441,israel sanction palestinians new blow peace talk,israel release palestinian prisoner deal revive peace talk,2.400000095367432,0.3128217551029846,1498,2261,-763,582169
5442,sky news cameraman kill egypt,sky news cameraman kill egypt,4.800000190734863,1.0,5701,5349,352,123904
5443,stock rise early trading,stock inch high early trading,4.400000095367432,0.6310543798479648,3642,5094,-1452,2108304
5444,fbi audit expert testify zimmerman trial,jury selection begin zimmerman trial,1.399999976158142,0.3127996779784826,1497,1335,162,26244
5445,cranial nuclear talk extend november,ran nuclear talk extend november,4.400000095367432,0.8213180508695024,4994,5096,-102,10404
5446,boston come suspect appear court,boston come suspect bury,1.2000000476837158,0.6054856242998381,3446,1214,2232,4981824
5447,death toll india building collapse hit,toll india building collapse hit,3.200000047683716,0.926841889358745,5501,3176,2325,5405625
5448,drama announce creation twin manufacturing hub,stock retreat manufacture datum,0.4000000059604645,0.0,17,476,-459,210681
5449,charge terrorist offence,people charge terror offence,4.800000190734863,0.6443475685879911,3742,5393,-1651,2725801
5450,president drama reveal plan withdraw troop afghanistan,government shutdown drama tell republicans lift threat economy want talk,0.800000011920929,0.087424550072634,473,860,-387,149769
5451,nato raise doubts russia pull ukraine order,sign russian withdrawal ukraine order official day,2.5999999046325684,0.2541909940363752,1196,2455,-1259,1585081
5452,ftse bursa malaysia update,ftse bursa malaysia update,3.400000095367432,1.0,5617,3424,2193,4809249
5453,glasgow helicopter crash search end,glasgow helicopter crash woman victim,2.799999952316284,0.6883341321637217,4053,2612,1441,2076481
5454,quotation news,quotation day,3.200000047683716,0.7022173140718324,4152,3101,1051,1104601
5455,philip leave hospital day,angela leave hospital day,1.7999999523162842,0.6778972646376593,3975,1742,2233,4986289
5456,fragment king alfred,remain winchester king alfred great,4.599999904632568,0.4940295625671022,2620,5154,-2534,6421156
5457,israel free second group palestinian prisoner,israel release palestinian prisoner,3.799999952316284,0.607683640784916,3466,4238,-772,595984
5458,skydiver dead collide jump,skydiver dead collide jump arizona,3.799999952316284,0.8703547443459444,5271,4071,1200,1440000
5459,iron jetpack spark concern hawaii,iron jetpacks park concern,3.799999952316284,0.38738959943293794,1923,4081,-2158,4656964
5460,israel free palestinian prisoner,israel release palestinian prisoner,4.599999904632568,0.7321365492622868,4389,5156,-767,588289
5461,france days think responsibilities syria,france urge unite syria,2.5999999046325684,0.2905759802092701,1372,2385,-1013,1026169
5462,boston come suspect identify surveillance video arrest,boston come suspect fbi surveillance say mother,3.400000095367432,0.5843759235142025,3280,3587,-307,94249
5463,china anger overcome worry,china anger north overcome worry stealth flight,3.200000047683716,0.769128043035322,4650,3286,1364,1860496
5464,china juan strengthen new high usd,china juan weaken usd,2.200000047683716,0.6097645342757608,3483,2059,1424,2027776
5465,hold shoot belfast,arrest shoot,3.200000047683716,0.3967643403528532,1982,3314,-1332,1774224
5466,police stop maldives presidential election,deity sins ali presidential election,1.2000000476837158,0.2728338601182072,1296,1215,81,6561
5467,indian army kill militant indian control kashmir,indian troop kill militant commander indian control kashmir,3.5999999046325684,0.823580591978167,5003,3954,1049,1100401
5468,war bomb kill northwest syria,war bomb kill northwest pakistan,1.2000000476837158,0.8460040443988885,5139,1216,3923,15389929
5469,ran oil swap eastern neighbor,ran urge rapid release diplomat,0.4000000059604645,0.09680916827381138,514,510,4,16
5470,turkey president appeal calm,texas house provisional approve abortion law,0.0,0.0,34,310,-276,76176
5471,north test fire missile sea,n fire shell sea,2.799999952316284,0.3951988650227641,1970,2607,-637,405769
5472,die senegal house fire,woman die work house fire,2.200000047683716,0.5295582626741702,2856,2050,806,649636
5473,oh gas blast kill injury dozen,syria missile kill include kiss,0.6000000238418579,0.07914086177647907,448,641,-193,37249
5474,rolling station open ukrainian presidential election,combination open influential wards,0.2000000029802322,0.11027571248461307,600,385,215,46225
5475,india ink image april,india ink image,2.5999999046325684,0.8772228425100292,5311,2518,2793,7800849
5476,french journalist kill ali,france confirm french journalist kill ali,5.0,0.8086317759770981,4916,5671,-755,570025
5477,luman kill tourist pakistan,lumen attack hotel remote pakistani province,3.200000047683716,0.0,24,3287,-3263,10647169
5478,israel james observe brief papa truce,israel james accept temporary truce,4.599999904632568,0.4335033286669245,2208,5160,-2952,8714304
5479,china troubled xinjiang hit violence,china online population rise man,0.4000000059604645,0.10343045476808423,547,514,33,1089
5480,relative scuffle police china fire kill,angry family demand answer china plant fire kill,3.799999952316284,0.15402744785790612,798,4080,-3282,10771524
5481,ran reject claim chlorine bomb,ran reject mko claim nuclear site,2.400000095367432,0.4319981179277169,2199,2199,0,0
5482,india minister wife die unnatural death affair rumour,minister wife death unnatural,3.799999952316284,0.6818012540170445,4000,4070,-70,4900
5483,dead hurt shoot s carolina oceanfront hotel,dead injure train collision near moscow,0.2000000029802322,0.10109372785380004,535,397,138,19044
5484,burial boston come suspect appear legal,ready home boston come victim leave hospital,1.0,0.2642140799996143,1253,1058,195,38025
5485,kill s china road cave,kill china earthquake,1.2000000476837158,0.34658115713391957,1693,1217,476,226576
5486,south africa president angela improve,afghan president delay sign deal,0.0,0.1345461967169066,719,339,380,144400
5487,world news update need know,labour tax rate need know,0.6000000238418579,0.3591125743180619,1747,647,1100,1210000
5488,syrian civil war photo,syrian civil war peace talk risk ran invitation,1.2000000476837158,0.5288574163580586,2850,1218,1632,2663424
5489,abdullah sides head afghan presidential toll,explosion hear near afghan presidential palace,1.0,0.25846855665495094,1217,1045,172,29584
5490,man blame rival colleague murder,pakistans man blame rival kill party member,4.199999809265137,0.47302644176709285,2466,4868,-2402,5769604
5491,bangladesh honors factory victims,retainer bangladesh factory safety,2.799999952316284,0.380569972846342,1885,2587,-702,492804
5492,meet fire national die,get fire national blow hospital,3.0,0.33057059097861136,1599,2774,-1175,1380625
5493,japan depend dolphin hunt criticism,japan depend dolphin hunt criticism,5.0,1.0000000000000002,5703,5664,39,1521
5494,comb blast rock shopping mall siberia kill,comb blast indian opposition rally kill,1.399999976158142,0.3998592081917255,2002,1337,665,442225
5495,philippine typhoid death toll,philippine typhoid death toll rise,3.400000095367432,0.9240061341399588,5495,3660,1835,3367225
5496,police fire tear venezuelan vote protest,heir madura win venezuela presidency,0.6000000238418579,0.0,83,645,-562,315844
5497,attack kill ran,suicide attack kill northern ran,1.7999999523162842,0.6515587735450483,3790,1667,2123,4507129
5498,chinese political adviser meet greek,chinese political adviser meet cement president,3.400000095367432,0.7392404780016306,4450,3546,904,817216
5499,palestinian diplomat injure explosion prague,palestinian ambassador injure apartment blast,4.0,0.2976047001789928,1414,4633,-3219,10361961
5500,ukraine leader pledge crisis talk,ukraine leader pledges crisis talks,5.0,0.5179726396425315,2776,5661,-2885,8323225
5501,kill attack ran,kill series attack ran,3.0,0.7488888218906288,4516,3011,1505,2265025
5502,military presence asia,nato military presence amid russian threat,1.2000000476837158,0.47433878594976975,2477,1219,1258,1582564
5503,believe syrian government chemical weapon,suspect syria chemical weapon,5.0,0.4622900716995575,2386,5660,-3274,10719076
5504,world power ran resume expert nuclear talk,ran nuclear expert world power resume talk week,4.0,0.9440602037970689,5541,4661,880,774400
5505,egypt slim brotherhood refuse,egyptian court sentence slim brotherhood leader life prison,1.399999976158142,0.39275089172931077,1952,1338,614,376996
5506,dead canada bus train crash,dead paris train crash,2.200000047683716,0.5781681034099712,3232,2140,1092,1192464
5507,chinese president meet greek call strong partnership,chinese president meet indian vice president,1.7999999523162842,0.4850397490949292,2539,1705,834,695556
5508,astrazeneca pay buy bristol eyes squibb diabetes alliance,astrazeneca buy bristol diabetes venture billion,5.0,0.6061014191760563,3452,5677,-2225,4950625
5509,italian fugitive arrest dominican republic,australian icebreaker arrive antarctica new rescue bid,0.0,0.0,385,334,51,2601
5510,india hold talk china week,egypt hold talk imf loan week,1.399999976158142,0.42992664550162174,2183,1339,844,712336
5511,israel carrying round offensive papa,israel haunches round offensive papa,4.800000190734863,0.6901736280098437,4068,5400,-1332,1774224
5512,thud alert israel prime minister sentence year jail corruption,thud alert sentence year israel,3.799999952316284,0.731021105959109,4379,4110,269,72361
5513,brahimi apology syria lack peace progress,mediator apologize syrian lack peace progress,3.799999952316284,0.4543496732559861,2334,4203,-1869,3493161
5514,egyptian protest issue dorsi resignation ultimatum,ukraine protest battle police new clash,0.4000000059604645,0.11217051699761178,610,591,19,361
5515,thing foci olympics,thing ethanol,0.0,0.2837400661968598,1345,332,1013,1026169
5516,china stock open lower wednesday,china stock close lower monday,2.5999999046325684,0.6096459619724103,3479,2409,1070,1144900
5517,delay missile test tension rise,william vague decision halt missile test sensible,3.400000095367432,0.26987768304344495,1280,3506,-2226,4955076
5518,fire seizing kill,fire seizing kill,5.0,1.0,5668,5700,-32,1024
5519,india china ink border agreement,india china ink agreement trans border river,3.799999952316284,0.7881751179363669,4783,4199,584,341056
5520,venezuela expel diplomat,venezuela expel diplomat,5.0,1.0,5675,5699,-24,576
5521,heavy hit north china city flight cancel,heavy north china city lights cancel,5.0,0.7059305939761487,4179,5698,-1519,2307361
5522,russia claim fail possible terror act,russia say ballistic object fire mediterranean,1.399999976158142,0.10736536750408274,570,1340,-770,592900
5523,chinese tourist kill pakistan,kidnap kill southern siberia,0.4000000059604645,0.10566321267804155,559,581,-22,484
5524,world reach,clash types court opens trial young death,0.0,0.0,404,309,95,9025
5525,luman kill foreign tourist northern pakistan,islamic militant kill foreign tourist pakistani,2.5999999046325684,0.45924799931093896,2363,2433,-70,4900
5526,austrian find harding steal skull home museum,stolen skull find home museum,3.400000095367432,0.5459453643507584,3001,3456,-455,207025
5527,egypt haunches offensive final militant,egypt launch offensive final insurgent,5.0,0.5397472769044751,2954,5695,-2741,7513081
5528,record set southwest heat wave turn fatal,dead hospitalize southwest heat wave,4.0,0.5658112843454264,3148,4401,-1253,1570009
5529,detroit eligible bankruptcy protection judge,detroit eligible bankruptcy protection,4.599999904632568,0.9270194277732134,5503,5159,344,118336
5530,british noble win author boris passing lie,noble prize win author boris passing die,4.199999809265137,0.7642407532210367,4627,4857,-230,52900
5531,israel government authorise new settlement ahead talk,israel approved new settlement come head peace talks,4.800000190734863,0.30997186507894303,1481,5459,-3978,15824484
5532,pakistani taliban chief kill drone strike,funeral pakistan taliban chief set place,1.600000023841858,0.34401596448780103,1680,1478,202,40804
5533,ruin sign crimea annex treaty,ruin sign crimea annexation,3.5999999046325684,0.5679279781391087,3168,3890,-722,521284
5534,faa continue ban flight el iv,faa lift ban flight el iv,1.7999999523162842,0.8630810007057698,5235,1756,3479,12103441
5535,chinese envoy result vietnamese philippine accusation south china tea,china tell vietnam want peace south china tea,3.200000047683716,0.3257617642802915,1568,3216,-1648,2715904
5536,people arrest australia large illegal tobacco importation indicate,police target illegal tobacco indicate,2.799999952316284,0.5722430853631242,3199,2653,546,298116
5537,drama move fill red board cap richer,drama voice willingness talk gop budget,0.4000000059604645,0.10718928924050819,569,574,-5,25
5538,ran president condemn use chemical weapon syria,probe allege use chemical weapon syria,1.600000023841858,0.5539139633978432,3063,1479,1584,2509056
5539,society frame edge,old ligament crack edge,0.4000000059604645,0.2515485244808512,1180,585,595,354025
5540,invites ran syrian peace conference,ran invite attend syrian peace conference,5.0,0.574388148608832,3209,5693,-2484,6170256
5541,italy bus crash death toll rise,starbucks clear college degree path worker,0.0,0.0,351,285,66,4356
5542,soccer def punch layer lies,police utah soccer referee punch player die,4.199999809265137,0.32314920471162367,1558,4802,-3244,10523536
5543,angela jerked head narrow win german election,kalaw new president swear dispute election,0.4000000059604645,0.1094714971812597,594,587,7,49
5544,israel detail palestinians arrest operation continue,israel criticize palestinian stance settler,1.2000000476837158,0.11540565715028465,622,1220,-598,357604
5545,rebel kill civilian syria alawite village,comb kill civilian afghanistan,1.2000000476837158,0.3137253924938368,1502,1221,281,78961
5546,world send emergency relief batter philippines,typhoon haiyan world send relief batter philippines,5.0,0.7410240391132308,4463,5689,-1226,1503076
5547,palestinian hunger striker israel reach deal,palestinian activist detain israel raid,1.2000000476837158,0.24976353207465324,1170,1222,-52,2704
5548,sad say syria comply arm resolution,syria sad vow comply resolution,4.800000190734863,0.7912335354613029,4807,5428,-621,385641
5549,south organ president sorry merry response,organ president sorry ferry disaster,4.599999904632568,0.5190186420986087,2788,5163,-2375,5640625
5550,good price like raise concern ran,american chris corner win pain,0.0,0.0,342,281,61,3721
5551,drama minute decision syria approval,drama mill limit military action syria,2.0,0.25322600700290876,1190,1880,-690,476100
5552,river back stroll child drive,river back mon stroll child drive,4.0,0.8395884611768099,5105,4412,693,480249
5553,pain princess testify historic fraud probe,pain princess testify historic fraud probe,5.0,1.0,5659,5687,-28,784
5554,senate confirm drama nominee key appeal court,senate approve drama nominee key appeal court,5.0,0.8574272558287845,5205,5686,-481,231361
5555,right chief press egypt bursa detention,rights chief dresses egypt dorsi retention,5.0,0.20036159714755525,986,5685,-4699,22080601
5556,senate confirm janet ellen federal reserve chief,senate confirm janet ellen federal reserve hair,5.0,0.8828254926403483,5336,5684,-348,121104
5557,syrian rebel groups battle north,syrian rebel group battle north,5.0,0.7168815403320783,4273,5683,-1410,1988100
5558,mayawati demand president rule kashmir,mayawati demand president rule mamma kashmir,3.0,0.8693173541718662,5264,2949,2315,5359225
5559,agenda president sign anti gay bill,agenda president sign harsh anti gay law,4.0,0.8243874026816976,5009,4486,523,273529
5560,lock dear fly protests seat,lock tear gas fly protest heat,5.0,0.32383555307491646,1563,5563,-4000,16000000
5561,boston come suspect bury virginia,boston bomb suspect bury virginia cemetery,5.0,0.7440186319893718,4491,5655,-1164,1354896
5562,dead philippine restaurant blast,kill philippines restaurant blast,5.0,0.5640846716030271,3135,5561,-2426,5885476
5563,china army newspaper hit prism programme,china army newspaper slum prism program,5.0,0.6488807642123205,3773,5509,-1736,3013696
5564,ilio berlusconi expel italy parliament,ilio berlusconi expel parliament,4.0,0.9161425126622063,5471,4480,991,982081
5565,kill bahrain car explosion,kill bahrain car blast,5.0,0.7032658059492725,4162,5488,-1326,1758276
5566,russia warn respond interest attack ukraine,russia warn respond interest ukraine attack,5.0,1.0,5655,5485,170,28900
5567,bosnia mubarak retreat adjourn june,mubarak retreat adjourn june,4.0,0.8829572925965081,5337,4477,860,739600
5568,egypt protest defy cabinet threat end sit,egypt protest defy cabinet threat,4.0,0.8885188770799046,5357,4468,889,790321
5569,couple marry scientology wedding,couple marry britain scientology wedding,5.0,0.9286877481418332,5510,5493,17,289
5570,later emit hand power son,batard emit hand power son aim,4.0,0.6957070161460128,4104,4507,-403,162409
5571,philippine typhoid death toll fear hit,philippine typhoid death toll rise,3.0,0.7610393869588967,4609,3031,1578,2490084
5572,egypt brace friday anger carnage,egypt brace friday anger bloody crackdown,4.0,0.6458165521178418,3755,4518,-763,582169
5573,red box seat tigers advance world series,red box beat tiger reach world series,4.0,0.494788837130193,2626,4514,-1888,3564544
5574,china land rabbit root rover soon,china land root rover moon,4.0,0.6886981224876735,4059,4511,-452,204304
5575,ukrainian parliament dismiss president,ukraine parliament vote dismiss president,4.0,0.6658539403288178,3892,4508,-616,379456
5576,venezuela lawmaker crawl amid election tension,venezuela lawmaker crawl election,5.0,0.804342443811778,4888,5498,-610,372100
5577,north warn foreigner south advising evacuation,north warn foreigner south evacuate,5.0,0.615233917263045,3526,5491,-1965,3861225
5578,captain sunken south organ ferry arrest,captain baptize s organ merry arrest,4.0,0.4562961724950037,2345,4503,-2158,4656964
5579,war driver plunge river bridge collapse,war plunge river bridge collapse,3.0,0.8995702473400986,5409,2786,2623,6880129
5580,death toll syria top,death toll syria far,5.0,0.7965432279058826,4840,5494,-654,427716
5581,communist rebel ambush philippine police kill,communist rebel kill philippine police,4.0,0.8608662553878702,5224,4501,723,522729
5582,egypt dorsi face trial prison break murder say prosecution,egypt dorsi face trial prison break,3.0,0.7939651376433697,4824,2784,2040,4161600
5583,ran nuclear talks enter,ran nuclear talk enter crucial day,5.0,0.5076471903212253,2714,5500,-2786,7761796
5584,army declare martial law,thailand army declare martial law deny coup,3.0,0.6950558415129144,4100,2781,1319,1739761
5585,woman die ride roller coster texas,woman die ride roller coster texas amusement park,4.0,0.8299940209029196,5048,4499,549,301401
5586,noble author boris passing die,noble prize win author boris passing die,4.0,0.8578305918624405,5209,4451,758,574564
5587,dead typhoid slum central philippines,dead typhoid matter philippines,5.0,0.6397139780431571,3709,5486,-1777,3157729
5588,post office saving bank atm open chennai,india post office saving bank atm inaugurate chennai,4.0,0.8278439093819209,5034,4434,600,360000
5589,israel agree hour ceasefire,israel agree hour papa truce,3.0,0.5770885776781787,3225,2802,423,178929
5590,magnitude strike indonesia sumatra usgs,earthquake magnitude strike indonesia island,3.0,0.4956986392020688,2633,2801,-168,28224
5591,british stuntman fall death wing suit misha,british stuntman die wingsuit misha alps,4.0,0.5110348194840337,2736,4429,-1693,2866249
5592,make india vote jaipur west debate,make india vote debate jaipur literature festival,5.0,0.7207361581299205,4301,5534,-1233,1520289
5593,white diamond break record long long auction,white diamond fetch record auction,4.0,0.6175916181052624,3551,4428,-877,769129
5594,chinese satellite spot large object search area,malaysia chinese satellite find object ocean,3.0,0.5432349441142448,2979,2761,218,47524
5595,james urges hizbullah lighter syria,james call hezbollah pull force syria,5.0,0.2505216347020587,1174,5536,-4362,19027044
5596,russia reach deal syria chemical weapon,china welcome russia deal syria chemical weapon,3.0,0.7237990749737413,4317,2819,1498,2244004
5597,psni fail ruc officer tribunal tell,psni fail ruc officer family,4.0,0.7656222128528094,4635,4438,197,38809
5598,stock edge lower follow retail earning,stock edge lower earning retainer,5.0,0.6543681505147888,3814,5538,-1724,2972176
5599,police helicopter clash scottish pub,police helicopter clash bar glasgow,4.0,0.4334890891919807,2207,4460,-2253,5076009
5600,pressure israel demand papa truce,pressure israel papa,4.0,0.7403074764059726,4458,4450,8,64
5601,australian say confident signal black box,australian confident sound light,4.0,0.45010243783178994,2304,4445,-2141,4583881
5602,angela condition improve,angela condition worst past hour,1.0,0.4223085990851185,2141,1005,1136,1290496
5603,philippe king belgium,philippe ascend throne divide belgium,4.0,0.5266645593884449,2832,4448,-1616,2611456
5604,india anti graft party take charge new delhi,india anti draft party forms government delhi,4.0,0.5363464957288471,2929,4453,-1524,2322576
5605,pain approve new restrictive abortion law,spanish government approve tight restriction abortion,5.0,0.3182676112808945,1531,5540,-4009,16072081
5606,drama order syria gas attack inquiry,urge syria gas attack inspection,2.0,0.43131570926283236,2194,1795,399,159201
5607,german ambassador athens residence shoot,shot fire german ambassador residence athens,5.0,0.8517361666069396,5168,5543,-375,140625
5608,ukraine jail opposition icon tymoshenko walk free,ukraine opposition chief want protest,2.0,0.2898129928576191,1369,1807,-438,191844
5609,oklahoma examine go wrong blotched execution,inmate die heart attack blotched execution,3.0,0.41314372100003294,2088,2834,-746,556516
5610,napolitano elect second term italy president,italian president napolitano elect second term,5.0,0.839443072954272,5103,5545,-442,195364
5611,court convict bosnia croats atrocity,war crimes court convict bosnians croat,4.0,0.24117544692223714,1131,4417,-3286,10797796
5612,maude man pressure cooper arrest detroit airport,maude travel pressure hooker arrest,4.0,0.4260846438738884,2157,4420,-2263,5121169
5613,north say citizen trial,north say detain american tourist face trial,5.0,0.42226660982417374,2140,5560,-3420,11696400
5614,protest escapade amid violence,protest general strike,3.0,0.19092093154462078,949,2856,-1907,3636649
5615,egypt impose state emergency people kill,egypt announce month state emergency nationwide,3.0,0.4490248321167611,2299,2855,-556,309136
5616,ally demand justice trayvon,people rally justice trayvon,4.0,0.5785319331951264,3236,4496,-1260,1587600
5617,warn plight woman child syria,unicef call immediate safe access woman child,3.0,0.17679410968563106,900,2757,-1857,3448449
5618,age dempsey face congress defense budget,age lament political change defence budget,4.0,0.296976640926332,1411,4516,-3105,9641025
5619,bony sell unit cut job,bony axe unit major business overhaul,3.0,0.3874737349445508,1925,2844,-919,844561
5620,kill half police shoot dead,police human kill california shooting,2.0,0.24809004323882888,1158,1877,-719,516961
5621,report elderly american,north report detain war veteran,2.0,0.1687900379128562,863,1865,-1002,1004004
5622,search leader urge caution finding relate miss malaysian jetliner,teacher hope king come lose malaysian airline,1.0,0.1754003186873028,895,1007,-112,12544
5623,angela remember family stadium memorial service plan,angela family thank nation world support,1.0,0.26268294060342,1243,1088,155,24025
5624,ukrainian presidency say deal reach crisis talk,ukraine rival sign deal end crisis,4.0,0.3072165886690075,1467,4362,-2895,8381025
5625,drama mill limit military action syria,drama urge military action syria seek congress,2.0,0.5840984367520805,3279,1838,1441,2076481
5626,syria escape assassination try regime say,syrian prime minister survive assassination attempt,4.0,0.25366174058855695,1192,4353,-3161,9991921
5627,jordan elect maude seat security council,jordan elect security council seat maude arabia reject,3.0,0.8524076005588815,5176,2925,2251,5067001
5628,kill ran mosque come,kill ran funeral,0.0,0.33618728527692954,1636,279,1357,1841449
5629,police surround protest belfast ahead,peaceful anti protest hold belfast,3.0,0.418250601092252,2117,2879,-762,580644
5630,george zimmerman find guilty trayvon martin murder,george zimmerman verdict ropes table news talkradio rode,1.0,0.2759283218133582,1312,1011,301,90601
5631,man rescue waterford dublin coast,rescue boat assize dublin,3.0,0.48703733777976166,2557,2893,-336,112896
5632,angela spend day hospital,angela hospital rd,5.0,0.4745960388433651,2480,5558,-3078,9474084
5633,kill clash slim brotherhood cairo office,egypt protester storm slim brotherhood,2.0,0.3881601758880811,1930,1816,114,12996
5634,maude woman protest drive,maude woman drive protest little problem,2.0,0.7758643849236457,4695,1815,2880,8294400
5635,russian parliament allow ruin use military ukraine,president drama warn russia stay ukraine,1.0,0.14764745378744618,768,1012,-244,59536
5636,elson angela hospital release report incorrect,elson angela hospital stay,2.0,0.5527737790545022,3057,1843,1214,1473796
5637,world stock rise hope red stimulus,red expect maintain stimulus,1.0,0.4358056465861005,2221,1013,1208,1459264
5638,dinner war sanction,impact sanction russia,1.0,0.3306219016540305,1600,1014,586,343396
5639,world hit new stadium death,worker die world stadium,3.0,0.5523533018683777,3054,2797,257,66049
5640,data ano indian small car fail crash test,world cheap car crash test,1.0,0.3719150291599722,1825,1021,804,646416
5641,greece reach agreement troyka ballot trance expect day,debt inspector reach agreement greece,3.0,0.4111019683905961,2073,2806,-733,537289
5642,murray end year wait british win,murray win wimbledon title end britain year agony,5.0,0.4935069510707629,2611,5510,-2899,8404201
5643,malaysia airline plane clash ukraine russia border live,russia pass troop ukraine order,0.0,0.2632809084976832,1246,275,971,942841
5644,determine extent chemical weapons use syria,know far chemical weapon syria civil war,2.0,0.20200131222904605,993,1846,-853,727609
5645,covert war pakistan,new major earthquake rock southwest pakistan,0.0,0.15072214159620062,788,274,514,264196
5646,russia ruin claim authority invade ukraine,kremlin ruin decide russian troop ukraine,2.0,0.2838185833155981,1346,1812,-466,217156
5647,senior cpc official meet dprk leader special envoy,north organ leader send special envoy china,3.0,0.4226989136729935,2144,2809,-665,442225
5648,turkey unrest go despite end park protest,turkish erdogan say duty order crackdown istanbul park protest,1.0,0.22345420707578872,1059,1059,0,0
5649,hope call action climate change draft cyclical,hope urge action climate change draft cyclical,5.0,0.9443321525222774,5543,5517,26,676
5650,singapore share open low thursday,singapore share open high thursday,2.0,0.8072932437758749,4907,1789,3118,9721924
5651,jihadi john,jihadi john,5.0,1.0000000000000002,5721,5520,201,40401
5652,headline major cranial newspaper act,headline cranial newspaper act,2.0,0.9094284956113332,5441,1775,3666,13439556
5653,attorney general older design,attorney general uric older resign,4.0,0.652857396982163,3798,4683,-885,783225
5654,widen actions russia,boost actions russia,5.0,0.5743379376651339,3208,5523,-2315,5359225
5655,sign news gmt,sign news gmt,1.0,1.0,5602,1097,4505,20295025
5656,bones industrial average wednesday,bones industrial average dare monday,2.0,0.6570373287889589,3835,1780,2055,4223025
5657,adj ahead despite crane collapse official vow,adj ahead despite crane collapse,4.0,0.8808990053398711,5328,4646,682,465124
5658,house republicans elect paul speaker,house republicans eye reluctant speaker,3.0,0.5701209486135979,3181,2792,389,151321
5659,sign news gmt,sign news gmt,3.0,1.0,5607,2927,2680,7182400
5660,singapore share open high wednesday,singapore share open low tuesday,1.0,0.6027180899754088,3423,1091,2332,5438224
5661,china treasury bond future open high tuesday,china treasury bond future close mixed wednesday,1.0,0.6354866682856093,3678,1093,2585,6682225
5662,attorney general older design,attorney general uric older design,5.0,0.8774292306215397,5312,5527,-215,46225
5663,headline major cranial newspaper kept,headline cranial newspaper act,3.0,0.6807257325030841,3992,3034,958,917764
5664,china high alert typhoid kalmaegi,china issue yellow alert typhoid kalmaegi,4.0,0.808687182963151,4917,4654,263,69169
5665,maude lead airstrike hit cement capital,maude airstrike semen capital kill,3.0,0.590555079630739,3329,3041,288,82944
5666,ali hunt jihadist nightclub tiller,militant attack ali hunt jihadist nightclub tiller,3.0,0.9174020044296379,5474,3048,2426,5885476
5667,magnitude earthquake strike real,magnitude earthquake strike indonesia,1.0,0.7180467765801732,4281,1095,3186,10150596
5668,tokyo share open high buoyant market,tokyo share open high trace gain,4.0,0.5575102636205179,3088,4648,-1560,2433600
5669,ran parliament back nuclear deal,ran hardliner attack nuclear deal,1.0,0.5213917270766194,2805,1096,1709,2920681
5670,hawaii press hurricane year,hawaii race hurricane year approach,5.0,0.6570083455054614,3834,5515,-1681,2825761
5671,ran coming kill,ran suicide bomber kill,2.0,0.38550777868615027,1909,1967,-58,3364
5672,pierre bold lockdown,pierre reaches final bold lockdown,3.0,0.7846045734415835,4749,3017,1732,2999824
5673,tokyo share open higher buoyant market,tokyo share open higher follow strong performance,4.0,0.567338420790236,3161,4632,-1471,2163841
5674,kill injure china car accident,kill seventeen injure raiwind road accident,0.0,0.4546365689416029,2336,287,2049,4198401
5675,emigrant rescue sea mediterranean,emigrant rescue wooden boat mediterranean,3.0,0.7301887558626586,4369,3056,1313,1723969
5676,lewis hamilton take sole russian,lewis hamilton win inaugural russian,4.0,0.6611520749900788,3859,4689,-830,688900
5677,security council hear semen envoy final,security council urge semen mouths end,2.0,0.44561989083499554,2286,1956,330,108900
5678,israel force arrest palestinians overnight clash local,israel security force arrest palestinians overnight west bank sweep,1.0,0.5888744304363333,3314,1065,2249,5058001
5679,dead injure east china road accident,dead injure central israel traffic accident,0.0,0.4948624200736327,2627,289,2338,5466244
5680,market wait china datum,market china drag,2.0,0.4308270822510238,2187,1961,226,51076
5681,palestinians israel police clash jerusalem al sa,palestinian hot israel police jerusalem lie,2.0,0.39822912749132106,1991,1964,27,729
5682,suspected koko arm suicide comber siberia kill,suspect koko arm attack kill dozen siberia,4.0,0.5502951930841353,3035,4679,-1644,2702736
5683,end long long protest,concern long long protest,2.0,0.7853837763053104,4753,1952,2801,7845601
5684,russian warplane strike inside syria,russian follette syria,2.0,0.32731555854616046,1576,1904,-328,107584
5685,cctv luman tunisia museum attack,kill guns museum attack,1.0,0.4071632215418094,2044,1069,975,950625
5686,log ukraine crisis,log ran turmoil,0.0,0.424251238095749,2151,290,1861,3463321
5687,siberia notes right presidential election,guineas poll presidential elections,2.0,0.15909169754258826,815,1907,-1092,1192464
5688,prince william don samurai gear japan tour,prince william britain arrive seizing,2.0,0.311873442703556,1489,1908,-419,175561
5689,micronesia vice president visit china,vice president bolivia visit china,2.0,0.6060034006347198,3451,1909,1542,2377764
5690,islamic state issue video head hostage,islamic state post second propaganda video hostage,3.0,0.6191150514003694,3557,2948,609,370881
5691,ran end cooperation agreement pakistan,ran tajikistan sign cooperation agreement,2.0,0.5918895951246926,3348,1911,1437,2064969
5692,teenager test negative bold,texas hospital worker test positive bold,1.0,0.40281718440695385,2022,1079,943,889249
5693,texas see syrian refugee,turkey exploit syrian refugee,1.0,0.521283316007488,2802,1081,1721,2961841
5694,new actions target overseas saber attacker,china disagree sanction program overseas saber attacker,2.0,0.5448972105284373,2990,1882,1108,1227664
5695,kill israel air strike papa,militant kill clash air strike ran,0.0,0.4942858853619525,2621,305,2316,5363856
5696,deadly locks coal line ukraine,head despite ease fire ukraine,2.0,0.16196177072921655,825,1887,-1062,1127844
5697,greece ballot uncertainty weigh global market,greece concern drag asia market,3.0,0.3050282483756892,1452,2945,-1493,2229049
5698,money help united beat vernon premier league,west beat newcastle premier league,1.0,0.5178649128998076,2775,994,1781,3171961
5699,hard line jewish leader shoot jerusalem,israel leader urge calm jerusalem,1.0,0.37339158743404116,1836,900,936,876096
5700,backstage moves intensify right islamic state side,fixed progress report right islamic state,2.0,0.34970300466530735,1709,1879,-170,28900
5701,egypt ipi urges release ll jazeera journalist arrest berlin,egypt sentence ll jazeera journalist jail,1.0,0.5213780291032736,2804,898,1906,3632836
5702,occupy palestinian territory israel forces continue shed palestinian blood,occupy palestinian territory israel warn security papa truce talk resume,1.0,0.4690309537769781,2441,916,1525,2325625
5703,tibia order investigation tibia right abuse,india court order investigation job scar death,0.0,0.2514824813040164,1179,301,878,770884
5704,taiwan coast guard launch new ship south china tea tension rise,chinese military reach amid south china tea tension,2.0,0.4344932588714838,2215,1891,324,104976
5705,burundi police fire tear gas protest,montenegrin police fire tear disperse opposition,1.0,0.2992173374894973,1424,912,512,262144
5706,real earthquake death toll surpass,death toll real earthquake top,3.0,0.8145087201382262,4948,2994,1954,3818116
5707,shy parents arrive tradition hearing,shy king parent free jail pain,1.0,0.23778905840555997,1116,905,211,44521
5708,siberia admit slow response bold case,camp response bold crisis,1.0,0.45665967042133127,2348,910,1438,2067844
5709,thousand cross austria hungary border,thousand russians strange abroad,1.0,0.15771683851963297,809,911,-102,10404
5710,kranjcar leave late rescue qpr doses inspire stoke,carry lane leave late rescue point tottenham hotspur,0.0,0.2626542517812358,1242,299,943,889249
5711,scar histories sentence year prison,bookkeeper auschwitz sentence year prison,0.0,0.4041341885345203,2033,298,1735,3010225
5712,fro palestinian activist march headquarters,fro palestinian activist prepare flotilla break papa blockade,2.0,0.4116378578798708,2077,1915,162,26244
5713,eczema face possible charge sex tape case,menendez face possible corruption charge,1.0,0.3684366330727153,1800,919,881,776161
5714,dead russian airline mystery crash,seat flash detect time russian airline crash,2.0,0.40284700495336634,2023,1938,85,7225
5715,hold talk ftii student,cameron hold talk surgeon future,0.0,0.24061953733507865,1128,297,831,690561
5716,announce retirement,senator red cruz announce presidential bid,0.0,0.22941755456862323,1084,296,788,620944
5717,runner fire fail advance champions league,epl club avoid champions league woe,1.0,0.3532524329949386,1725,924,801,641601
5718,cranial president praise nuclear deal,ran arrest spy near nuclear plant,1.0,0.12487754438917473,675,926,-251,63001
5719,koko arm disrupt iberian election,dress wash general election,1.0,0.14560622495365177,760,904,-144,20736
5720,south regret north refusal talk,south report death new case,1.0,0.16443533543512365,837,895,-58,3364
5721,lane crash site search call right,france get stage,0.0,0.0,386,294,92,8464
5722,drama query turnbull china port deal,spanish ball seven death,0.0,0.0,387,291,96,9216
5723,china generous bid see reap big return malaysia,china keep eye visit tiger free russian president,0.0,0.07249317882809996,431,307,124,15376
5724,hezbollah target qaeda gathering border syria,belarus tighten security border ukraine,0.0,0.14769120558783935,769,345,424,179776
5725,south report seven new mer case,south organ woman contact mers patient die,1.0,0.10551148356655579,558,975,-417,173889
5726,drama call international,drama vow save iraqis strange mountain,0.0,0.1958300827189411,970,363,607,368449
5727,military say conduct airstrike syria ran,observatory say russian air strike kill syria,1.0,0.17054726906554127,873,978,-105,11025
5728,abandon plane airport,police abandon post lesotho fear life,0.0,0.3496217253787204,1708,357,1351,1825201
5729,north citizen trial,n hit new sanction,2.0,0.0,388,1947,-1559,2430481
5730,long long official resume work protest thin,long long student leader protest retreat,2.0,0.5491583049931444,3025,1949,1076,1157776
5731,bold nhs staff pack suspect bold case,say investigation suspect mer case,0.0,0.21322880880525977,1025,361,664,440896
5732,leader signals support airstrikes syria,typhus back cameron push air strike syria,1.0,0.08341597369157801,459,985,-526,276676
5733,agree talk south,door crown fifth sultan,0.0,0.0,389,353,36,1296
5734,ran large important partner russia oak,ran reiterate support ran syria,0.0,0.18724905327517732,939,358,581,337561
5735,taiwan president charter plane pay respect,poland president lose challenge,0.0,0.09963712644371892,526,359,167,27889
5736,palestinians die attack israelis ahead merry visit,palestinian official slum israel stone throw bill,0.0,0.0,390,366,24,576
5737,thomas took accuse put cost customer,university florida fat accuse spit wound war veteran,0.0,0.11478841984630705,619,364,255,65025
5738,narendra lodi photoshopped image chennai flood visit go vital,narendra lodi speak non discrimination equality,0.0,0.29853869991964993,1420,348,1072,1149184
5739,chief welcome peaceful presidential election guinea,chief condemn attack peacekeeper ali,1.0,0.1428326794455343,749,941,-192,36864
5740,pakistan execution draw international ire,pakistan protest ceasefire violation india,0.0,0.12009144962758701,648,350,298,88804
5741,australians kill sonya bus crash river,permalink kill germany train accident,0.0,0.06731690122168626,422,347,75,5625
5742,france shut mosque arrest man crackdown attack,security tighten new delhi church attack,2.0,0.09041121094546782,486,1920,-1434,2056356
5743,russian plane reportedly clash egypt,pilot kill jet clash england,2.0,0.16609688689837426,848,1927,-1079,1164241
5744,severe tales storm clodagh britain,jerk pledge nato solidarity latvia,0.0,0.0,391,349,42,1764
5745,dozen egyptians hostage take libyan terrorist revenge airstrike,egyptian boat crash death toll rise body find mile,0.0,0.0,392,351,41,1681
5746,president head bahrain,president china continue help fight bold,0.0,0.14957692697935576,781,362,419,175561
5747,china india vow bilateral tie,china scramble reassure battery stock trader,0.0,0.07982299564775913,449,192,257,66049
5748,ruin spokesman hope charge appear unfounded,late severe weather head texas tornado,0.0,0.0,1,1,0,0
