,sentence1,sentence2,similarity_score,common_word,rank_by_common_word,rank_by_similarity_score,d,d^2
0,"['plane', 'take']","['air', 'plane', 'take']",5.0,2,2042,5749,-3707,13741849
1,"['man', 'play', 'large', 'flute']","['man', 'play', 'flute']",3.799999952316284,3,3478,4143,-665,442225
2,"['man', 'spread', 'screwed', 'cheese', 'penza']","['man', 'spread', 'shrouded', 'cheese', 'unhooked', 'penza']",3.799999952316284,4,3891,4145,-254,64516
3,"['man', 'play', 'chess']","['man', 'play', 'chess']",2.5999999046325684,3,3471,2508,963,927369
4,"['man', 'play', 'cell']","['man', 'seat', 'play', 'cell']",4.25,3,3469,4917,-1448,2096704
5,"['man', 'fight']","['man', 'fight']",4.25,2,2481,4916,-2435,5929225
6,"['man', 'smoke']","['man', 'state']",0.5,1,738,604,134,17956
7,"['man', 'play', 'piano']","['man', 'play', 'guitar']",1.600000023841858,2,2468,1489,979,958441
8,"['man', 'play', 'guitar', 'singing']","['woman', 'play', 'caustic', 'guitar', 'singing']",2.200000047683716,3,3460,2019,1441,2076481
9,"['person', 'throw', 'cat', 'ceiling']","['person', 'throw', 'cat', 'ceiling']",5.0,4,3905,5504,-1599,2556801
10,"['man', 'hit', 'man', 'stick']","['man', 'span', 'man', 'stick']",4.199999809265137,2,2473,4728,-2255,5085025
11,"['woman', 'pick', 'hold', 'baby', 'kangaroo']","['woman', 'pick', 'hold', 'baby', 'kangaroo', 'arm']",4.599999904632568,5,4609,5168,-559,312481
12,"['man', 'play', 'flute']","['man', 'play', 'bamboo', 'flute']",3.867000102996826,3,3480,4335,-855,731025
13,"['person', 'fold', 'piece', 'paper']","['fold', 'piece', 'paper']",4.666999816894531,3,3502,5317,-1815,3294225
14,"['man', 'run', 'road']","['dog', 'run', 'road']",1.6670000553131104,2,2530,1597,933,870489
15,"['dog', 'try', 'bacon']","['dog', 'try', 'eat', 'bacon']",3.75,3,3495,4003,-508,258064
16,"['polar', 'bear', 'slide', 'snow']","['polar', 'bear', 'slide', 'snow']",5.0,4,3866,5541,-1675,2805625
17,"['woman', 'write']","['woman', 'swim']",0.5,1,735,601,134,17956
18,"['cat', 'rub', 'baby', 'face']","['cat', 'rub', 'baby']",3.799999952316284,3,3489,4154,-665,442225
19,"['man', 'ride', 'horse']","['man', 'ride', 'horse']",5.0,3,3486,5547,-2061,4247721
20,"['man', 'hour', 'oil', 'pot']","['man', 'hour', 'wine', 'pot']",3.200000047683716,3,3456,3083,373,139129
21,"['man', 'play', 'guitar']","['girl', 'play', 'guitar']",2.799999952316284,2,2507,2657,-150,22500
22,"['slide', 'slide']","['side', 'slide']",4.599999904632568,1,681,5153,-4472,19998784
23,"['woman', 'eat']","['woman', 'eat', 'meat']",3.0,2,2508,3006,-498,248004
24,"['woman', 'feel', 'potato']","['woman', 'peel', 'potato']",5.0,2,2511,5551,-3040,9241600
25,"['boy', 'fall', 'bike']","['boy', 'fall', 'bike']",4.800000190734863,3,3428,5354,-1926,3709476
26,"['woman', 'play', 'flute']","['woman', 'play', 'flute']",5.0,3,3427,5552,-2125,4515625
27,"['rabbit', 'run', 'eagle']","['hare', 'run', 'eagle']",4.199999809265137,2,2516,4772,-2256,5089536
28,"['woman', 'try', 'dreaded', 'pork', 'chop']","['woman', 'cook', 'dreaded', 'pork', 'chop']",4.199999809265137,4,3879,4774,-895,801025
29,"['girl', 'fly', 'kite']","['girl', 'run', 'fly', 'kite']",4.0,3,3425,4606,-1181,1394761
30,"['man', 'ride', 'mechanical', 'bull']","['man', 'ride', 'mechanical', 'bull']",4.0,4,3881,4575,-694,481636
31,"['man', 'play', 'guitar']","['man', 'play', 'guitar']",4.908999919891357,3,3421,5482,-2061,4247721
32,"['woman', 'dance', 'singe', 'woman']","['woman', 'dance', 'singe', 'rain']",3.0,3,3418,2985,433,187489
33,"['man', 'slide']","['man', 'slide', 'onion']",2.400000095367432,2,2406,2271,135,18225
34,"['man', 'pour', 'oil', 'pan']","['man', 'pour', 'oil', 'skilled']",4.199999809265137,3,3417,4777,-1360,1849600
35,"['lion', 'play', 'people']","['lion', 'play', 'man']",3.400000095367432,2,2410,3520,-1110,1232100
36,"['dog', 'ride', 'skateboard']","['dog', 'ride', 'skateboard']",5.0,3,3451,5508,-2057,4231249
37,"['carve', 'statue']","['man', 'carve', 'statue']",3.75,2,2385,3998,-1613,2601769
38,"['woman', 'slide', 'onion']","['man', 'cut', 'onion']",2.75,1,704,2542,-1838,3378244
39,"['woman', 'feel', 'shrimp']","['woman', 'peel', 'shrimp']",5.0,2,2386,5512,-3126,9771876
40,"['woman', 'try', 'fish']","['woman', 'cook', 'fish']",4.0,2,2393,4539,-2146,4605316
41,"['woman', 'play', 'electric', 'guitar']","['woman', 'play', 'guitar']",3.5999999046325684,3,3440,3948,-508,258064
42,"['baby', 'tiger', 'play', 'ball']","['baby', 'play', 'doll']",1.600000023841858,2,2545,1488,1057,1117249
43,"['person', 'slide', 'tomato']","['person', 'slide', 'meat']",1.75,2,2457,1622,835,697225
44,"['person', 'cut', 'onion']","['person', 'cut', 'onion']",5.0,3,3580,5522,-1942,3771364
45,"['man', 'play', 'piano']","['woman', 'play', 'violin']",1.0,1,880,993,-113,12769
46,"['woman', 'play', 'flute']","['man', 'play', 'guitar']",1.0,1,903,995,-92,8464
47,"['man', 'cut', 'potato']","['man', 'cut', 'carrot']",2.375,2,2422,2172,250,62500
48,"['kid', 'play', 'guitar']","['boy', 'play', 'guitar']",3.799999952316284,2,2431,4164,-1733,3003289
49,"['boy', 'play', 'guitar']","['man', 'play', 'guitar']",3.200000047683716,2,2432,3208,-776,602176
50,"['man', 'play', 'guitar']","['boy', 'play', 'guitar']",3.200000047683716,2,2434,3204,-770,592900
51,"['little', 'boy', 'play', 'keyboard']","['boy', 'play', 'key', 'board']",4.400000095367432,2,2436,5022,-2586,6687396
52,"['man', 'play', 'guitar']","['man', 'play', 'electric', 'guitar']",3.75,3,3573,4025,-452,204304
53,"['dog', 'lick', 'baby']","['dog', 'lick', 'baby']",4.75,3,3572,5338,-1766,3118756
54,"['woman', 'slide', 'onion']","['man', 'cut', 'onion']",3.200000047683716,1,894,3137,-2243,5031049
55,"['man', 'play', 'guitar']","['man', 'play', 'drum']",1.555999994277954,2,2613,1455,1158,1340964
56,"['woman', 'slide', 'pepper']","['woman', 'cut', 'red', 'pepper']",3.937999963760376,2,2639,4342,-1703,2900209
57,"['man', 'play', 'drum']","['man', 'play', 'drum']",5.0,3,3525,5528,-2003,4012009
58,"['woman', 'ride', 'horse']","['woman', 'ride', 'horse']",5.0,3,3519,5529,-2010,4040100
59,"['man', 'eat', 'banana', 'tree']","['man', 'eat', 'banana']",4.0,3,3515,4659,-1144,1308736
60,"['cat', 'play', 'key', 'board']","['man', 'play', 'keyboard']",1.600000023841858,1,945,1485,-540,291600
61,"['man', 'crop', 'tree', 'axe']","['man', 'cut', 'tree', 'axe']",4.75,3,3533,5332,-1799,3236401
62,"['kid', 'play', 'toy', 'phone']","['little', 'boy', 'play', 'toy', 'phone']",3.5,3,3556,3736,-180,32400
63,"['man', 'ride', 'motorcycle']","['man', 'ride', 'horse']",1.399999976158142,2,2569,1343,1226,1503076
64,"['man', 'ride', 'motorcycle']","['man', 'ride', 'horse']",1.399999976158142,2,2611,1342,1269,1610361
65,"['squirrel', 'spin', 'circle']","['squirrel', 'run', 'circle']",4.0,2,2380,4406,-2026,4104676
66,"['man', 'woman', 'kiss']","['man', 'woman', 'kiss']",5.0,3,3305,5514,-2209,4879681
67,"['man', 'get', 'car']","['man', 'get', 'car', 'garage']",3.8329999446868896,3,3274,4331,-1057,1117249
68,"['man', 'dance']","['man', 'talk']",0.6000000238418579,1,930,635,295,87025
69,"['man', 'play', 'guitar', 'singing']","['man', 'play', 'guitar']",2.9170000553131104,3,3272,2755,517,267289
70,"['person', 'cut', 'mushroom']","['person', 'cut', 'mushroom', 'knife']",4.199999809265137,3,3264,4766,-1502,2256004
71,"['tiger', 'cub', 'make', 'sound']","['tiger', 'walk']",2.0,1,826,1844,-1018,1036324
72,"['person', 'slide', 'onion']","['person', 'peel', 'onion']",2.5999999046325684,2,2164,2451,-287,82369
73,"['man', 'play', 'piano']","['man', 'play', 'trumpet']",1.600000023841858,2,2165,1483,682,465124
74,"['woman', 'peel', 'potato']","['woman', 'peel', 'apple']",2.0,2,2129,1822,307,94249
75,"['canada', 'eat', 'bamboo']","['bear', 'eat', 'bamboo']",4.199999809265137,2,2132,4740,-2608,6801664
76,"['person', 'peel', 'onion']","['person', 'peel', 'eggplant']",2.0,2,2137,1827,310,96100
77,"['monkey', 'push', 'monkey']","['monkey', 'push', 'monkey']",4.800000190734863,2,2142,5356,-3214,10329796
78,"['squirrel', 'run', 'circle']","['squirrel', 'move', 'circle']",4.400000095367432,2,2146,5083,-2937,8625969
79,"['man', 'tie', 'shoe']","['man', 'tie', 'shoe']",5.0,3,3302,5688,-2386,5692996
80,"['boy', 'singe', 'play', 'piano']","['boy', 'play', 'piano']",3.0,3,3300,3000,300,90000
81,"['dog', 'eat', 'water', 'melon']","['dog', 'eat', 'piece', 'watermelon']",4.25,2,2188,4938,-2750,7562500
82,"['woman', 'chop', 'broccoli']","['woman', 'chop', 'broccoli', 'knife']",4.25,3,3299,4941,-1642,2696164
83,"['man', 'peel', 'potato']","['man', 'peel', 'potato']",3.799999952316284,3,3295,4187,-892,795664
84,"['woman', 'play', 'guitar']","['man', 'play', 'guitar']",2.400000095367432,2,2196,2215,-19,361
85,"['woman', 'slide', 'tomato']","['man', 'slide', 'onion']",1.600000023841858,1,860,1482,-622,386884
86,"['man', 'swim', 'underwater']","['woman', 'swim', 'underwater']",2.0,2,2197,1919,278,77284
87,"['man', 'woman', 'talk']","['man', 'woman', 'eat']",1.600000023841858,2,2198,1480,718,515524
88,"['small', 'dog', 'chase', 'ball']","['dog', 'chase', 'ball']",4.0,3,3290,4398,-1108,1227664
89,"['man', 'play', 'cricket']","['man', 'play', 'basketball']",2.200000047683716,2,2207,2042,165,27225
90,"['man', 'ride', 'motorcycle']","['man', 'ride', 'motorcycle']",4.400000095367432,3,3286,5106,-1820,3312400
91,"['man', 'play', 'guitar']","['man', 'singe', 'play', 'guitar']",3.5999999046325684,3,3285,3888,-603,363609
92,"['man', 'talk', 'telephone']","['man', 'talk', 'phone']",3.5999999046325684,2,2187,3901,-1714,2937796
93,"['man', 'fish']","['man', 'exercise']",0.5,1,415,594,-179,32041
94,"['man', 'hesitate']","['man', 'talk']",0.800000011920929,1,421,777,-356,126736
95,"['boy', 'drive']","['day', 'dance']",0.6000000238418579,0,402,627,-225,50625
96,"['man', 'ride', 'horse']","['girl', 'ride', 'horse']",2.5999999046325684,2,2171,2413,-242,58564
97,"['man', 'ride', 'bicycle']","['monkey', 'ride', 'bike']",2.0,1,403,1897,-1494,2232036
98,"['man', 'slide', 'potato']","['woman', 'peel', 'potato']",2.200000047683716,1,507,2110,-1603,2569609
99,"['woman', 'peel', 'potato']","['man', 'slide', 'potato']",2.400000095367432,1,516,2183,-1667,2778889
100,"['man', 'play', 'guitar']","['play', 'guitar']",3.5999999046325684,2,2172,3896,-1724,2972176
101,"['woman', 'slide', 'week']","['woman', 'slide', 'ginger']",2.200000047683716,2,2173,1997,176,30976
102,"['man', 'cut', 'paper', 'plate']","['man', 'cut', 'paper', 'plate']",4.800000190734863,4,4123,5385,-1262,1592644
103,"['man', 'play', 'guitar']","['man', 'play', 'flute']",1.6430000066757202,2,2070,1594,476,226576
104,"['man', 'play', 'piano']","['man', 'play', 'violin']",1.75,2,2072,1607,465,216225
105,"['woman', 'slide', 'meat']","['woman', 'read', 'meat']",2.25,2,2074,2154,-80,6400
106,"['man', 'play', 'keyboard']","['man', 'play', 'keyboard', 'piano']",4.0,3,3215,4685,-1470,2160900
107,"['lady', 'chop', 'green', 'onion']","['lady', 'cut', 'green', 'onion']",4.800000190734863,3,3214,5379,-2165,4687225
108,"['sit', 'nodule', 'water']","['woman', 'boil', 'nodule', 'water']",3.200000047683716,2,2079,3259,-1180,1392400
109,"['iogel', 'fichte', 'dance', 'ceiling']","['iogel', 'ritchie', 'dance', 'stand', 'ceiling']",4.0,3,3212,4562,-1350,1822500
110,"['man', 'play', 'piano']","['person', 'play', 'piano']",4.400000095367432,2,2081,4999,-2918,8514724
111,"['woman', 'play', 'flute']","['woman', 'play', 'flute']",4.599999904632568,3,3210,5152,-1942,3771364
112,"['boy', 'check', 'callender']","['boy', 'look', 'calendar']",3.799999952316284,1,500,4066,-3566,12716356
113,"['woman', 'cut', 'onion']","['woman', 'chop', 'onion']",4.800000190734863,2,2082,5373,-3291,10830681
114,"['man', 'play', 'guitar']","['man', 'play', 'guitar']",4.85699987411499,3,3209,5480,-2271,5157441
115,"['woman', 'sewing', 'machine']","['woman', 'sewing', 'machine']",5.0,3,3208,5673,-2465,6076225
116,"['woman', 'slip', 'pancake']","['cartoon', 'chef', 'slip', 'pancake']",2.532999992370605,2,2047,2366,-319,101761
117,"['man', 'run', 'road']","['car', 'drive', 'road']",1.0,1,420,1068,-648,419904
118,"['man', 'ride', 'horse']","['man', 'talk', 'phone']",1.0,1,423,1074,-651,423801
119,"['man', 'ride', 'bike']","['man', 'ride', 'horse']",2.0,2,2051,1802,249,62001
120,"['woman', 'dance']","['man', 'eat']",0.1430000066757202,0,379,370,9,81
121,"['man', 'play', 'piano']","['man', 'play', 'flute']",2.0,2,2056,1798,258,66564
122,"['man', 'play', 'flute']","['man', 'play', 'piano']",1.600000023841858,2,2057,1474,583,339889
123,"['man', 'spin']","['man', 'dance']",1.600000023841858,1,449,1481,-1032,1065024
124,"['monkey', 'swinge', 'limb', 'limb']","['monkey', 'swinge', 'tree', 'tree']",3.400000095367432,2,2058,3539,-1481,2193361
125,"['people', 'get', 'train']","['people', 'get', 'train', 'station']",4.0,3,3245,4550,-1305,1703025
126,"['dog', 'jump', 'trampling']","['dog', 'ounce', 'trampling']",4.800000190734863,2,2104,5392,-3288,10810944
127,"['boy', 'play', 'instrument']","['man', 'play', 'trumpet']",2.5,1,428,2353,-1925,3705625
128,"['woman', 'play', 'guitar']","['man', 'sing', 'play', 'guitar']",1.75,2,2107,1609,498,248004
129,"['woman', 'pick']","['woman', 'slide', 'tomato']",1.0,1,526,983,-457,208849
130,"['man', 'climb', 'rope']","['man', 'limb', 'rope']",5.0,2,2110,5730,-3620,13104400
131,"['man', 'lift', 'car']","['man', 'climb', 'wall']",1.399999976158142,1,617,1333,-716,512656
132,"['man', 'woman', 'drive', 'street', 'deep']","['man', 'woman', 'drive', 'road', 'open', 'air', 'vehicle']",4.0,3,3237,4345,-1108,1227664
133,"['shortness', 'man', 'sit', 'chair']","['shortness', 'man', 'sit', 'chair']",3.799999952316284,4,4146,4267,-121,14641
134,"['woman', 'wrest']","['woman', 'wrest', 'floor']",4.0,2,2117,4465,-2348,5513104
135,"['puppy', 'play', 'blue', 'tennis', 'ball']","['puppy', 'play', 'tennis', 'ball']",4.0,4,4148,4426,-278,77284
136,"['kangroo', 'eat']","['kangaroo', 'eat']",4.800000190734863,1,603,5365,-4762,22676644
137,"['cat', 'play', 'piano']","['man', 'play', 'guitar']",0.6000000238418579,1,626,725,-99,9801
138,"['man', 'cut', 'carpet', 'knife']","['man', 'cut', 'carpet', 'knife']",4.75,4,4073,5341,-1268,1607824
139,"['woman', 'ride', 'motorize', 'soon', 'road']","['man', 'ride', 'motor', 'soon']",2.200000047683716,2,2122,2009,113,12769
140,"['slide', 'vegetable']","['slide', 'tomato']",3.0,1,628,3067,-2439,5948721
141,"['woman', 'dance']","['man', 'talk']",0.0,0,386,318,68,4624
142,"['dog', 'lick', 'baby', 'droop']","['dog', 'lick', 'baby']",2.200000047683716,3,3306,2048,1258,1582564
143,"['man', 'row', 'boat']","['man', 'slide', 'tomato']",0.4000000059604645,1,638,478,160,25600
144,"['man', 'cut', 'potato']","['man', 'slice', 'potato']",4.800000190734863,2,2124,5407,-3283,10778089
145,"['woman', 'chop', 'garlic']","['woman', 'dine', 'garlic']",4.800000190734863,2,2105,5422,-3317,11002489
146,"['animal', 'run', 'circle']","['squirrel', 'run', 'circle']",3.799999952316284,2,2103,4300,-2197,4826809
147,"['man', 'walk', 'slowly', 'rope', 'bridge']","['boy', 'walk', 'bridge']",3.0,2,2086,2929,-843,710649
148,"['man', 'play', 'guitar']","['man', 'seat', 'room', 'play', 'guitar']",4.0,3,3377,4361,-984,968256
149,"['man', 'play', 'flute']","['man', 'play', 'flute']",5.0,3,3376,5727,-2351,5527201
150,"['woman', 'crack', 'egg', 'glass', 'bowl']","['woman', 'crack', 'egg', 'bowl']",3.799999952316284,4,3997,4240,-243,59049
151,"['man', 'cut', 'fish']","['man', 'gun', 'fish']",3.0,2,2094,2950,-856,732736
152,"['man', 'pack', 'suitcase', 'trunk', 'car']","['man', 'put', 'suitcase', 'car', 'trunk']",4.400000095367432,4,4003,4991,-988,976144
153,"['man', 'hour', 'oil', 'tomato']","['man', 'pour', 'oil', 'cut', 'potato']",3.799999952316284,2,2096,4324,-2228,4963984
154,"['man', 'slide']","['man', 'slide']",3.0,2,2098,3015,-917,840889
155,"['man', 'waddle', 'canoe']","['man', 'play', 'harp']",0.6669999957084656,1,532,729,-197,38809
156,"['man', 'woman', 'walk', 'wood']","['man', 'woman', 'walk', 'arm', 'arm', 'wooded', 'area']",4.0,3,3366,4581,-1215,1476225
157,"['woman', 'pick', 'kangaroo']","['woman', 'pick', 'baby', 'kangaroo']",3.75,3,3365,4050,-685,469225
158,"['wish', 'swim']","['fish', 'swim']",4.132999897003174,1,527,4703,-4176,17438976
159,"['woman', 'mix', 'food', 'processor']","['woman', 'slender']",4.0,1,560,4663,-4103,16834609
160,"['person', 'surge', 'large', 'wave']","['person', 'surge']",3.5999999046325684,2,2101,3784,-1683,2832489
161,"['man', 'play', 'guitar']","['man', 'stab', 'target']",1.2000000476837158,1,587,1209,-622,386884
162,"['man', 'play', 'flute', 'band']","['man', 'play', 'guitar']",1.600000023841858,2,2102,1498,604,364816
163,"['man', 'spread', 'butter', 'loaf', 'bread']","['man', 'spread', 'butter', 'bread']",4.0,4,4008,4383,-375,140625
164,"['person', 'boil', 'nodule']","['woman', 'boil', 'nodule', 'water']",4.0,2,2211,4379,-2168,4700224
165,"['group', 'people', 'dance', 'hill']","['group', 'people', 'dance']",3.200000047683716,3,3379,3178,201,40401
166,"['man', 'dance', 'outside']","['man', 'play', 'flute']",1.0,1,581,1029,-448,200704
167,"['woman', 'feed', 'man']","['woman', 'mix', 'meat']",1.0,1,580,1030,-450,202500
168,"['man', 'put', 'pan', 'oven']","['woman', 'cut', 'onion']",0.6000000238418579,0,401,706,-305,93025
169,"['woman', 'sit', 'desk']","['woman', 'ride', 'donkey']",0.4000000059604645,1,578,467,111,12321
170,"['relics', 'transport', 'patient', 'stretcher']","['doctor', 'rush', 'patient', 'stretcher']",3.400000095367432,2,2322,3560,-1238,1532644
171,"['woman', 'play', 'flute', 'stage']","['woman', 'play', 'flute']",3.5999999046325684,3,3404,3761,-357,127449
172,"['baby', 'hand', 'play']","['hand', 'lay']",3.0,1,568,2861,-2293,5257849
173,"['baby', 'laugh']","['baby', 'laugh', 'tingling']",4.0,2,2325,4626,-2301,5294601
174,"['man', 'play', 'guitar']","['boy', 'play', 'piano']",1.2000000476837158,1,561,1208,-647,418609
175,"['man', 'fold', 'paper']","['woman', 'slide', 'pepper']",0.6000000238418579,0,400,704,-304,92416
176,"['woman', 'dance']","['man', 'dance']",1.600000023841858,1,1361,1497,-136,18496
177,"['cat', 'play']","['cat', 'fight']",2.5999999046325684,1,1325,2471,-1146,1313316
178,"['person', 'write']","['person', 'write', 'pencil']",3.5999999046325684,2,2326,3777,-1451,2105401
179,"['man', 'run']","['man', 'run', 'road']",3.5,2,2327,3705,-1378,1898884
180,"['woman', 'roll', 'dough']","['woman', 'floor', 'rolling', 'dough']",3.765000104904175,2,2329,4058,-1729,2989441
181,"['woman', 'add', 'space', 'meat']","['woman', 'add', 'sugar', 'meat']",2.75,3,3399,2564,835,697225
182,"['woman', 'add', 'oil', 'fish']","['woman', 'pour', 'water', 'fish']",2.25,2,2316,2145,171,29241
183,"['young', 'boy', 'hold', 'guitar']","['little', 'boy', 'play', 'guitar']",2.75,2,2334,2545,-211,44521
184,"['cheetah', 'run']","['cheetah', 'run', 'field']",3.799999952316284,2,2315,4086,-1771,3136441
185,"['man', 'eat', 'penza']","['man', 'eat', 'slice', 'penza']",4.800000190734863,3,3396,5436,-2040,4161600
186,"['orangutan', 'ride', 'bus']","['monkey', 'ride', 'bus']",3.5999999046325684,2,2299,3807,-1508,2274064
187,"['man', 'woman', 'talk', 'dinner']","['man', 'woman', 'ride', 'bicycle']",1.2000000476837158,2,2300,1207,1093,1194649
188,"['man', 'play', 'guitar']","['man', 'clean', 'glass', 'door']",0.4000000059604645,1,1363,570,793,628849
189,"['girl', 'singe', 'play', 'guitar']","['young', 'man', 'singe', 'play', 'guitar']",2.400000095367432,3,3388,2173,1215,1476225
190,"['girl', 'communicate', 'sign', 'language']","['young', 'girl', 'sign', 'language']",3.940999984741211,3,3387,4343,-956,913936
191,"['woman', 'weight', 'exercise']","['woman', 'hair']",0.5,1,1266,615,651,423801
192,"['man', 'get', 'inside', 'car']","['elderly', 'man', 'get', 'red', 'car']",3.75,3,3385,4005,-620,384400
193,"['big', 'green', 'ball', 'knock', 'potato']","['large', 'green', 'ball', 'hit', 'potato']",4.0,3,3384,4653,-1269,1610361
194,"['cat', 'play', 'keyboard']","['cat', 'play', 'piano']",3.0,2,2305,3005,-700,490000
195,"['dog', 'swim', 'pool']","['dog', 'swim', 'pool']",4.199999809265137,3,3206,4864,-1658,2748964
196,"['man', 'copper', 'chop', 'onion']","['man', 'machine', 'chop', 'potato']",2.0,2,2308,1932,376,141376
197,"['woman', 'slice']","['woman', 'cut']",5.0,1,1254,5605,-4351,18931201
198,"['herd', 'deer', 'cross', 'street']","['herd', 'carbon', 'cross', 'road']",3.0,2,2310,3054,-744,553536
199,"['person', 'ride', 'horse']","['man', 'ride', 'horse']",3.799999952316284,2,2311,4190,-1879,3530641
200,"['feed', 'animal']","['play', 'piano']",0.0,0,356,277,79,6241
201,"['slide', 'tortila']","['ride', 'horse']",0.0,0,352,276,76,5776
202,"['mix', 'ingredient']","['sew', 'thing']",0.25,0,351,442,-91,8281
203,"['monster', 'neck', 'dead', 'mouse']","['chicken', 'pack', 'dead', 'mouse']",4.0,2,2335,4397,-2062,4251844
204,"['woman', 'hold', 'kangaroo']","['woman', 'pick', 'kangaroo']",3.25,2,2336,3373,-1037,1075369
205,"['man', 'play', 'frog']","['cat', 'play', 'camera']",0.75,1,1287,734,553,305809
206,"['man', 'talk']","['man', 'play', 'guitar']",1.5,1,1285,1448,-163,26569
207,"['man', 'spread', 'butter', 'big', 'piece', 'bread']","['man', 'smear', 'butter', 'slice', 'garlic', 'bread']",3.5,3,3323,3731,-408,166464
208,"['man', 'run', 'high', 'wire']","['man', 'run', 'rope']",3.0,2,2361,3053,-692,478864
209,"['man', 'mow', 'lawn']","['woman', 'cut', 'lemon']",0.2000000029802322,0,346,399,-53,2809
210,"['man', 'open', 'door']","['man', 'play', 'guitar']",0.800000011920929,1,1314,830,484,234256
211,"['man', 'slide', 'potato', 'piece']","['man', 'cut', 'potato']",4.199999809265137,2,2362,4823,-2461,6056521
212,"['woman', 'cut', 'cook', 'octopus']","['woman', 'chop', 'octopus']",3.799999952316284,2,2366,4189,-1823,3323329
213,"['man', 'munch', 'board']","['dog', 'run', 'water']",0.4000000059604645,0,343,527,-184,33856
214,"['man', 'dance']","['man', 'eat', 'bread']",0.800000011920929,1,1321,799,522,272484
215,"['play', 'piano']","['man', 'play', 'guitar']",1.2000000476837158,1,1359,1204,155,24025
216,"['fox', 'eat', 'plate', 'brick', 'ratio']","['box', 'eat', 'plate']",2.799999952316284,2,2369,2700,-331,109561
217,"['boy', 'play', 'key', 'board']","['boy', 'play', 'piano']",3.200000047683716,2,2371,3230,-859,737881
218,"['person', 'play', 'keyboard']","['play', 'keyboard']",5.0,2,2372,5575,-3203,10259209
219,"['man', 'shoot', 'gun']","['man', 'spit']",0.0,1,1297,304,993,986049
220,"['slide', 'onion']","['peel', 'potato']",1.0,0,387,902,-515,265225
221,"['man', 'swim']","['woman', 'slide', 'meat']",0.0,0,373,303,70,4900
222,"['man', 'play', 'guitar']","['man', 'play', 'caustic', 'guitar']",3.75,3,3316,4055,-739,546121
223,"['woman', 'slide', 'pushkin']","['woman', 'ride', 'elephant']",0.4000000059604645,1,1317,540,777,603729
224,"['woman', 'dance']","['woman', 'knead', 'dough']",0.4000000059604645,1,1313,541,772,595984
225,"['woman', 'crack', 'egg', 'bowl']","['woman', 'place', 'skewer', 'rack']",0.6000000238418579,1,1306,681,625,390625
226,"['car', 'move', 'road']","['car', 'drive', 'road']",4.0,2,2374,4686,-2312,5345344
227,"['dress', 'pan']",['lay'],0.4000000059604645,0,366,564,-198,39204
228,"['man', 'play', 'guitar']","['man', 'drain', 'past']",0.4000000059604645,1,1272,563,709,502681
229,"['woman', 'drink', 'vodka']","['woman', 'exercise']",0.4000000059604645,1,1356,559,797,635209
230,"['woman', 'cut', 'meat', 'piece']","['woman', 'cut', 'meat']",4.800000190734863,3,3312,5415,-2103,4422609
231,"['man', 'rinse', 'speak']","['man', 'play', 'guitar']",0.6000000238418579,1,1337,663,674,454276
232,"['man', 'sell', 'item']","['man', 'clean', 'house']",0.800000011920929,1,1349,823,526,276676
233,"['man', 'jump', 'wall']","['man', 'jump', 'short', 'wall']",3.200000047683716,3,3310,3260,50,2500
234,"['runner', 'race', 'track']","['runner', 'compete', 'race']",3.200000047683716,2,2356,3263,-907,822649
235,"['man', 'kick', 'soccer', 'ball']","['man', 'mix', 'bowl']",0.6000000238418579,1,1051,676,375,140625
236,"['woman', 'try']","['woman', 'ride', 'horse']",0.6000000238418579,1,1053,672,381,145161
237,"['cat', 'lick', 'suck']","['woman', 'slide', 'cucumber']",0.0,0,377,292,85,7225
238,"['woman', 'dance', 'fire']","['woman', 'take', 'bath']",1.399999976158142,1,1060,1346,-286,81796
239,"['man', 'slide', 'fish', 'open']","['man', 'slide', 'potato']",2.200000047683716,2,2355,1985,370,136900
240,"['utter', 'melt', 'pan']","['man', 'melt', 'butter', 'pan']",3.5999999046325684,2,2338,3806,-1468,2155024
241,"['boy', 'dance']","['lid', 'dance']",3.111000061035156,1,1058,3076,-2018,4072324
242,"['woman', 'play', 'game', 'man']","['man', 'play', 'piano']",0.6000000238418579,2,2339,697,1642,2696164
243,"['man', 'drive', 'white', 'car']","['man', 'give', 'interview']",0.4000000059604645,1,1029,557,472,222784
244,"['man', 'drive', 'car']","['man', 'drive', 'car']",4.25,3,3331,4909,-1578,2490084
245,"['car', 'back', 'space']","['car', 'back', 'blocked', 'lane']",3.0,2,2345,2854,-509,259081
246,"['man', 'put', 'cheese', 'penza']","['man', 'sprinkle', 'cheese', 'penza']",5.0,3,3351,5654,-2303,5303809
247,"['boy', 'play', 'piano']","['boy', 'play', 'piano']",5.0,3,3349,5647,-2298,5280804
248,"['man', 'play', 'guitar']","['man', 'play', 'guitar']",3.75,3,3345,4038,-693,480249
249,"['man', 'ride', 'horse']","['man', 'play', 'keyboard']",0.2000000029802322,1,979,379,600,360000
250,"['man', 'walk', 'rope']","['man', 'ride', 'mo', 'pad']",0.4000000059604645,1,1243,534,709,502681
251,"['girl', 'play', 'flute']","['band', 'play', 'stage']",1.2860000133514404,1,964,1260,-296,87616
252,"['people', 'step', 'train']","['group', 'people', 'train']",4.599999904632568,2,2251,5161,-2910,8468100
253,"['woman', 'sewing', 'machine']","['woman', 'read', 'meat']",0.6000000238418579,1,966,722,244,59536
254,"['dog', 'look', 'swimming', 'pool']","['dog', 'walk', 'pool']",2.0,2,2233,1874,359,128881
255,"['man', 'mutter', 'piece', 'bread']","['man', 'apply', 'butter', 'bread']",5.0,2,2235,5630,-3395,11526025
256,"['man', 'cut', 'potato', 'piece']","['woman', 'cut', 'vegetable']",1.7999999523162842,1,968,1670,-702,492804
257,"['teenage', 'girl', 'dance', 'room']","['teenage', 'girl', 'dance', 'camera']",2.400000095367432,3,3339,2265,1074,1153476
258,"['lion', 'walk']","['lion', 'pace', 'pen']",2.400000095367432,1,991,2293,-1302,1695204
259,"['man', 'shoot', 'car']","['man', 'cut', 'potato']",0.4000000059604645,1,1020,460,560,313600
260,"['black', 'horse', 'run']","['horse', 'run']",4.199999809265137,2,2237,4771,-2534,6421156
261,"['woman', 'evening', 'shrimp']","['man', 'dance', 'rain']",0.0,0,344,355,-11,121
262,"['man', 'ride', 'horse']","['woman', 'wash', 'freeze']",0.0,0,342,352,-10,100
263,"['man', 'walk', 'path']","['man', 'walk', 'tight', 'rope']",0.800000011920929,2,2239,751,1488,2214144
264,"['man', 'slide', 'potato']","['woman', 'cut', 'jalepeno']",1.399999976158142,0,339,1371,-1032,1065024
265,"['dog', 'bark', 'ball']","['dog', 'swim', 'tennis', 'ball']",1.5,2,2240,1432,808,652864
266,"['kid', 'run', 'away', 'fish', 'swinge', 'fishing', 'pole']","['little', 'kid', 'run', 'fishing', 'pole']",2.5,4,4033,2356,1677,2812329
267,"['man', 'walk', 'path', 'wilderness']","['man', 'walk', 'road']",2.5,2,2242,2331,-89,7921
268,"['elderly', 'man', 'speak', 'sodium']","['man', 'make', 'speech', 'sodium']",3.5,2,2243,3735,-1492,2226064
269,"['man', 'ride', 'horse', 'slow', 'motion']","['man', 'ride', 'horse']",3.400000095367432,3,3336,3511,-175,30625
270,"['person', 'cut', 'bursata', 'cheese']","['person', 'slide', 'cheese']",3.799999952316284,2,2245,4166,-1921,3690241
271,"['man', 'shoot', 'automatic', 'rifle']","['man', 'shoot', 'gun']",3.799999952316284,2,2247,4163,-1916,3671056
272,"['man', 'crush', 'garlic', 'knife']","['woman', 'slide', 'meat', 'knife']",1.5,1,1178,1441,-263,69169
273,"['woman', 'file', 'fingernail', 'board']","['woman', 'feed', 'baby', 'bottle']",0.5,1,1174,610,564,318096
274,"['man', 'ride', 'skateboard']","['woman', 'cut', 'potato']",0.0,0,367,269,98,9604
275,"['woman', 'take', 'shower']","['man', 'ride', 'white', 'horse']",0.0,0,368,134,234,54756
276,"['man', 'dance']","['man', 'ride', 'horse']",0.800000011920929,1,1179,770,409,167281
277,"['man', 'row', 'boat']","['man', 'shoot', 'gun']",0.8500000238418579,1,1186,887,299,89401
278,"['man', 'swinge', 'rope', 'attach', 'ceiling']","['man', 'swinge', 'rope']",3.400000095367432,3,3335,3538,-203,41209
279,"['woman', 'ride', 'horse', 'beach']","['man', 'carry', 'man']",0.4000000059604645,0,370,477,-107,11449
280,"['man', 'hold', 'small', 'animal', 'hand']","['man', 'show', 'small', 'monkey']",1.75,2,2232,1621,611,373321
281,"['person', 'fold', 'square', 'paper', 'piece']","['man', 'fold', 'paper']",3.25,2,2231,3346,-1115,1243225
282,"['person', 'try', 'meat', 'pan']","['person', 'hold', 'sunk']",0.75,1,1187,743,444,197136
283,"['chimpanzee', 'hurt', 'woman']","['man', 'drive', 'car']",0.0,0,371,97,274,75076
284,"['woman', 'peel', 'shrimp']","['man', 'hold', 'femur']",0.0,0,372,96,276,76176
285,"['debris', 'play']","['debris', 'socialize']",4.25,1,1226,4915,-3689,13608721
286,"['woman', 'slide', 'butter']","['woman', 'slice']",1.7999999523162842,1,1228,1724,-496,246016
287,"['man', 'play', 'guitar']","['man', 'play', 'guitar', 'singe']",3.200000047683716,3,3558,3179,379,143641
288,"['elephant', 'spray', 'water']","['elephant', 'spray', 'water']",3.5999999046325684,3,3764,3757,7,49
289,"['dog', 'sit', 'counter', 'store']","['dog', 'stand', 'counter']",2.5999999046325684,2,2215,2423,-208,43264
290,"['drill', 'hole', 'strip', 'wood', 'power', 'drill']","['man', 'drill', 'hole', 'piece', 'wood']",3.200000047683716,3,3776,3094,682,465124
291,"['woman', 'slide', 'vegetable']","['woman', 'dine', 'garlic']",2.799999952316284,1,1233,2725,-1492,2226064
292,"['badge', 'burrow', 'hole']","['badge', 'dig', 'earth']",4.599999904632568,1,1234,5273,-4039,16313521
293,"['woman', 'water', 'skin', 'lake']","['man', 'play', 'flute']",0.0,0,384,91,293,85849
294,"['girl', 'play', 'violin']","['baby', 'laugh', 'tingling']",0.25,0,385,447,-62,3844
295,"['helicopter', 'land', 'helped']","['helicopter', 'land']",3.92300009727478,2,2218,4338,-2120,4494400
296,"['woman', 'cut', 'chicken']","['woman', 'slide', 'meat']",2.75,1,1239,2541,-1302,1695204
297,"['woman', 'cut', 'cucumber']","['man', 'play', 'guitar']",0.0,0,349,90,259,67081
298,"['woman', 'ride', 'elephant', 'adoring', 'crowd']","['woman', 'ride', 'elephant']",3.0,3,3779,3024,755,570025
299,"['puppy', 'slide', 'backwards', 'floor']","['puppy', 'push', 'backwards']",3.799999952316284,2,2220,4150,-1930,3724900
300,"['woman', 'splint', 'garlic', 'glove']","['woman', 'break', 'head', 'garlic', 'glove']",4.599999904632568,3,3782,5304,-1522,2316484
301,"['dog', 'look', 'swimming', 'pool']","['dog', 'walk', 'edge', 'pool']",2.5999999046325684,2,2225,2512,-287,82369
302,"['woman', 'mile', 'beauty', 'treatment', 'glass']","['woman', 'mix', 'cream', 'glass', 'spoon']",3.5999999046325684,2,2226,3747,-1521,2313441
303,"['man', 'draw', 'picture']","['person', 'draw']",3.5999999046325684,1,1219,3750,-2531,6405961
304,"['woman', 'pick', 'potato']","['woman', 'pour', 'matter', 'bowl']",1.0,1,1220,943,277,76729
305,"['man', 'look', 'computer', 'monitor']","['man', 'lawton']",2.75,1,1221,2554,-1333,1776889
306,"['boy', 'ride', 'trickle']","['woman', 'ride', 'water', 'soon']",1.25,1,1171,1251,-80,6400
307,"['man', 'compete', 'tire', 'roll', 'race']","['people', 'slip', 'traitor', 'tire', 'race']",2.75,2,2252,2558,-306,93636
308,"['person', 'cut', 'meat']","['person', 'ride', 'mechanical', 'bull']",0.0,1,1169,89,1080,1166400
309,"['man', 'play', 'violin']","['woman', 'sewing', 'machine']",0.0,0,389,88,301,90601
310,"['baby', 'crawl', 'doorway']","['baby', 'crawl', 'floor']",2.400000095367432,2,2272,2266,6,36
311,"['man', 'play', 'keyboard']","['person', 'play', 'piano']",2.200000047683716,1,1118,2041,-923,851929
312,"['man', 'smell', 'pizza']","['woman', 'feed', 'man']",0.2000000029802322,1,1121,425,696,484416
313,"['monkey', 'pull', 'tail', 'dog']","['monkey', 'tease', 'dog']",2.799999952316284,2,2253,2660,-407,165649
314,"['dog', 'lie', 'wooden', 'floor']","['dog', 'lay', 'floor']",4.0,2,2275,4610,-2335,5452225
315,"['woman', 'try', 'pan']","['man', 'play', 'guitar']",0.0,0,354,87,267,71289
316,"['man', 'put', 'reasoning', 'bowl', 'water']","['man', 'add', 'reasoning', 'water', 'bowl']",5.0,4,4046,5626,-1580,2496400
317,"['elderly', 'woman', 'pour', 'oil', 'try', 'pan']","['tied', 'man', 'put', 'water']",0.0,0,357,86,271,73441
318,"['woman', 'chop', 'onion']","['woman', 'slide', 'partially', 'half', 'onion']",3.200000047683716,2,2277,3086,-809,654481
319,"['woman', 'pick', 'kangaroo']","['woman', 'carry', 'kangaroo']",3.5,2,2280,3690,-1410,1988100
320,"['dog', 'bite']","['dog', 'open', 'food']",1.75,1,1131,1610,-479,229441
321,"['woman', 'define', 'fish']","['man', 'catch', 'fish']",1.25,1,1101,1246,-145,21025
322,"['man', 'mow', 'grass']","['man', 'burst', 'concrete']",0.8330000042915344,1,1102,886,216,46656
323,"['cat', 'watch']","['man', 'slide', 'leave']",0.0,0,362,82,280,78400
324,"['boy', 'stick', 'door', 'hothouse']","['child', 'stick', 'dog', 'house']",3.75,1,1115,3999,-2884,8317456
325,"['people', 'lip', 'swimming', 'pool']","['man', 'fall', 'pool']",2.75,1,1135,2546,-1411,1990921
326,"['woman', 'swim', 'underwater']","['woman', 'swim']",3.799999952316284,2,2283,4159,-1876,3519376
327,"['man', 'play', 'guitar']","['woman', 'dance']",0.2000000029802322,0,399,378,21,441
328,"['airplane', 'fly', 'air']","['south', 'african', 'airways', 'plane', 'fly', 'blue', 'sky']",3.400000095367432,1,1168,3517,-2349,5517801
329,"['bear', 'run', 'dog']","['bear', 'fight', 'wolf']",1.399999976158142,1,1164,1357,-193,37249
330,"['woman', 'rest', 'float', 'raft']","['woman', 'relax', 'inner', 'tube']",3.799999952316284,1,1165,4160,-2995,8970025
331,"['man', 'dine', 'operating', 'room']","['man', 'kiss', 'woman', 'stage']",0.4000000059604645,1,1166,522,644,414736
332,"['man', 'hold', 'leaf']","['woman', 'watch', 'television']",0.0,0,394,78,316,99856
333,"['person', 'ride', 'horse']","['woman', 'slide', 'potato']",0.0,0,398,77,321,103041
334,"['woman', 'slide', 'octopus']","['man', 'play', 'guitar']",0.0,0,338,76,262,68644
335,"['man', 'break', 'water', 'jug']","['woman', 'peel', 'garlic']",0.2000000029802322,0,369,424,-55,3025
336,"['man', 'play', 'guitar']","['woman', 'cut', 'vegetable']",0.0,0,336,75,261,68121
337,"['girl', 'eat', 'cupcake']","['man', 'slide', 'cucumber']",0.0,0,325,74,251,63001
338,"['little', 'girl', 'play', 'grass', 'dog', 'ball']","['baby', 'play', 'dog', 'ball']",3.799999952316284,3,3748,4161,-413,170569
339,"['people', 'ride', 'paddle', 'raft']","['people', 'float', 'raft']",2.25,2,2286,2151,135,18225
340,"['lady', 'cut', 'potato']","['man', 'cut', 'potato']",2.400000095367432,2,2288,2276,12,144
341,"['missile', 'explode']","['rocket', 'explode']",3.200000047683716,1,1147,3177,-2030,4120900
342,"['dog', 'play', 'snow']","['dog', 'paw', 'fly', 'carpet']",1.600000023841858,1,1146,1569,-423,178929
343,"['woman', 'dance', 'woman']","['woman', 'shed', 'chicken']",0.4000000059604645,1,1145,544,601,361201
344,"['boy', 'push', 'van']","['person', 'slide', 'tomato']",0.0,0,107,71,36,1296
345,"['boy', 'make', 'dance', 'step']","['boy', 'pour', 'pitcher']",0.4000000059604645,1,1144,583,561,314721
346,"['woman', 'open', 'soda', 'drink']","['woman', 'ride', 'elephant']",0.6000000238418579,1,1150,674,476,226576
347,"['man', 'assemble', 'speaker', 'part']","['man', 'play', 'guitar']",1.0,1,1143,972,171,29241
348,"['dog', 'walk', 'edge', 'pool']","['dog', 'walk', 'pool']",4.599999904632568,3,3769,5300,-1531,2343961
349,"['utter', 'bowl']","['man', 'cut', 'butter', 'mixing', 'bowl']",4.25,1,1140,4936,-3796,14409616
350,"['raccoon', 'eat']","['man', 'eat']",1.5,1,1139,1433,-294,86436
351,"['fall', 'horse']","['man', 'gets', 'knock', 'horse']",3.5,1,1138,3729,-2591,6713281
352,"['woman', 'feel', 'apple']","['man', 'pip', 'wheel', 'motorcycle']",0.0,0,108,70,38,1444
353,"['man', 'take', 'path', 'class']","['man', 'rinse', 'speak']",0.0,1,1137,69,1068,1140624
354,"['animal', 'play', 'water']","['man', 'play', 'king', 'long']",0.0,1,1136,83,1053,1108809
355,"['man', 'ride', 'horse', 'jump', 'obstacle']","['man', 'kick', 'soccer', 'ball']",0.3330000042915344,1,1142,455,687,471969
356,"['person', 'pencil', 'trick', 'hand']","['person', 'slide', 'carrot', 'half']",0.3330000042915344,1,1152,458,694,481636
357,"['person', 'light', 'camera', 'fire']","['person', 'blow', 'touch', 'camera']",3.3329999446868896,2,2291,3417,-1126,1267876
358,"['man', 'slide', 'tape', 'box']","['man', 'cut', 'open', 'box']",4.333000183105469,2,2273,4952,-2679,7177041
359,"['man', 'fish', 'river']","['man', 'singe', 'walk', 'sidewalk']",0.800000011920929,1,1167,821,346,119716
360,"['man', 'ride', 'bike']","['woman', 'dance', 'street']",0.2000000029802322,0,109,423,-314,98596
361,"['man', 'push']","['woman', 'cut', 'octopus']",0.0,0,110,117,-7,49
362,"['man', 'play', 'guitar']","['woman', 'slide', 'pork']",0.0,0,111,102,9,81
363,"['little', 'boy', 'singe', 'play', 'guitar']","['baby', 'play', 'guitar']",2.799999952316284,2,2254,2711,-457,208849
364,"['woman', 'powder', 'face']","['woman', 'tap', 'finger', 'table']",0.800000011920929,1,1162,822,340,115600
365,"['woman', 'peel', 'potato']","['lion', 'walk']",0.0,0,112,132,-20,400
366,"['woman', 'fire', 'rifle']","['man', 'perform', 'sound']",0.25,0,113,446,-333,110889
367,"['woman', 'put', 'grand', 'man', 'shoulder']","['man', 'hour', 'water', 'pilot', 'head']",0.5,1,1161,612,549,301401
368,"['old', 'woman', 'shake', 'hand', 'man']","['man', 'woman', 'shake', 'hand']",3.75,4,4049,3994,55,3025
369,"['woman', 'waterskie']","['woman', 'wake', 'boarding', 'lake']",1.75,1,1159,1604,-445,198025
370,"['tree', 'bend', 'storm']","['tree', 'hit', 'hard', 'wind']",2.6670000553131104,1,1158,2532,-1374,1887876
371,"['man', 'woman', 'ride', 'car']","['woman', 'try', 'shrimp']",0.4000000059604645,1,1157,552,605,366025
372,"['man', 'move', 'tree', 'limb']","['woman', 'play', 'violin']",0.0,0,114,131,-17,289
373,"['man', 'play', 'piano']","['woman', 'play', 'violin']",1.0,1,1155,897,258,66564
374,"['person', 'hour', 'oil', 'skilled']","['person', 'dine', 'onion']",0.800000011920929,1,1154,794,360,129600
375,"['animal', 'eat']","['woman', 'dance']",0.0,0,115,130,-15,225
376,"['woman', 'walk', 'dog']","['woman', 'walk', 'dog', 'street']",4.0,3,3826,4552,-726,527076
377,"['group', 'people', 'sing']","['people', 'singe']",5.0,1,1134,5619,-4485,20115225
378,"['cat', 'drink', 'milk']","['cat', 'lick', 'saucer', 'milk']",4.400000095367432,2,2259,5017,-2758,7606564
379,"['girl', 'make', 'eyelid']","['woman', 'apply', 'eyeshadow']",2.0,0,116,1898,-1782,3175524
380,"['man', 'fight']","['man', 'fight', 'form', 'martial', 'art']",2.799999952316284,2,2260,2678,-418,174724
381,"['military', 'officer', 'bark', 'recruit']","['officer', 'talk', 'recruit']",2.5,2,2262,2338,-76,5776
382,"['man', 'put', 'chicken', 'container']","['man', 'put', 'food', 'box']",2.5,2,2264,2329,-65,4225
383,"['man', 'tie', 'stenographer', 'machine']","['man', 'stenographic']",2.25,1,1111,2143,-1032,1065024
384,"['woman', 'add', 'past', 'pot', 'water']","['woman', 'make', 'nodule']",3.5999999046325684,1,1110,3789,-2679,7177041
385,"['woman', 'lie', 'blanket', 'rock', 'read', 'book']","['woman', 'seat', 'singe', 'song', 'play', 'guitar']",1.2000000476837158,1,1109,1242,-133,17689
386,"['supply', 'play']","['man', 'play', 'soccer']",0.2000000029802322,1,1108,430,678,459684
387,"['man', 'run', 'field']","['man', 'limb', 'rope']",1.0,1,1114,908,206,42436
388,"['man', 'hug']","['man', 'take', 'picture']",0.4000000059604645,1,1107,561,546,298116
389,"['pour', 'ingredient', 'pot']","['man', 'put', 'vegetable', 'pot']",2.799999952316284,1,1105,2697,-1592,2534464
390,"['couple', 'walk']","['man', 'saw']",0.0,0,117,128,-11,121
391,"['person', 'play', 'guitar']","['man', 'play', 'guitar']",3.0,2,2267,3060,-793,628849
392,"['person', 'add', 'food', 'pan']","['woman', 'put', 'rice', 'pan']",3.0,1,1104,3050,-1946,3786916
393,"['group', 'penguin', 'walk']","['large', 'penguin', 'head', 'ocean']",2.799999952316284,1,1103,2710,-1607,2582449
394,"['man', 'play', 'guitar']",['handle'],0.0,0,118,125,-7,49
395,"['dog', 'jump', 'trampling']","['boy', 'play', 'guitar']",0.0,0,119,124,-5,25
396,"['man', 'shake', 'container', 'kitchen', 'sink']","['man', 'empty', 'plastic', 'container']",2.200000047683716,2,2268,2036,232,53824
397,"['man', 'walk', 'horse']","['man', 'lead', 'horse', 'halt']",3.75,2,2269,4029,-1760,3097600
398,"['paper', 'cut', 'scissor']","['piece', 'paper', 'cut']",4.0,2,2270,4657,-2387,5697769
399,"['person', 'feel', 'shrimp']","['lady', 'peel', 'shrimp']",3.5,1,1106,3716,-2610,6812100
400,"['man', 'play', 'guitar']","['man', 'try', 'read', 'paper']",0.800000011920929,1,1116,767,349,121801
401,"['man', 'make', 'bed', 'hotel']","['man', 'hold', 'animal']",0.800000011920929,1,1124,790,334,111556
402,"['dog', 'pull', 'dog', 'tail', 'leg']","['monkey', 'pull', 'dog', 'tail']",1.75,3,3813,1614,2199,4835601
403,"['woman', 'beat', 'egg', 'bowl']","['person', 'mix', 'ingredient', 'bowl']",3.0,1,1117,2789,-1672,2795584
404,"['man', 'jump', 'rope', 'outside']","['woman', 'slide', 'cucumber']",0.0,0,120,122,-2,4
405,"['person', 'slide', 'onion']","['master', 'singe']",0.0,0,121,121,0,0
406,"['woman', 'hold', 'kangaroo']","['man', 'hat', 'sing', 'song']",0.0,0,122,120,2,4
407,"['soccer', 'player', 'kick', 'soccer', 'ball', 'goal']","['soccer', 'player', 'score', 'goal']",3.799999952316284,3,3642,4115,-473,223729
408,"['woman', 'cook']","['woman', 'pour', 'ingredient', 'try', 'pan']",3.200000047683716,1,1130,3152,-2022,4088484
409,"['woman', 'swim', 'beach']","['woman', 'splash', 'ocean', 'wave']",3.200000047683716,1,1129,3157,-2028,4112784
410,"['man', 'carry', 'man']","['man', 'spray', 'man', 'water']",0.800000011920929,1,1128,801,327,106929
411,"['woman', 'put', 'paste', 'dish']","['woman', 'pull', 'kind', 'sticky', 'bowl']",1.5,1,1127,1430,-303,91809
412,"['man', 'hold', 'talk', 'gray', 'tube', 't', 'shirt']","['man', 'show', 't', 'shirt']",2.75,3,3643,2548,1095,1199025
413,"['hour', 'olive', 'oil', 'bowl', 'tomato', 'edge']","['man', 'pour', 'oil', 'tomato', 'slice']",3.75,2,2290,4039,-1749,3059001
414,"['man', 'play', 'guitar']","['man', 'play', 'guitar', 'friend']",3.200000047683716,3,3726,3159,567,321489
415,"['boil', 'oka', 'pot']","['hour', 'olive', 'oil', 'bowl', 'tomato', 'edge']",0.800000011920929,0,124,796,-672,451584
416,"['person', 'peel', 'potato']","['cat', 'lick', 'small', 'bottle']",0.0,0,105,133,-28,784
417,"['cat', 'jump', 'box']","['young', 'man', 'talk', 'leaf']",0.0,0,103,118,-15,225
418,"['woman', 'reason', 'oil']","['woman', 'pour', 'ingredient', 'bowl']",1.399999976158142,1,1126,1317,-191,36481
419,"['cat', 'slide', 'upside', 'couch']","['cat', 'crawl', 'piece', 'furniture']",3.200000047683716,1,1132,3162,-2030,4120900
420,"['woman', 'dance', 'man', 'play', 'keyboard']","['woman', 'dance', 'stage']",2.200000047683716,2,2289,2079,210,44100
421,"['chef', 'clean', 'bowl', 'soup']","['man', 'wipe', 'edge', 'bowl']",2.532999992370605,1,1123,2365,-1242,1542564
422,"['explosion', 'boom', 'desert']","['nuclear', 'weapon', 'explode', 'desert']",3.400000095367432,1,1122,3673,-2551,6507601
423,"['woman', 'slice', 'lemon']","['man', 'talk', 'microphone']",0.0,0,86,115,-29,841
424,"['overnight', 'man', 'ship', 'rope']","['young', 'man', 'dance']",0.800000011920929,1,1120,792,328,107584
425,"['lady', 'crack', 'raw', 'egg']","['woman', 'crack', 'egg', 'bowl']",3.200000047683716,2,2282,3145,-863,744769
426,"['man', 'sharpen', 'pencil', 'knife']","['woman', 'dance', 'rain']",0.0,0,87,114,-27,729
427,"['elastic', 'toy', 'float', 'water']","['lady', 'perform', 'dance']",0.0,0,88,113,-25,625
428,"['turtle', 'follow', 'fish']","['sea', 'turtle', 'hunt', 'fish']",3.0,2,2281,2798,-517,267289
429,"['woman', 'pencil', 'eye', 'shadow']","['girl', 'eye', 'pencil', 'eyelid']",2.799999952316284,2,2230,2668,-438,191844
430,"['man', 'tie', 'shoe']","['dog', 'ride', 'bicyclist', 'shoulder']",0.0,0,89,111,-22,484
431,"['woman', 'slide', 'meat', 'knife']","['man', 'spread', 'dough']",0.4169999957084656,0,90,592,-502,252004
432,"['dog', 'run', 'ground']","['girl', 'tap', 'finger', 'nail']",0.0,0,91,110,-19,361
433,"['man', 'pet', 'tie', 'dog']","['man', 'show', 'dog', 'camera']",1.0,2,2222,1103,1119,1252161
434,"['woman', 'walk', 'open', 'ground', 'pet', 'dog', 'dog', 'follow']","['man', 'walk', 'dog']",2.0,2,2219,1858,361,130321
435,"['woman', 'mine', 'garlic']","['person', 'clean', 'disk']",0.0,0,93,108,-15,225
436,"['tear', 'play', 'soccer']","['different', 'set', 'tear', 'play', 'football', 'field']",2.5,2,2217,2337,-120,14400
437,"['rat', 'like', 'creature', 'smell']","['animal', 'walk', 'ground']",2.0,0,94,1817,-1723,2968729
438,"['sum', 'finger', 'fight']","['man', 'ride', 'water', 'toy', 'water']",0.0,0,95,107,-12,144
439,"['man', 'lay', 'ground', 'aim', 'rifle']","['man', 'spread', 'butter', 'gorilla']",0.0,1,1218,106,1112,1236544
440,"['couple', 'run', 'ocean']","['man', 'woman', 'run', 'hold', 'hand']",2.818000078201294,1,1217,2750,-1533,2350089
441,"['woman', 'chop', 'hard', 'egg']","['person', 'cut', 'boil', 'egg', 'piece']",3.532999992370605,1,1216,3744,-2528,6390784
442,"['root', 'share', 'kiss']","['male', 'female', 'root', 'kiss']",3.799999952316284,2,2216,4129,-1913,3659569
443,"['cat', 'try', 'touch', 'dog']","['cat', 'tease', 'dog', 'touch', 'head']",3.25,3,3639,3385,254,64516
444,"['rhine', 'graze', 'grass']","['rhine', 'graze', 'field']",4.0,2,2214,4356,-2142,4588164
445,"['man', 'drive', 'little', 'red', 'car', 'traffic']","['dog', 'run', 'water', 'beach']",0.0,0,96,103,-7,49
446,"['man', 'cut', 'bread']","['man', 'trick', 'soccer', 'ball']",1.0,1,1213,1057,156,24336
447,"['cat', 'rapidly', 'seat', 'kid', 'head']","['cat', 'boy', 'play']",2.5999999046325684,1,1212,2454,-1242,1542564
448,"['cat', 'play', 'box']","['dog', 'play', 'floor', 'cleaner']",1.399999976158142,1,1211,1284,-73,5329
449,"['couple', 'dance', 'church']","['couple', 'slow', 'dance']",3.200000047683716,2,2250,3192,-942,887364
450,"['man', 'pat', 'alligator', 'mouth']","['person', 'dump', 'chop', 'vegetable', 'pot', 'stove']",0.0,0,97,68,29,841
451,"['person', 'check', 'rice', 'pudding']","['horse', 'run']",0.0,0,98,67,31,961
452,"['woman', 'stir', 'egg', 'glass', 'bowl']","['young', 'girl', 'singe', 'stage']",0.0,0,99,66,33,1089
453,"['man', 'play', 'drum']","['man', 'hour', 'clean', 'sink']",0.0,1,1214,49,1165,1357225
454,"['man', 'slide', 'pepper']","['person', 'cut', 'big', 'green', 'pepper', 'apart']",3.799999952316284,1,1223,4134,-2911,8473921
455,"['woman', 'speak', 'sign', 'language']","['woman', 'space', 'seafood']",0.6430000066757202,1,1224,727,497,247009
456,"['boy', 'crawl', 'dog', 'house']","['cat', 'play', 'floor']",0.0,0,100,30,70,4900
457,"['girl', 'fly', 'kite', 'run', 'hill']","['girl', 'lose', 'kite']",2.25,2,2249,2147,102,10404
458,"['woman', 'place', 'food', 'pot', 'hot', 'water']","['woman', 'try', 'meat']",1.25,1,1225,1248,-23,529
459,"['small', 'monkey', 'walk', 'water']","['monkey', 'wade', 'marsh']",3.400000095367432,1,1240,3620,-2380,5664400
460,"['man', 'ride', 'bike']","['bear', 'eat']",0.0,0,102,28,74,5476
461,"['young', 'man', 'singe', 'play', 'piano']","['man', 'write', 'letter']",0.2000000029802322,1,1238,390,848,719104
462,"['boy', 'take', 'sunglass']","['boy', 'scream']",0.5,1,1237,593,644,414736
463,"['girl', 'play', 'piano']","['boy', 'push']",0.0,0,104,27,77,5929
464,"['lady', 'slice', 'tomato']","['cut', 'tomato']",4.0,1,1236,4487,-3251,10569001
465,"['hold', 'hedgehog']","['onion', 'slice']",0.0,0,126,25,101,10201
466,"['woman', 'feel', 'potato']","['woman', 'trill', 'pineapple']",1.0,1,1235,1000,235,55225
467,"['cat', 'drink', 'water']","['truck', 'go', 'hill']",0.0,0,146,24,122,14884
468,"['person', 'put', 'salt', 'pepper', 'piece', 'pork']","['youngster', 'sit', 'piano']",0.0,0,127,23,104,10816
469,"['man', 'sit', 'chair', 'stared']","['little', 'girl', 'put', 'hair', 'pony', 'tail']",0.0,0,149,22,127,16129
470,"['woman', 'dine', 'potato']","['woman', 'cut', 'tiny', 'piece']",1.7999999523162842,1,1232,1716,-484,234256
471,"['baby', 'crawl', 'happily']","['baby', 'sneer', 'scare', 'baby']",1.2000000476837158,1,1231,1230,1,1
472,"['person', 'try', 'meat', 'pan']","['man', 'cut', 'vegetable']",0.6000000238418579,0,150,720,-570,324900
473,"['man', 'look', 'window']","['woman', 'swim', 'water']",0.25,0,151,443,-292,85264
474,"['man', 'seat', 'play', 'guitar']","['man', 'play', 'caustic', 'guitar', 'singe', 'microphone']",3.25,3,3620,3384,236,55696
475,"['woman', 'slide', 'onion', 'knife']","['man', 'prepare', 'dish']",1.25,0,153,1250,-1097,1203409
476,"['rider', 'run', 'jump', 'horse']","['woman', 'jump', 'bundle', 'horse']",4.0,2,2241,4495,-2254,5080516
477,"['boy', 'play', 'key', 'board']","['boy', 'sit', 'room', 'play', 'piano', 'lamp', 'light']",3.25,2,2238,3394,-1156,1336336
478,"['man', 'fight']","['man', 'exercise']",0.75,1,1230,737,493,243049
479,"['man', 'play', 'wooden', 'flute', 'man', 'play', 'long', 'drum']","['man', 'play', 'flute']",3.25,3,3625,3382,243,59049
480,"['person', 'pet', 'monkey']","['man', 'hold', 'slow', 'boris']",1.2000000476837158,0,154,1227,-1073,1151329
481,"['cartoon', 'rabbit', 'kiss']","['rabbit', 'kiss', 'rabbit']",3.799999952316284,2,2234,4138,-1904,3625216
482,"['hedgehog', 'chew', 'towel']","['hedgehog', 'bite', 'blanket']",3.400000095367432,1,1227,3427,-2200,4840000
483,"['cat', 'lick']","['man', 'slide', 'white', 'onion', 'lanolin', 'slice']",0.0,0,155,17,138,19044
484,"['small', 'guinea', 'pig', 'gnaw', 'eat', 'piece', 'carrot', 'floor']","['guinea', 'pig', 'eat', 'carrot']",3.5,4,4072,3701,371,137641
485,"['boy', 'stand', 'burn', 'car']","['young', 'man', 'stand', 'car', 'explode']",3.75,2,2294,4036,-1742,3034564
486,"['man', 'smoke']","['man', 'sit', 'suit', 'smoke']",4.0,2,2295,4502,-2207,4870849
487,"['woman', 'add', 'sauce', 'food']","['person', 'cut', 'leave']",0.2000000029802322,0,156,374,-218,47524
488,"['child', 'eat', 'food']","['deer', 'jump', 'fence']",0.0,0,157,15,142,20164
489,"['submarine', 'go', 'water']","['baby', 'fall', 'asleep']",0.0,0,158,14,144,20736
490,"['man', 'run', 'street']","['man', 'play', 'guitar']",0.800000011920929,1,1185,755,430,184900
491,"['person', 'slide', 'onion']","['cat', 'pop', 'toilet']",0.0,0,159,13,146,21316
492,"['badge', 'dig', 'dirt']","['man', 'move', 'large', 'rock']",0.0,0,160,12,148,21904
493,"['woman', 'slide', 'big', 'pepper']","['dog', 'move', 'mouth']",0.0,0,161,11,150,22500
494,"['man', 'ride', 'bicycle']","['man', 'ride', 'bike']",5.0,2,2354,5646,-3292,10837264
495,"['man', 'woman', 'kiss']","['man', 'woman', 'talk']",0.6000000238418579,2,2347,703,1644,2702736
496,"['woman', 'slide', 'onion']","['woman', 'cut', 'onion']",4.199999809265137,2,2346,4773,-2427,5890329
497,"['small', 'boy', 'play', 'dog']","['baby', 'play', 'dog']",3.75,2,2342,4032,-1690,2856100
498,"['man', 'draw']","['man', 'draw']",5.0,2,2373,5642,-3269,10686361
499,"['man', 'cut', 'potato']","['woman', 'cut', 'tomato']",1.25,1,1180,1253,-73,5329
500,"['boy', 'play', 'guitar']","['kid', 'play', 'guitar']",3.5999999046325684,2,2370,3767,-1397,1951609
501,"['woman', 'cut', 'onion']","['woman', 'cut', 'onion']",5.0,3,3723,5641,-1918,3678724
502,"['toy', 'train', 'strike', 'toy', 'car']","['toy', 'train', 'strike', 'toy', 'car']",5.0,4,4176,5639,-1463,2140369
503,"['man', 'play', 'guitar']","['man', 'play', 'flute']",2.200000047683716,2,2312,2008,304,92416
504,"['cat', 'open', 'drawer', 'limb', 'inside']","['cat', 'open', 'drawer', 'climbing', 'inside']",5.0,4,4169,5636,-1467,2152089
505,"['woman', 'try', 'food']","['woman', 'deep', 'try', 'food']",4.25,3,3683,4922,-1239,1535121
506,"['man', 'dine', 'onion']","['woman', 'cut', 'onion']",2.5,1,1175,2348,-1173,1375929
507,"['girl', 'play', 'guitar']","['man', 'play', 'guitar']",2.799999952316284,2,2313,2687,-374,139876
508,"['girl', 'singe', 'stage']","['man', 'singe', 'stage']",2.799999952316284,2,2332,2685,-353,124609
509,"['woman', 'ride', 'horse']","['woman', 'ride', 'donkey']",2.799999952316284,2,2331,2684,-353,124609
510,"['girl', 'play', 'guitar']","['man', 'play', 'guitar']",2.799999952316284,2,2324,2683,-359,128881
511,"['woman', 'brush', 'shrimp']","['woman', 'brush', 'shrimp']",5.0,3,3688,5610,-1922,3694084
512,"['man', 'dance', 'ceiling']","['man', 'dance', 'ceiling', 'room']",4.800000190734863,3,3676,5413,-1737,3017169
513,"['woman', 'thinly', 'slice', 'onion', 'large', 'knife']","['woman', 'slide', 'onion', 'large', 'knife']",4.199999809265137,4,4086,4895,-809,654481
514,"['man', 'play', 'keyboard']","['man', 'play', 'keyboard']",5.0,3,3673,5643,-1970,3880900
515,"['man', 'play', 'guitar']","['man', 'play', 'guitar']",5.0,3,3698,5609,-1911,3651921
516,"['woman', 'peel', 'potato']","['woman', 'feel', 'potato']",5.0,2,2125,5596,-3471,12047841
517,"['woman', 'handle', 'frog']","['man', 'hold', 'frog']",3.75,1,1189,4051,-2862,8191044
518,"['man', 'play', 'flute']","['man', 'play', 'guitar']",2.0,2,2100,1876,224,50176
519,"['man', 'play', 'guitar']","['man', 'play', 'flute']",1.5829999446868896,2,2099,1456,643,413449
520,"['man', 'play', 'piano']","['man', 'play', 'guitar']",1.777999997138977,2,2097,1625,472,222784
521,"['man', 'play', 'guitar']","['man', 'play', 'piano']",2.0,2,2095,1869,226,51076
522,"['man', 'play', 'flute']","['man', 'play', 'guitar']",2.0,2,2092,1871,221,48841
523,"['man', 'play', 'flute']","['man', 'play', 'guitar']",2.0,2,2090,1835,255,65025
524,"['woman', 'couch']","['woman', 'hug', 'couch']",3.200000047683716,2,2089,3235,-1146,1313316
525,"['slide', 'cucumber']","['man', 'slide', 'cucumber']",3.799999952316284,2,2106,4233,-2127,4524129
526,"['kitten', 'play', 'blue', 'rope', 'toy']","['kitten', 'play', 'toy']",4.400000095367432,3,3624,5025,-1401,1962801
527,"['dog', 'bark', 'toy']","['dog', 'bark', 'toy']",5.0,3,3613,5573,-1960,3841600
528,"['person', 'fold', 'gorilla']","['man', 'fold', 'gorilla']",3.5,2,2118,3722,-1604,2572816
529,"['cat', 'drink', 'milk']","['kitten', 'drink', 'milk']",4.0,2,2115,4424,-2309,5331481
530,"['person', 'drive', 'car']","['man', 'drive', 'car']",3.5,2,2114,3721,-1607,2582449
531,"['turtle', 'walk']","['tortoise', 'walk']",4.400000095367432,1,1200,5054,-3854,14853316
532,"['cow', 'eat', 'grass']","['cow', 'eat', 'hay']",3.799999952316284,2,2113,4235,-2122,4502884
533,"['woman', 'chop', 'broccoli']","['woman', 'chop', 'garlic']",2.5999999046325684,2,2108,2488,-380,144400
534,"['man', 'cry']","['man', 'scream']",3.0,1,1198,2811,-1613,2601769
535,"['man', 'play', 'guitar']","['man', 'play', 'guitar']",5.0,3,3657,5569,-1912,3655744
536,"['man', 'cut', 'onion']","['man', 'cut', 'planting']",3.6670000553131104,2,2060,3983,-1923,3697929
537,"['man', 'slide', 'potato']","['woman', 'peel', 'potato']",2.3329999446868896,1,1197,2170,-973,946729
538,"['woman', 'tap', 'finger', 'table']","['woman', 'tap', 'finger']",4.0,3,3810,4505,-695,483025
539,"['boil', 'oka', 'pot']","['cook', 'oka', 'pan']",4.400000095367432,1,1194,5053,-3859,14891881
540,"['man', 'smoke']","['man', 'mix']",0.2000000029802322,1,1193,407,786,617796
541,"['man', 'play', 'drum']","['man', 'play', 'drum']",5.0,3,3803,5568,-1765,3115225
542,"['man', 'give', 'pool']","['man', 'diving', 'pool']",5.0,2,2048,5567,-3519,12383361
543,"['woman', 'cut', 'leak']","['woman', 'slide', 'week']",4.0,1,1191,4512,-3321,11029041
544,"['little', 'boy', 'play', 'guitar']","['boy', 'play', 'guitar']",4.599999904632568,3,3792,5287,-1495,2235025
545,"['woman', 'dance']","['man', 'dance']",2.5999999046325684,1,1190,2372,-1182,1397124
546,"['woman', 'talk']","['man', 'talk']",2.5999999046325684,1,1099,2392,-1293,1671849
547,"['girl', 'put', 'hair']","['woman', 'put', 'hair']",2.5999999046325684,2,2061,2421,-360,129600
548,"['kid', 'play', 'guitar']","['man', 'play', 'guitar']",2.200000047683716,2,2078,2075,3,9
549,"['group', 'people', 'march', 'place']","['group', 'people', 'dance', 'concert']",1.7000000476837158,2,2077,1599,478,228484
550,"['woman', 'shoot', 'machine', 'gun']","['man', 'shoot', 'gun']",2.0,2,2069,1966,103,10609
551,"['man', 'play', 'piano']","['man', 'play', 'piano']",4.0,3,3814,4492,-678,459684
552,"['woman', 'slide', 'onion']","['slide', 'onion']",3.25,2,2065,3371,-1306,1705636
553,"['man', 'slide', 'cucumber']","['man', 'cut', 'cucumber']",4.5,2,2083,5145,-3062,9375844
554,"['girl', 'eat', 'cupcake']","['woman', 'eat', 'cupcake']",2.5999999046325684,2,2126,2439,-313,97969
555,"['woman', 'cut', 'onion']","['man', 'chop', 'onion']",2.0,1,1025,1905,-880,774400
556,"['man', 'play', 'guitar']","['baby', 'play', 'guitar']",1.7999999523162842,2,2167,1640,527,277729
557,"['man', 'play', 'guitar']","['man', 'play', 'drum']",1.555999994277954,2,2186,1454,732,535824
558,"['little', 'girl', 'talk', 'telephone']","['girl', 'talk', 'phone']",4.5,2,2185,5128,-2943,8661249
559,"['man', 'chop', 'log', 'axe']","['man', 'chop', 'tree', 'trunk', 'axe']",4.0,3,3821,4357,-536,287296
560,"['person', 'cut', 'capsicum', 'piece']","['person', 'slide', 'garlic', 'piece']",1.600000023841858,2,2184,1516,668,446224
561,"['man', 'talk', 'woman']","['woman', 'walk', 'dog']",0.5,1,1002,600,402,161604
562,"['man', 'walk']","['man', 'talk']",1.399999976158142,1,1001,1310,-309,95481
563,"['pour', 'oil', 'skilled']","['pour', 'milk', 'slender']",1.600000023841858,1,1000,1514,-514,264196
564,"['small', 'kitten', 'play', 'ball']","['kitten', 'play', 'ball']",4.400000095367432,3,3743,5032,-1289,1661521
565,"['man', 'play', 'guitar']","['woman', 'play', 'flute']",1.7999999523162842,1,1006,1772,-766,586756
566,"['girl', 'play', 'violin']","['girl', 'play', 'flute']",2.5999999046325684,2,2181,2416,-235,55225
567,"['man', 'play', 'piano']","['cat', 'play', 'piano']",1.600000023841858,2,2179,1531,648,419904
568,"['man', 'exercise']","['girl', 'exercise']",3.0,1,999,2959,-1960,3841600
569,"['person', 'slide', 'gallop']","['person', 'slide', 'octopus']",2.0,2,2176,1941,235,55225
570,"['man', 'woman', 'ride', 'bicycle']","['man', 'woman', 'ride', 'motorcycle']",2.0,3,3729,1951,1778,3161284
571,"['man', 'fight', 'cow', 'pasture']","['man', 'fight', 'cattle', 'pen']",4.0,2,2170,4348,-2178,4743684
572,"['woman', 'add', 'oil', 'pan']","['man', 'pour', 'oil', 'pan']",3.0,2,2208,3066,-858,736164
573,"['girl', 'make', 'bed']","['young', 'girl', 'make', 'bed']",4.400000095367432,3,3774,5042,-1268,1607824
574,"['cat', 'play', 'watermelon']","['cat', 'play', 'watermelon']",4.800000190734863,3,3760,5375,-1615,2608225
575,"['girl', 'jump', 'car']","['girl', 'jump', 'car']",4.800000190734863,3,3757,5372,-1615,2608225
576,"['man', 'pray']","['man', 'run']",0.7269999980926514,1,997,731,266,70756
577,"['car', 'parking']","['cat', 'play']",0.0,0,136,50,86,7396
578,"['man', 'run']","['man', 'dance']",1.25,1,996,1245,-249,62001
579,"['man', 'singe']","['man', 'dance']",0.5,1,995,613,382,145924
580,"['man', 'carry', 'man', 'shoulder']","['man', 'carry', 'shoulder']",3.25,3,3763,3354,409,167281
581,"['woman', 'peel', 'potato']","['woman', 'slide', 'tomato']",1.3329999446868896,1,994,1262,-268,71824
582,"['woman', 'cut', 'tomato']","['woman', 'slide', 'potato']",1.0,1,993,1090,-97,9409
583,"['peel', 'potato']","['slide', 'tomato']",1.399999976158142,0,137,1303,-1166,1359556
584,"['woman', 'peel', 'potato']","['woman', 'slide', 'tomato']",1.3329999446868896,1,992,1265,-273,74529
585,"['root', 'kiss']","['root', 'kiss']",5.0,2,2138,5586,-3448,11888704
586,"['boy', 'couch', 'play', 'video', 'game']","['boy', 'play', 'video', 'game']",4.0,4,3840,4405,-565,319225
587,"['woman', 'squeeze', 'lemon']","['woman', 'squeeze', 'juice', 'lemon']",4.400000095367432,3,3824,5104,-1280,1638400
588,"['woman', 'slide', 'onion']","['man', 'slide', 'tomato']",1.2000000476837158,1,998,1160,-162,26244
589,"['woman', 'slide', 'carrot']","['man', 'slide', 'tomato']",1.2000000476837158,1,1008,1159,-151,22801
590,"['girl', 'say', 'hair']","['girl', 'file', 'nail']",1.25,1,1016,1247,-231,53361
591,"['man', 'walk', 'stair']","['man', 'walk', 'staircase']",5.0,2,2166,5606,-3440,11833600
592,"['people', 'ride', 'motorcycle']","['people', 'ride', 'bike']",2.0,2,2159,1921,238,56644
593,"['man', 'play', 'guitar']","['woman', 'play', 'electric', 'guitar']",2.200000047683716,2,2157,2025,132,17424
594,"['man', 'play', 'guitar', 'singing']","['man', 'play', 'guitar']",3.200000047683716,3,3815,3290,525,275625
595,"['man', 'walk', 'rain']","['man', 'woman', 'walk', 'grand']",1.5,2,2451,1438,1013,1026169
596,"['kangaroo', 'eat']","['kangaroo', 'eat']",4.75,2,2616,5340,-2724,7420176
597,"['man', 'fish']","['man', 'exercise']",0.5,1,1021,614,407,165649
598,"['woman', 'swim']","['man', 'singe']",0.06700000166893,0,139,368,-229,52441
599,"['woman', 'eat']","['animal', 'eat']",1.600000023841858,1,1019,1547,-528,278784
600,"['boy', 'girl', 'dance', 'rain']","['man', 'woman', 'dance', 'rain']",2.5999999046325684,2,2604,2371,233,54289
601,"['man', 'drive', 'car']","['man', 'drive', 'car']",4.875,3,3649,5481,-1832,3356224
602,"['woman', 'grate', 'onion']","['woman', 'rate', 'onion']",5.0,2,2640,5603,-2963,8779369
603,"['poster', 'fight']","['man', 'fight']",2.0,1,1024,1945,-921,848241
604,"['man', 'ride', 'horse']","['man', 'drive', 'car']",1.399999976158142,1,1017,1296,-279,77841
605,"['man', 'ride', 'horse']","['man', 'drive', 'car']",1.399999976158142,1,1015,1295,-280,78400
606,"['man', 'shoot', 'gun']","['man', 'slide']",0.800000011920929,1,1014,881,133,17689
607,"['woman', 'cut', 'onion']","['woman', 'cut', 'meat']",2.0,2,2636,1916,720,518400
608,"['woman', 'slide']","['man', 'slide', 'bread']",1.600000023841858,1,1012,1541,-529,279841
609,"['boy', 'play', 'piano']","['man', 'play', 'piano']",3.0,2,2634,2940,-306,93636
610,"['baby', 'elephant', 'eat']","['baby', 'elephant', 'eat', 'sailing']",3.615000009536743,3,3701,3976,-275,75625
611,"['woman', 'crack', 'egg', 'bowl']","['woman', 'crack', 'egg']",4.0,3,3715,4696,-981,962361
612,"['person', 'play', 'keyboard']","['boy', 'play', 'key', 'board']",4.0,1,1010,4691,-3681,13549761
613,"['boy', 'thank', 'man', 'sword']","['boy', 'spark', 'man', 'plastic', 'sword']",3.3329999446868896,3,3672,3400,272,73984
614,"['person', 'slide', 'carrot', 'piece']","['person', 'cut', 'onion', 'piece']",1.5,2,2571,1435,1136,1290496
615,"['man', 'slice', 'bunch', 'water', 'bottle', 'knife']","['man', 'slide', 'line', 'water', 'bottle', 'knife']",4.400000095367432,4,3842,5098,-1256,1577536
616,"['man', 'write', 'book']","['man', 'write', 'paper']",2.875,2,2555,2753,-198,39204
617,"['woman', 'slide', 'garlic']","['woman', 'slide', 'big', 'pepper']",2.200000047683716,2,2549,2096,453,205209
618,"['person', 'make', 'bed']","['person', 'eat', 'table']",0.2000000029802322,1,990,429,561,314721
619,"['man', 'play', 'keyboard']","['man', 'play', 'guitar']",1.7999999523162842,2,2547,1703,844,712336
620,"['man', 'play', 'violin']","['man', 'play', 'harp']",1.600000023841858,2,2601,1538,1063,1129969
621,"['woman', 'smoke']","['man', 'walk']",0.2000000029802322,0,141,433,-292,85264
622,"['man', 'erase', 'man', 'board']","['man', 'erase', 'work', 'board']",3.0,3,3697,3063,634,401956
623,"['man', 'ride', 'motorcycle']","['man', 'ride', 'motorcycle', 'town']",3.5,3,3719,3709,10,100
624,"['man', 'ride', 'motorcycle', 'highway']","['man', 'ride', 'motorcycle']",3.5,3,3712,3710,2,4
625,"['woman', 'slide', 'meat']","['woman', 'slide', 'onion']",2.0,2,2588,1958,630,396900
626,"['woman', 'cut', 'broccoli']","['woman', 'cut', 'broccoli']",5.0,3,3711,5594,-1883,3545689
627,"['man', 'play', 'piano']","['woman', 'peel', 'potato']",0.0,0,85,39,46,2116
628,"['slide', 'tomato']","['slide', 'fruit']",3.200000047683716,1,965,3270,-2305,5313025
629,"['woman', 'dance', 'cage']","['woman', 'dance']",3.25,2,2590,3364,-774,599076
630,"['woman', 'swim']","['man', 'spit']",0.0,0,84,38,46,2116
631,"['man', 'run']","['man', 'move']",1.0,1,970,976,-6,36
632,"['man', 'play', 'guitar']","['man', 'play', 'guitar']",3.6670000553131104,3,3708,3980,-272,73984
633,"['cat', 'stare', 'camera']","['cat', 'address', 'camera']",3.0,2,2599,3047,-448,200704
634,"['baby', 'laugh', 'crawl']","['baby', 'laugh', 'crawl', 'floor']",4.199999809265137,3,3699,4843,-1144,1308736
635,"['woman', 'shoot', 'gun']","['woman', 'shoot', 'shotgun']",4.091000080108643,2,2552,4699,-2147,4609609
636,"['woman', 'dance', 'rain']","['woman', 'dance', 'railway', 'station']",2.0,2,2553,1810,743,552049
637,"['woman', 'dance']","['woman', 'exercise']",1.0,1,961,977,-16,256
638,"['kid', 'play', 'instrument']","['young', 'boy', 'play', 'wind', 'instrument']",3.799999952316284,2,2554,4076,-1522,2316484
639,"['slice', 'bottle', 'sword']","['man', 'break', 'bottle', 'sword']",4.0,2,2556,4676,-2120,4494400
640,"['woman', 'cut', 'apple']","['woman', 'cut', 'potato']",1.7999999523162842,2,2557,1701,856,732736
641,"['man', 'peel', 'apple']","['man', 'feel', 'apple']",5.0,2,2565,5590,-3025,9150625
642,"['man', 'play', 'guitar']","['man', 'play', 'skull']",1.0,2,2566,935,1631,2660161
643,"['animal', 'walk', 'ground']","['solenodon', 'walk', 'ground']",3.0,2,2567,2795,-228,51984
644,"['little', 'girl', 'play', 'grand', 'piano', 'stage']","['little', 'girl', 'play', 'piano']",2.5999999046325684,4,3954,2520,1434,2056356
645,"['group', 'people', 'dance']","['group', 'man', 'dance']",3.400000095367432,2,2043,3658,-1615,2608225
646,"['man', 'play', 'guitar']","['woman', 'play', 'guitar']",2.0,2,2609,1850,759,576081
647,"['cat', 'swing', 'ceiling', 'fan']","['cat', 'spin', 'ceiling', 'fan']",4.199999809265137,3,3664,4858,-1194,1425636
648,"['woman', 'play', 'flute']","['girl', 'play', 'flute']",3.799999952316284,2,2612,4085,-1473,2169729
649,"['woman', 'dine', 'onion']","['woman', 'cut', 'onion']",4.400000095367432,2,2617,4988,-2371,5621641
650,"['monkey', 'brush', 'bull', 'dog']","['monkey', 'brush', 'dog']",4.199999809265137,3,3658,4804,-1146,1313316
651,"['woman', 'slide', 'onion']","['woman', 'cut', 'potato']",1.2000000476837158,1,962,1150,-188,35344
652,"['man', 'play', 'piano']","['woman', 'play', 'guitar']",1.2000000476837158,1,972,1196,-224,50176
653,"['woman', 'wash', 'hand']","['woman', 'straighten', 'hair']",0.800000011920929,1,980,878,102,10404
654,"['woman', 'fire', 'shotgun']","['woman', 'shoot', 'gun']",3.200000047683716,1,973,3268,-2295,5267025
655,"['man', 'eat', 'bowl', 'cereal']","['man', 'eat', 'cereal']",4.0,3,3655,4567,-912,831744
656,"['woman', 'bathe', 'bath', 'tub']","['woman', 'take', 'bath']",4.400000095367432,2,2426,5000,-2574,6625476
657,"['motorcyclist', 'clash', 'motorcycle']","['person', 'clash', 'motorcycle']",4.199999809265137,2,2453,4797,-2344,5494336
658,"['man', 'dangle', 'mouse', 'near', 'snake']","['man', 'feed', 'mice', 'snake']",3.200000047683716,2,2450,3222,-772,595984
659,"['man', 'woman', 'walk', 'wood']","['man', 'woman', 'walk', 'jungle']",3.400000095367432,3,3801,3561,240,57600
660,"['person', 'hour', 'rice', 'pudding', 'bowl']","['lady', 'pour', 'rice', 'pudding', 'bowl']",4.0,3,3796,4524,-728,529984
661,"['man', 'stare', 'window']","['man', 'look', 'window']",4.800000190734863,2,2443,5429,-2986,8916196
662,"['woman', 'fire', 'rifle']","['woman', 'cut', 'lemon']",0.2000000029802322,1,988,388,600,360000
663,"['man', 'eat', 'banana']","['peel', 'banana']",1.7999999523162842,1,981,1634,-653,426409
664,"['man', 'perform', 'stage']","['comedy', 'time', 'perform', 'stage']",2.5999999046325684,2,2420,2448,-28,784
665,"['cartoon', 'woman', 'give', 'pool']","['cartoon', 'woman', 'dive', 'board']",2.799999952316284,2,2389,2615,-226,51076
666,"['lady', 'baby', 'trashcan']","['woman', 'put', 'baby', 'trash']",5.0,1,978,5721,-4743,22496049
667,"['try', 'meat']","['play', 'pain']",0.25,0,24,440,-416,173056
668,"['man', 'rapidly', 'chop', 'mushroom', 'knife']","['person', 'quickly', 'chop', 'mushroom', 'knife']",3.75,3,3831,4045,-214,45796
669,"['woman', 'add', 'ingredient', 'bowl']","['woman', 'crack', 'egg', 'bowl']",1.75,2,2412,1608,804,646416
670,"['skateboarder', 'trick', 'half', 'pipe']","['man', 'skateboard', 'half', 'pipe']",3.5,2,2411,3738,-1327,1760929
671,"['man', 'speak', 'stage']","['man', 'speak', 'sodium']",3.400000095367432,2,2408,3607,-1199,1437601
672,"['man', 'play', 'guitar']","['man', 'hat', 'play', 'harp']",1.399999976158142,2,2401,1379,1022,1044484
673,"['man', 'play', 'keyboard']","['man', 'play', 'guitar']",1.399999976158142,2,2517,1381,1136,1290496
674,"['person', 'cut', 'potato']","['person', 'slide', 'shallow']",1.0,1,989,954,35,1225
675,"['man', 'dance', 'ceiling', 'room']","['man', 'dance', 'upside', 'ceiling']",4.599999904632568,3,3832,5222,-1390,1932100
676,"['man', 'dance']","['woman', 'shop']",0.4000000059604645,0,25,489,-464,215296
677,"['reason', 'egg']","['reason', 'raw', 'egg', 'bowl']",3.5999999046325684,2,2515,3773,-1258,1582564
678,"['man', 'swinge', 'rope']","['gibbon', 'swinge', 'tree']",1.25,1,1061,1249,-188,35344
679,"['man', 'cut', 'potato']","['woman', 'cut', 'broccoli']",1.5,1,1027,1444,-417,173889
680,"['woman', 'boil', 'shrimp']","['woman', 'come', 'hair']",1.0,1,1077,939,138,19044
681,"['man', 'cut', 'potato']","['man', 'slide', 'potato']",3.75,2,2513,4041,-1528,2334784
682,"['man', 'dance', 'road']","['man', 'dance']",3.25,2,2525,3381,-856,732736
683,"['deer', 'jump', 'fence']","['deer', 'jump', 'cycling', 'fence']",4.0,3,3754,4608,-854,729316
684,"['girl', 'dance', 'rain']","['woman', 'dance', 'rain']",3.0,2,2532,2905,-373,139129
685,"['woman', 'write', 'letter']","['woman', 'sit', 'desk']",1.6670000553131104,1,1075,1596,-521,271441
686,"['gorilla', 'play', 'drum']","['monkey', 'play', 'drum']",3.3329999446868896,2,2526,3413,-887,786769
687,"['woman', 'ride', 'horse']","['woman', 'pick', 'potato']",0.5,1,1073,602,471,221841
688,"['boy', 'cut', 'grass', 'curb', 'scissor']","['boy', 'cut', 'grass', 'scissor']",3.75,4,3898,4028,-130,16900
689,"['man', 'glass', 'talk']","['man', 'library', 'talk']",3.25,2,2476,3390,-914,835396
690,"['woman', 'cut', 'flower']","['woman', 'cut', 'broccoli']",1.0,2,2480,963,1517,2301289
691,"['person', 'walk', 'stone', 'path']","['man', 'walk', 'sidewalk']",3.5,1,1071,3728,-2657,7059649
692,"['man', 'play', 'keyboard', 'nose']","['man', 'play', 'piano', 'nose']",4.400000095367432,3,3768,4986,-1218,1483524
693,"['man', 'play', 'guitar']","['cat', 'play']",0.4000000059604645,1,1069,484,585,342225
694,"['animal', 'eat']","['animal', 'hop']",0.4000000059604645,1,1068,492,576,331776
695,"['man', 'lift', 'weight']","['man', 'lift', 'tarbell']",4.199999809265137,2,2464,4898,-2434,5924356
696,"['man', 'run', 'bus']","['man', 'run', 'truck']",2.5,2,2500,2339,161,25921
697,"['man', 'climb', 'rope']","['man', 'sit', 'rock']",0.25,1,1065,450,615,378225
698,"['cat', 'play', 'piano']","['cat', 'lick', 'paw']",0.25,1,1064,449,615,378225
699,"['woman', 'dance', 'rain']","['woman', 'add', 'oil', 'dish']",0.25,1,1070,448,622,386884
700,"['man', 'run', 'race']","['face', 'run', 'track']",2.5999999046325684,1,1080,2431,-1351,1825201
701,"['man', 'cut', 'potato', 'piece']","['woman', 'cut', 'potato']",1.7999999523162842,2,2492,1767,725,525625
702,"['man', 'play', 'flute']","['woman', 'apply', 'eye', 'line']",0.0,0,27,229,-202,40804
703,"['woman', 'cut', 'potato']","['woman', 'slide', 'carrot']",1.2000000476837158,1,1081,1193,-112,12544
704,"['chicken', 'pack', 'dead', 'mouse']","['monster', 'neck', 'dead', 'mouse']",3.5999999046325684,2,2491,3798,-1307,1708249
705,"['woman', 'thinly', 'slide', 'cucumber']","['woman', 'slide', 'tomato']",1.2000000476837158,2,2488,1192,1296,1679616
706,"['person', 'slide', 'bread', 'piece']","['man', 'slide', 'bread']",3.200000047683716,2,2484,3276,-792,627264
707,"['woman', 'cut', 'square']","['woman', 'cut', 'big', 'pepper']",2.200000047683716,2,2499,2013,486,236196
708,"['woman', 'add', 'oil', 'fish']","['woman', 'ride', 'horse']",0.800000011920929,1,1093,834,259,67081
709,"['woman', 'grate', 'carrot']","['woman', 'coat', 'pork', 'chop']",1.600000023841858,1,1092,1554,-462,213444
710,"['clean', 'animal']","['woman', 'clean', 'shrimp']",2.799999952316284,1,1091,2583,-1492,2226064
711,"['man', 'talk', 'phone']","['man', 'talk']",3.200000047683716,2,2465,3305,-840,705600
712,"['woman', 'smoke']","['woman', 'make', 'food']",0.800000011920929,1,1090,854,236,55696
713,"['man', 'lay', 'shoot', 'gun']","['man', 'lay', 'ground', 'shoot', 'rifle']",3.799999952316284,3,2683,4090,-1407,1979649
714,"['man', 'ambulance']","['man', 'pour', 'past', 'plate']",0.0,1,1096,226,870,756900
715,"['man', 'dive', 'swimming', 'pool']","['man', 'singe', 'microphone']",0.6669999957084656,1,1089,730,359,128881
716,"['man', 'fire', 'shot', 'gun']","['man', 'shoot', 'shotgun']",5.0,1,1087,5719,-4632,21455424
717,"['man', 'play', 'guitar']","['man', 'play', 'flute']",1.7999999523162842,2,2504,1739,765,585225
718,"['man', 'peel', 'potato']","['man', 'play', 'guitar']",0.4000000059604645,1,1086,475,611,373321
719,"['woman', 'ride', 'horse']","['man', 'ride', 'horse', 'arena']",2.0,2,2534,1778,756,571536
720,"['airplane', 'move', 'runaway']","['plane', 'land', 'runaway']",2.799999952316284,1,1084,2603,-1519,2307361
721,"['woman', 'slip', 'water', 'tub']","['woman', 'lie', 'raft']",0.800000011920929,1,1083,848,235,55225
722,"['man', 'mow', 'lawn']","['man', 'mix']",0.800000011920929,1,1082,847,235,55225
723,"['woman', 'peel', 'potato']","['woman', 'hit', 'man']",0.75,1,1063,745,318,101124
724,"['man', 'play', 'piano']","['man', 'lay', 'ground']",0.75,1,1079,746,333,110889
725,"['woman', 'ballet']","['woman', 'ride', 'horse']",1.0,1,1062,922,140,19600
726,"['woman', 'cut', 'onion']","['woman', 'row', 'boat']",0.800000011920929,1,1043,845,198,39204
727,"['woman', 'stir', 'rice', 'pot']","['put', 'rice', 'pan']",2.7690000534057617,1,1041,2573,-1532,2347024
728,"['woman', 'put', 'slab', 'meat', 'pan']","['man', 'put', 'piece', 'meat', 'plastic', 'bag']",2.400000095367432,2,2536,2305,231,53361
729,"['boy', 'play', 'trumpet']","['boy', 'play', 'trumpet']",4.400000095367432,3,2675,4977,-2302,5299204
730,"['person', 'ride', 'horse']","['man', 'ride', 'motorcycle']",1.7999999523162842,1,1039,1726,-687,471969
731,"['woman', 'slide', 'onion']","['woman', 'cut', 'carrot']",1.399999976158142,1,1038,1406,-368,135424
732,"['man', 'slide', 'vegetable']","['woman', 'slide', 'potato']",2.25,1,1037,2146,-1109,1229881
733,"['cat', 'play']","['woman', 'play', 'flute']",0.25,1,1036,439,597,356409
734,"['man', 'ride', 'bicycle']","['man', 'ride', 'bicycle', 'parking', 'lot']",3.25,3,2650,3393,-743,552049
735,"['band', 'perform', 'stage']","['band', 'play', 'singe', 'stage']",4.5,2,2543,5142,-2599,6754801
736,"['woman', 'slide', 'fish', 'cake']","['woman', 'ride', 'horse']",0.800000011920929,1,1042,867,175,30625
737,"['man', 'eat', 'bread']","['man', 'play', 'flute']",0.800000011920929,1,1035,877,158,24964
738,"['woman', 'cook', 'shrimp']","['woman', 'dance']",0.800000011920929,1,1033,870,163,26569
739,"['woman', 'dance']","['woman', 'slide', 'ginger']",0.25,1,1032,441,591,349281
740,"['woman', 'losse', 'cat', 'air', 'cat', 'hang', 'rod', 'ceiling']","['person', 'throw', 'cat', 'air', 'grab', 'ceiling']",3.5,3,2653,3698,-1045,1092025
741,"['big', 'turtle', 'walk']","['tortoise', 'walk']",4.25,1,1031,4920,-3889,15124321
742,"['man', 'burn', 'flag']","['man', 'shoot', 'gun']",0.5,1,1030,605,425,180625
743,"['man', 'push', 'van']","['woman', 'singe']",0.0,0,29,223,-194,37636
744,"['man', 'eat', 'wood']","['man', 'add', 'oil', 'car']",0.5,1,1028,607,421,177241
745,"['dog', 'speak', 'camera']","['dog', 'eat', 'water', 'melon']",0.6000000238418579,1,1034,648,386,148996
746,"['man', 'put', 'paper', 'towel', 'paper', 'plate']","['man', 'put', 'paper', 'dish']",2.200000047683716,3,2662,2018,644,414736
747,"['man', 'woman', 'walk']","['man', 'woman', 'walk', 'hold']",3.200000047683716,3,2792,3080,-288,82944
748,"['man', 'cut', 'rope', 'sword']","['man', 'lead', 'thick', 'rope', 'sword']",4.400000095367432,3,2783,4992,-2209,4879681
749,"['man', 'singe', 'play', 'guitar']","['man', 'play', 'guitar']",3.0,3,2797,2826,-29,841
750,"['man', 'cut', 'paper']","['person', 'tear', 'paper']",2.5829999446868896,1,1045,2367,-1322,1747684
751,"['man', 'dance']","['rat', 'run']",0.0,0,30,221,-191,36481
752,"['boy', 'talk', 'phone']","['woman', 'talk', 'telephone']",1.7999999523162842,1,1059,1730,-671,450241
753,"['man', 'play', 'guitar']","['woman', 'peel', 'tube']",0.0,0,31,220,-189,35721
754,"['woman', 'slide', 'onion']","['woman', 'slide', 'lemon']",1.399999976158142,2,2414,1420,994,988036
755,"['woman', 'ride', 'horse']","['man', 'run', 'rope']",0.0,0,32,234,-202,40804
756,"['man', 'play', 'soccer']","['man', 'draw', 'figure']",0.4000000059604645,1,1056,508,548,300304
757,"['woman', 'peel', 'orange']","['man', 'play', 'flute']",0.0,0,33,219,-186,34596
758,"['crack', 'egg', 'open']","['man', 'break', 'egg']",3.0,1,1055,2832,-1777,3157729
759,"['man', 'cut', 'snake', 'cook']","['woman', 'cut', 'meat']",2.0,1,1054,1867,-813,660969
760,"['woman', 'scrape', 'carrot']","['man', 'strike', 'clay', 'pot']",0.0,0,34,217,-183,33489
761,"['man', 'woman', 'bollywood', 'dancing']","['man', 'woman', 'dance', 'rain']",1.6670000553131104,2,2398,1598,800,640000
762,"['woman', 'cut', 'flower']","['man', 'hold', 'huge', 'sunflower']",1.0,0,35,1063,-1028,1056784
763,"['man', 'dance', 'dinner']","['bomb', 'explode', 'desert']",0.0,0,36,216,-180,32400
764,"['american', 'flag', 'wave']","['american', 'flag', 'blow', 'wind']",4.199999809265137,2,2383,4887,-2504,6270016
765,"['lion', 'walk', 'enclosed', 'area']","['lion', 'walk']",2.5999999046325684,2,2392,2500,-108,11664
766,"['woman', 'slide', 'lemon']","['man', 'show', 'bread']",0.25,0,37,452,-415,172225
767,"['woman', 'play', 'flute']","['woman', 'slide', 'tune']",0.4000000059604645,1,1050,503,547,299209
768,"['dog', 'bark', 'toy']","['dog', 'bark', 'electronic', 'toy', 'duck']",3.5,3,2736,3725,-989,978121
769,"['woman', 'add', 'egg', 'stirring']","['woman', 'mix', 'egg', 'bowl']",3.5,2,2447,3704,-1257,1580049
770,"['woman', 'cover', 'piece', 'meat', 'flour']","['woman', 'reason', 'piece', 'meat']",3.0,3,2740,2838,-98,9604
771,"['white', 'cat', 'perch', 'small', 'wooden', 'cabinet', 'look', 'outside', 'window']","['cat', 'perch', 'table', 'look', 'window']",3.400000095367432,4,3883,3429,454,206116
772,"['man', 'floor', 'exercise']","['man', 'exercise']",3.5999999046325684,2,2459,3791,-1332,1774224
773,"['man', 'slide', 'potato']","['man', 'peel', 'banana']",1.0,1,1046,1092,-46,2116
774,"['play', 'piano']","['person', 'play', 'keyboard', 'piano']",3.5999999046325684,2,2442,3827,-1385,1918225
775,"['woman', 'put', 'man']","['woman', 'paint', 'face', 'man']",2.799999952316284,2,2427,2613,-186,34596
776,"['woman', 'drop', 'eggplant', 'pan']","['woman', 'put', 'chop', 'eggplant', 'skilled']",4.0,2,2544,4603,-2059,4239481
777,"['man', 'play', 'trumpet']","['man', 'play', 'musical', 'instrument']",3.400000095367432,2,2624,3466,-842,708964
778,"['woman', 'slide', 'lemon']","['woman', 'kitchen', 'feel', 'lemon']",2.6670000553131104,2,2622,2528,94,8836
779,"['tiger', 'try', 'climb', 'wall']","['lion', 'try', 'climb', 'wall']",3.0,3,2762,2842,-80,6400
780,"['man', 'prepare', 'hang', 'rope']","['man', 'tie', 'noose']",4.666999816894531,1,1352,5315,-3963,15705369
781,"['woman', 'dance', 'stage']","['woman', 'dance']",3.200000047683716,2,2629,3088,-459,210681
782,"['girl', 'ride', 'horse']","['girl', 'spray', 'plant', 'water']",0.2000000029802322,1,1341,393,948,898704
783,"['person', 'try']","['person', 'peel', 'potato']",1.2000000476837158,1,1347,1185,162,26244
784,"['man', 'shoot', 'pistol']","['woman', 'chop', 'garlic']",0.800000011920929,0,22,853,-831,690561
785,"['woman', 'swinge', 'arm']","['woman', 'slide', 'onion']",0.800000011920929,1,1344,851,493,243049
786,"['man', 'walk', 'outside']","['man', 'dance']",0.75,1,1340,736,604,364816
787,"['man', 'dry', 'hand']","['woman', 'fix', 'hair']",0.25,0,40,437,-397,157609
788,"['soccer', 'player', 'kick', 'soccer', 'ball', 'goal', 'long', 'way', 'field']","['soccer', 'player', 'kick', 'ball', 'goal']",3.25,5,4995,3398,1597,2550409
789,"['girl', 'play', 'piano']","['little', 'girl', 'play', 'grand', 'piano', 'stage']",3.3329999446868896,3,2727,3407,-680,462400
790,"['man', 'draw', 'figure']","['man', 'draw', 'digital', 'dry', 'ease', 'board']",3.3329999446868896,2,2570,3409,-839,703921
791,"['monkey', 'hang', 'tree']","['monkey', 'swing', 'branch', 'branch']",2.0,1,1328,1834,-506,256036
792,"['child', 'jump', 'trampoline']","['boy', 'play', 'trampling']",3.0,0,21,2908,-2887,8334769
793,"['woman', 'knife', 'slide', 'pepper']","['woman', 'slide', 'green', 'pepper']",4.0,3,2735,4551,-1816,3297856
794,"['man', 'add', 'oil', 'car']","['man', 'put', 'anti', 'freeze', 'car']",2.0,2,2560,1837,723,522729
795,"['man', 'slide', 'carrot', 'machine']","['man', 'climb', 'rope']",0.4000000059604645,1,1362,496,866,749956
796,"['boy', 'play', 'keyboard']","['person', 'play', 'piano', 'keyboard']",3.200000047683716,2,2572,3184,-612,374544
797,"['cat', 'play', 'antenna']","['boy', 'play', 'mud']",0.4000000059604645,1,1357,493,864,746496
798,"['woman', 'slide', 'pushkin']","['person', 'slide', 'cantaloupe']",2.0,1,1269,1836,-567,321489
799,"['people', 'throw', 'dummy', 'cliff', 'edge']","['people', 'throw', 'dummy', 'cliff']",4.5,4,3961,5137,-1176,1382976
800,"['gun', 'fire']","['potato', 'peel']",0.5,0,2,611,-609,370881
801,"['woman', 'cut', 'plastic', 'sheet']","['woman', 'play', 'guitar', 'street']",0.5,1,1280,603,677,458329
802,"['woman', 'cut', 'pineapple']","['woman', 'slide', 'pineapple', 'piece']",4.0,2,2595,4682,-2087,4355569
803,"['woman', 'add', 'space', 'meat']","['woman', 'add', 'ingredient', 'beef']",3.75,2,2589,4056,-1467,2152089
804,"['person', 'add', 'oil', 'pan']","['cook', 'pour', 'oil', 'pan']",4.25,2,2587,4926,-2339,5470921
805,"['cook', 'season', 'dough']","['man', 'reason', 'dough', 'pan']",3.75,1,1260,4000,-2740,7507600
806,"['boy', 'run', 'beach']","['boy', 'play', 'beach']",2.75,2,2585,2572,13,169
807,"['baby', 'monkey', 'scratch']","['monkey', 'scratch', 'mummy']",3.25,2,2582,3339,-757,573049
808,"['boy', 'ride', 'bike', 'gate']","['woman', 'ride', 'horse']",0.800000011920929,1,1252,880,372,138384
809,"['man', 'card', 'trick']","['man', 'squeeze', 'water']",0.25,1,1253,454,799,638401
810,"['man', 'play', 'piano']","['play', 'guitar']",0.75,1,1258,732,526,276676
811,"['man', 'mow', 'grass']","['guy', 'mow', 'lawn']",4.800000190734863,1,1271,5421,-4150,17222500
812,"['person', 'mix', 'water', 'flour']","['person', 'hitchhike', 'road']",0.800000011920929,1,1283,879,404,163216
813,"['dog', 'pen']","['cowboy', 'ride', 'horse', 'desert']",0.0,0,4,210,-206,42436
814,"['man', 'ride', 'wheel', 'motorcycle']","['person', 'perform', 'trick', 'motorcycle']",3.0,1,1305,2765,-1460,2131600
815,"['cat', 'open', 'drawer', 'limb', 'inside']","['big', 'cat', 'open', 'plastic', 'drawer', 'paw', 'hope', 'inside']",3.75,4,3919,3992,-73,5329
816,"['man', 'open', 'box', 'knife']","['man', 'play', 'guitar']",0.0,1,1320,209,1111,1234321
817,"['man', 'kick', 'boot', 'water']","['woman', 'slide', 'red', 'pepper']",0.25,0,6,453,-447,199809
818,"['man', 'eat']","['woman', 'rock', 'climbing']",0.0,0,7,208,-201,40401
819,"['puppy', 'repeatedly', 'roll']","['dog', 'roll']",3.5,1,1311,3708,-2397,5745609
820,"['young', 'boy', 'sing', 'play', 'guitar']","['kid', 'play', 'guitar']",3.25,2,2630,3334,-704,495616
821,"['woman', 'peel', 'lemon']","['man', 'balance', 'wire']",0.4000000059604645,0,8,461,-453,205209
822,"['man', 'play', 'trumpet']","['play', 'tell']",0.800000011920929,1,1286,875,411,168921
823,"['dog', 'look']","['dog', 'watch', 'store', 'counter']",1.600000023841858,1,1290,1463,-173,29929
824,"['woman', 'slide', 'onion']","['man', 'show', 'slide', 'carrot', 'knife']",1.2000000476837158,1,1292,1180,112,12544
825,"['man', 'drill', 'hole', 'wood']","['man', 'drill', 'wood']",4.199999809265137,3,2703,4838,-2135,4558225
826,"['cut', 'circle', 'pink', 'sheet', 'paper']","['pour', 'tomato', 'sauce', 'pot', 'meat']",0.2000000029802322,0,9,426,-417,173889
827,"['man', 'play', 'flute']","['man', 'pet', 'tie', 'dog']",0.2000000029802322,1,1296,431,865,748225
828,"['man', 'place', 'meat', 'bag']","['man', 'drive', 'car']",0.5,1,1323,595,728,529984
829,"['girl', 'eat', 'cupcake']","['man', 'play', 'trumpet']",0.0,0,10,207,-197,38809
830,"['rabbit', 'sniff', 'paw', 'stuff', 'rabbit']","['live', 'rabbit', 'play', 'stuff', 'animal', 'funny']",4.5,2,2575,5132,-2557,6538249
831,"['man', 'mutter', 'bread']","['woman', 'ride', 'horse']",0.0,0,11,205,-194,37636
832,"['woman', 'squeeze', 'cucumber', 'slice']","['woman', 'getting', 'rouse', 'green', 'slime']",0.75,1,1295,741,554,306916
833,"['man', 'take', 'inside', 'green', 'pepper']","['remove', 'seed', 'bell', 'pepper']",4.0,1,1300,4523,-3223,10387729
834,"['man', 'take', 'piece', 'pepperoni', 'penza', 'penza', 'box', 'put', 'lid', 'close', 'box']","['man', 'take', 'piece', 'pepperoni', 'penza', 'box']",2.75,6,5186,2562,2624,6885376
835,"['man', 'add', 'vegetable', 'pot']","['man', 'add', 'slice', 'vegetable', 'cooking', 'bowl', 'water']",3.400000095367432,3,2688,3616,-928,861184
836,"['man', 'run', 'jump', 'wall']","['man', 'jump', 'wall']",3.400000095367432,3,2660,3622,-962,925444
837,"['man', 'reason', 'sausage']","['man', 'add', 'reasoning', 'water', 'bowl']",2.400000095367432,1,1307,2234,-927,859329
838,"['clown', 'singe', 'people', 'dance']","['clown', 'singe']",3.0,2,2573,2808,-235,55225
839,"['woman', 'feed', 'aardvark']","['woman', 'chop', 'garlic']",0.4000000059604645,1,1281,470,811,657721
840,"['person', 'rinse', 'speak', 'water']","['man', 'rinse', 'large', 'speak']",3.928999900817871,2,2638,4340,-1702,2896804
841,"['boy', 'ride', 'bike', 'metal', 'fence']","['bmx', 'baker', 'ride', 'fence']",3.0,2,2633,2812,-179,32041
842,"['man', 'throw', 'knife', 'tree']","['man', 'show', 'magic']",1.75,1,1322,1605,-283,80089
843,"['girl', 'walk', 'stage']","['woman', 'model', 'walk', 'catwalk']",2.5999999046325684,1,1248,2499,-1251,1565001
844,"['woman', 'weight', 'exercise']","['woman', 'exercise', 'tarbell']",3.5,2,2607,3742,-1135,1288225
845,"['man', 'peel', 'potato']","['man', 'hide']",0.5,1,1277,598,679,461041
846,"['large', 'bird', 'stand', 'table', 'pick', 'plastic', 'glass', 'contain', 'liquid', 'place', 'bowl']","['bird', 'pick', 'plastic', 'cup', 'contain', 'liquid', 'beak', 'put', 'cup', 'bowl']",3.5,6,5188,3733,1455,2117025
847,"['woman', 'rain']","['car', 'drive', 'road']",0.0,0,13,218,-205,42025
848,"['woman', 'hit', 'man']","['man', 'hold', 'slow', 'boris']",0.0,1,1265,236,1029,1058841
849,"['woman', 'ride', 'elephant']","['man', 'lift']",0.0,0,14,252,-238,56644
850,"['man', 'lift', 'weight']","['woman', 'exercise']",1.0,0,15,1039,-1024,1048576
851,"['person', 'ride', 'jet', 'wave']","['woman', 'ride', 'seldom']",2.0,1,1348,1805,-457,208849
852,"['woman', 'wear', 'headphone']","['woman', 'chop', 'leave']",0.6000000238418579,1,1353,618,735,540225
853,"['kitten', 'eat', 'food', 'plate']","['kitten', 'eat', 'food']",4.0,3,2656,4364,-1708,2917264
854,"['woman', 'read', 'lifestyle', 'magazine']","['woman', 'slide', 'meat', 'piece']",0.5,1,1326,599,727,528529
855,"['man', 'pour', 'child', 'bowl']","['man', 'open', 'hour', 'content', 'bowl']",2.5,2,2149,2359,-210,44100
856,"['bird', 'eat', 'food', 'tree', 'bowl']","['bird', 'eat', 'bowl']",3.25,3,2663,3358,-695,483025
857,"['group', 'girl', 'exist', 'taxi']","['video', 'clip', 'hanna', 'leave', 'taxi']",2.0,1,1274,1801,-527,277729
858,"['woman', 'reason', 'piece', 'meat']","['man', 'load', 'rifle', 'bullet']",0.0,0,17,267,-250,62500
859,"['man', 'chop', 'commander', 'leaf']","['man', 'play', 'guitar']",0.800000011920929,1,1279,783,496,246016
860,"['man', 'take', 'slice', 'penza']","['man', 'talk', 'cell', 'phone']",0.800000011920929,1,1245,784,461,212521
861,"['man', 'place', 'meat', 'inside', 'plastic', 'bag']","['woman', 'carry', 'allay', 'bag']",0.4000000059604645,1,1249,569,680,462400
862,"['rabbi', 'talk']","['man', 'walk', 'rope']",0.0,0,18,266,-248,61504
863,"['man', 'ride', 'horse']","['woman', 'rub', 'baby', 'leg']",0.0,0,20,265,-245,60025
864,"['man', 'play', 'guitar']",['lay'],0.0,0,42,264,-222,49284
865,"['man', 'slide']","['man', 'break', 'pot']",0.4000000059604645,1,1316,516,800,640000
866,"['man', 'drive', 'car']","['woman', 'lip', 'shrimp', 'matter']",0.0,0,62,263,-201,40401
867,"['dog', 'paw', 'fly', 'carpet']","['dog', 'play', 'bug', 'carpet']",3.5999999046325684,2,2150,3811,-1661,2758921
868,"['dog', 'bark']","['jet', 'fly']",0.231000006198883,0,65,436,-371,137641
869,"['monkey', 'walk', 'bed']","['man', 'ride', 'horse']",0.0,0,66,262,-196,38416
870,"['woman', 'cook', 'broccoli']","['man', 'eat', 'food']",0.5,0,67,597,-530,280900
871,"['man', 'try', 'gorilla']","['person', 'perform', 'card', 'trick']",0.0,0,68,261,-193,37249
872,"['woman', 'serve', 'volleyball', 'net']","['woman', 'hand', 'volleyball', 'woman', 'serve']",2.75,3,2687,2556,131,17161
873,"['man', 'slide', 'cucumber', 'knife']","['man', 'cook', 'gorilla', 'skilled']",0.75,1,1293,735,558,311364
874,"['man', 'play', 'electronic', 'keyboard']","['band', 'play', 'instrument']",1.25,1,1294,1252,42,1764
875,"['man', 'play', 'violin']","['baby', 'laugh', 'crawl']",0.0,0,69,259,-190,36100
876,"['man', 'severe', 'toe', 'leather', 'boot', 'sword']","['man', 'cut', 'boot', 'sword']",3.75,3,2672,3993,-1321,1745041
877,"['person', 'remove', 'scale', 'fish']","['person', 'deal', 'fish']",5.0,2,2131,5713,-3582,12830724
878,"['people', 'walk', 'garden']","['boy', 'talk', 'man']",0.0,0,70,258,-188,35344
879,"['young', 'child', 'ride', 'horse']","['little', 'girl', 'ride', 'horse']",3.200000047683716,2,2140,3151,-1011,1022121
880,"['person', 'cut', 'garlic', 'piece', 'knife']","['put', 'ingredient', 'work']",0.75,0,71,740,-669,447561
881,"['man', 'fold', 'piece', 'paper']","['man', 'slide', 'plastic', 'container', 'sword']",0.5,1,1288,606,682,465124
882,"['man', 'push', 'water']","['man', 'push', 'man', 'ocean']",2.5,2,2141,2345,-204,41616
883,"['boy', 'upset', 'play', 'video', 'game']","['play', 'pageboy']",1.75,1,1291,1620,-329,108241
884,"['man', 'make', 'cell', 'phone']","['man', 'make', 'phone']",4.0,3,2676,4413,-1737,3017169
885,"['man', 'speak', 'phone']","['bear', 'chew', 'stick']",0.0,0,72,255,-183,33489
886,"['woman', 'apply', 'cosmetic', 'face']","['woman', 'put']",4.599999904632568,1,1302,5181,-3879,15046641
887,"['man', 'lift', 'barrel']","['man', 'lift', 'weight']",4.0,2,2144,4439,-2295,5267025
888,"['woman', 'need', 'animal', 'hand']","['woman', 'feed', 'animal']",3.0,2,2192,3019,-827,683929
889,"['ferret', 'climb', 'cage']","['secret', 'climb', 'shelf']",2.200000047683716,1,1319,2030,-711,505521
890,"['young', 'woman', 'play', 'flute']","['woman', 'wash', 'freeze']",0.0,1,1315,251,1064,1132096
891,"['woman', 'shoot', 'shotgun']","['woman', 'shoot', 'rifle']",2.799999952316284,2,2195,2648,-453,205209
892,"['person', 'add', 'child', 'powder', 'child', 'bean']","['man', 'add', 'reasoning', 'bean']",3.799999952316284,2,2200,4326,-2126,4519876
893,"['woman', 'rapidly', 'fire', 'handful']","['woman', 'shoot', 'gun']",4.400000095367432,1,1310,5100,-3790,14364100
894,"['person', 'slide', 'onion']","['solenodon', 'walk', 'ground']",0.0,0,74,249,-175,30625
895,"['dog', 'open', 'fridge']","['dog', 'close', 'refrigerator', 'door']",1.75,1,1308,1624,-316,99856
896,"['woman', 'hold', 'dancing', 'baby']","['woman', 'abuse', 'child']",1.0,1,1304,1002,302,91204
897,"['woman', 'joke', 'man']","['girl', 'apply', 'face', 'man']",1.7999999523162842,1,1282,1672,-390,152100
898,"['lady', 'add', 'cheese', 'sauce']","['man', 'hour', 'plate', 'shrouded', 'cheese', 'pot', 'sauce']",1.600000023841858,2,2202,1508,694,481636
899,"['man', 'give', 'lecture', 'sodium']","['man', 'deliver', 'lecture', 'event', 'celebrate', 'game', 'cricket']",2.3329999446868896,2,2204,2168,36,1296
900,"['cat', 'shimmy', 'bed']","['cat', 'crawl', 'upside', 'couch']",2.0,1,1259,1955,-696,484416
901,"['woman', 'chop', 'garlic']","['woman', 'slice', 'fish']",1.0,1,1257,1006,251,63001
902,"['man', 'cut', 'grass']","['masked', 'man', 'sing']",0.0,1,1256,247,1009,1018081
903,"['man', 'cut', 'grass']","['clown', 'singe']",0.0,0,75,246,-171,29241
904,"['boy', 'run', 'away', 'fishing', 'line']","['boy', 'run', 'fish', 'hang', 'fishing', 'rod']",3.0,3,2784,3061,-277,76729
905,"['man', 'play', 'office']","['man', 'reason', 'vegetable']",0.4000000059604645,1,1251,589,662,438244
906,"['man', 'carry', 'man']","['man', 'take', 'picture', 'ant']",0.4000000059604645,1,1247,568,679,461041
907,"['seat', 'drop', 'pan']","['woman', 'put', 'meat', 'pan']",3.25,1,1261,3366,-2105,4431025
908,"['woman', 'cut', 'stallion']","['woman', 'fall', 'sand', 'castle']",0.0,1,1262,243,1019,1038361
909,"['man', 'slam', 'dun', 'ball']","['woman', 'slide', 'onion']",0.0,0,76,242,-166,27556
910,"['machine', 'sharpen', 'pencil']","['girl', 'ride', 'bicycle']",0.0,0,77,241,-164,26896
911,"['woman', 'brush', 'foot']","['sun', 'rise', 'tree']",0.0,0,78,240,-162,26244
912,"['man', 'clean', 'window']","['man', 'drive', 'car']",0.4000000059604645,1,1273,566,707,499849
913,"['person', 'stir', 'rice']","['woman', 'crack', 'egg']",1.0,0,79,1015,-936,876096
914,"['man', 'put', 'knife', 'vice']","['man', 'dance']",0.25,1,1267,438,829,687241
915,"['boy', 'play', 'violin', 'stage']","['boy', 'stage', 'play', 'violin']",4.25,4,4103,4928,-825,680625
916,"['woman', 'cut', 'pink', 'loaf', 'knife']","['man', 'play', 'guitar']",0.1180000007152557,0,81,369,-288,82944
917,"['man', 'add', 'pork', 'crop', 'pan']","['woman', 'peel', 'potato']",1.0,0,64,1019,-955,912025
918,"['man', 'fight']","['man', 'draw', 'white', 'paper']",0.4000000059604645,1,1264,538,726,527076
919,"['man', 'catch', 'ball']","['cat', 'rub', 'baby']",0.0,0,82,239,-157,24649
920,"['girl', 'read', 'newspaper']","['chef', 'peel', 'potato']",0.0,0,63,238,-175,30625
921,"['slow', 'boris', 'bite', 'person', 'finger']","['small', 'animal', 'chew', 'finger']",2.5,1,1360,2330,-970,940900
922,"['man', 'walk', 'path', 'wilderness']","['man', 'peel', 'onion']",0.75,1,1354,733,621,385641
923,"['man', 'play', 'guitar']","['guy', 'singe', 'play', 'guitar']",3.0,2,2178,3008,-830,688900
924,"['man', 'state', 'road']","['boy', 'state', 'boarding']",2.5999999046325684,1,1336,2427,-1091,1190281
925,"['man', 'hour', 'liquid', 'pan']","['chef', 'pour', 'oil', 'pan']",2.5999999046325684,1,1324,2430,-1106,1223236
926,"['boy', 'play', 'piano', 'singing']","['pig', 'agitate', 'lion']",0.0,0,61,203,-142,20164
927,"['cat', 'ferret', 'play']","['ferret', 'kitten', 'play']",4.25,2,2180,4942,-2762,7628644
928,"['monkey', 'walk', 'water']","['guy', 'play', 'trumpet']",0.0,0,45,202,-157,24649
929,"['woman', 'put']","['band', 'singe']",0.0,0,46,201,-155,24025
930,"['dog', 'drive', 'car']","['guy', 'talk', 'microphone']",0.0,0,47,184,-137,18769
931,"['man', 'sing', 'stage', 'microphone']","['man', 'suit', 'stand', 'microphone', 'singing']",3.5,2,2183,3737,-1554,2414916
932,"['car', 'back', 'space']","['car', 'take', 'reverse']",2.400000095367432,1,1334,2301,-967,935089
933,"['man', 'hold', 'frog']","['man', 'empty', 'plastic', 'container']",0.6000000238418579,1,1335,638,697,485809
934,"['man', 'travel', 'boat']","['woman', 'cut', 'carrot', 'knife']",0.0,0,48,164,-116,13456
935,"['man', 'ride', 'motorcycle', 'highway']","['person', 'drive', 'motorcycle', 'road']",3.75,1,1350,4037,-2687,7219969
936,"['man', 'dine', 'onion']","['man', 'play', 'guitar']",0.4000000059604645,1,1338,535,803,644809
937,"['man', 'perform', 'stage']","['man', 'gun', 'fish']",0.4000000059604645,1,1343,533,810,656100
938,"['woman', 'sit']","['woman', 'sit', 'close', 'talk']",2.5999999046325684,2,2066,2438,-372,138384
939,"['man', 'remove', 'couple', 'master', 'scramble', 'plastic', 'packet']","['man', 'remove', 'food', 'bag']",1.75,2,2067,1602,465,216225
940,"['woman', 'dance', 'fire']","['man', 'tie', 'noose']",0.0,0,49,163,-114,12996
941,"['man', 'meditate']","['man', 'ride', 'horse']",0.75,1,1342,738,604,364816
942,"['boy', 'cut', 'paper']","['man', 'load', 'rifle']",0.0,0,50,162,-112,12544
943,"['man', 'talk', 'telephone']","['girl', 'walk', 'stage']",0.0,0,51,161,-110,12100
944,"['man', 'play', 'guitar', 'singing']","['man', 'open', 'package', 'contain', 'headphone']",0.800000011920929,1,1339,827,512,262144
945,"['soccer', 'player', 'kick', 'ball', 'leg']","['person', 'kick', 'soccer', 'ball', 'forth', 'foot']",3.400000095367432,3,2767,3497,-730,532900
946,"['animal', 'walk']","['woman', 'apply', 'eye']",0.0,0,52,160,-108,11664
947,"['scratch', 'animal', 'belly']","['woman', 'stroke', 'femur']",2.0,0,53,1903,-1850,3422500
948,"['man', 'lift', 'heavy', 'weight']","['allay', 'lick', 'woman', 'hand']",0.25,0,54,451,-397,157609
949,"['boy', 'play', 'toy']","['boy', 'play', 'handed', 'game']",3.0,2,2044,2962,-918,842724
950,"['man', 'give', 'cliff']","['man', 'ride', 'motorcycle']",0.6669999957084656,1,1355,728,627,393129
951,"['man', 'come', 'water']","['man', 'rise', 'swamp']",3.200000047683716,1,1358,3207,-1849,3418801
952,"['man', 'woman', 'dance']","['man', 'pet', 'dog']",0.3330000042915344,1,955,457,498,248004
953,"['man', 'sweep', 'floor', 'house', 'long', 'broom']","['man', 'sweep', 'living', 'room']",3.3329999446868896,2,2053,3414,-1361,1852321
954,"['group', 'couple', 'dance']","['man', 'woman', 'dance', 'slowly']",3.3329999446868896,1,953,3418,-2465,6076225
955,"['man', 'seal', 'fish']","['man', 'hour', 'cook', 'oil', 'pot']",1.0,1,861,1060,-199,39601
956,"['man', 'set', 'camera', 'sunset', 'picture', 'beach']","['man', 'take', 'picture', 'lake']",2.200000047683716,2,2054,2136,-82,6724
957,"['hold', 'pet', 'baby', 'tiger']","['rinse', 'large', 'beef', 'speak', 'kitchen', 'sink']",0.4000000059604645,0,55,530,-475,225625
958,"['man', 'play', 'guitar']","['cat', 'clean', 'face', 'paw']",0.0,0,56,158,-102,10404
959,"['man', 'push', 'wall']","['man', 'base', 'food']",0.25,1,562,445,117,13689
960,"['woman', 'cut', 'vegetable']","['woman', 'slide', 'egg', 'plant']",2.25,1,563,2163,-1600,2560000
961,"['person', 'break', 'egg', 'small', 'bowl']","['man', 'crack', 'egg']",2.5999999046325684,1,564,2412,-1848,3415104
962,"['man', 'play', 'keyboard']","['man', 'ride', 'mechanical', 'bull']",1.2000000476837158,1,565,1173,-608,369664
963,"['dog', 'run', 'yard']","['black', 'pet', 'dog', 'run', 'garden', 'house']",3.200000047683716,2,2055,3181,-1126,1267876
964,"['child', 'walk', 'street', 'deep', 'pull']","['woman', 'walk', 'road', 'man', 'morcar', 'pull']",1.399999976158142,2,2059,1417,642,412164
965,"['man', 'add', 'oil', 'pot']","['dog', 'catch', 'fish', 'river']",0.2000000029802322,0,57,382,-325,105625
966,"['girl', 'dance', 'bonfire']","['woman', 'dance', 'music', 'stand', 'near', 'bonfire']",2.75,2,2085,2536,-451,203401
967,"['man', 'chop', 'butter', 'container']","['woman', 'cut', 'shrimp']",0.6000000238418579,0,58,644,-586,343396
968,"['girl', 'drag', 'downhill', 'dog']","['dog', 'pull', 'child', 'hill']",3.799999952316284,1,569,4310,-3741,13995081
969,"['man', 'take', 'sunglass', 'talk']","['man', 'wear', 'hard', 'hat', 'remove', 'glass', 'speak']",3.400000095367432,1,570,3515,-2945,8673025
970,"['man', 'funny', 'skin', 'boxer', 'crowd', 'people']","['boy', 'dance', 'people']",1.5,1,571,1439,-868,753424
971,"['girl', 'tide', 'bed']","['woman', 'make', 'bed']",2.5,1,572,2347,-1775,3150625
972,"['cook', 'onion']","['man', 'swinge', 'nunchuck']",0.0,0,59,153,-94,8836
973,"['man', 'sledghammer', 'break', 'concrete', 'block', 'man']","['man', 'break', 'slab', 'concrete', 'lie', 'prone', 'man', 'sledge', 'hammer']",5.0,3,2742,5707,-2965,8791225
974,"['lady', 'dry', 'nodule', 'hot', 'water', 'cook']","['woman', 'place', 'container', 'nodule', 'pan', 'water']",4.333000183105469,2,2109,4953,-2844,8088336
975,"['girl', 'dance', 'stage']","['girl', 'put']",0.3330000042915344,1,576,456,120,14400
976,"['bear', 'lay']","['baby', 'relax', 'log']",3.3329999446868896,0,60,3405,-3345,11189025
977,"['kiss', 'play', 'swimming', 'pool', 'green', 'color', 'crocodile', 'float']","['kiss', 'push', 'inflammable', 'crocodile', 'pool']",4.199999809265137,3,2745,4785,-2040,4161600
978,"['couple', 'policewoman', 'singe', 'karaoke']","['woman', 'dance']",0.800000011920929,0,83,809,-726,527076
979,"['man', 'put', 'broccoli', 'water']","['person', 'peel', 'potato']",1.0,0,167,1075,-908,824464
980,"['doctor', 'help', 'patient']","['doctor', 'try', 'revive', 'man']",2.799999952316284,1,579,2576,-1997,3988009
981,"['grate', 'onion', 'water']","['person', 'rate', 'potato', 'bowl']",1.5,0,168,1427,-1259,1585081
982,"['baby', 'talk']","['boy', 'try', 'firetruck']",1.2000000476837158,0,169,1178,-1009,1018081
983,"['woman', 'boil', 'egg']","['woman', 'place', 'egg', 'pot', 'water']",3.0,2,2120,2998,-878,770884
984,"['woman', 'put', 'ingredient', 'whiskey', 'egg']","['man', 'hour', 'gasoline']",0.0,0,275,152,123,15129
985,"['woman', 'slide', 'mange']","['man', 'put', 'cheese', 'gorilla']",0.6000000238418579,0,276,658,-382,145924
986,"['girl', 'slide', 'butter', 'piece']","['woman', 'slide']",1.0,1,582,1080,-498,248004
987,"['man', 'play', 'guitar']","['person', 'slide', 'meat', 'piece']",0.0,0,277,151,126,15876
988,"['man', 'open', 'package', 'contain', 'headphone']","['woman', 'ride', 'horse']",0.0,0,278,150,128,16384
989,"['girl', 'play', 'guitar']","['boy', 'play', 'key', 'board', 'people']",1.0,1,584,1082,-498,248004
990,"['little', 'girl', 'play', 'violin', 'beach']","['girl', 'sit', 'couch', 'rocket']",0.0,1,585,149,436,190096
991,"['monkey', 'rate', 'kicking', 'gloved', 'hand']","['monkey', 'practice', 'martial', 'art']",3.5,1,586,3688,-3102,9622404
992,"['female', 'apply', 'hair', 'hand']","['cat', 'eat', 'slice', 'watermelon']",0.0,0,279,148,131,17161
993,"['man', 'rate', 'kicking', 'man', 'wear', 'protective', 'boxing', 'glove']","['man', 'kick', 'box', 'trainer']",2.5,1,588,2340,-1752,3069504
994,"['man', 'play', 'wooden', 'flute']","['little', 'boy', 'vacuum', 'floor']",0.0,0,280,147,133,17689
995,"['young', 'woman', 'play', 'guitar']","['woman', 'cut', 'meat']",0.75,1,589,739,-150,22500
996,"['man', 'play', 'soccer']","['man', 'ride', 'motorcycle']",0.0,1,590,146,444,197136
997,"['woman', 'run', 'beach']","['dog', 'swim', 'pool']",0.0,0,281,145,136,18496
998,"['man', 'strain', 'past']","['man', 'play', 'wooden', 'flute']",0.0,1,575,144,431,185761
999,"['play', 'swing']","['man', 'play', 'guitar']",0.800000011920929,1,559,806,-247,61009
1000,"['green', 'white', 'train', 'sit', 'track']","['green', 'white', 'train', 'track']",4.400000095367432,4,4084,5006,-922,850084
1001,"['small', 'white', 'cat', 'glow', 'eye', 'stand', 'underneath', 'chair']","['white', 'cat', 'stand', 'floor']",2.5999999046325684,3,2751,2390,361,130321
1002,"['large', 'boat', 'water', 'marina']","['large', 'boat', 'sea']",3.200000047683716,2,2091,3110,-1019,1038361
1003,"['bus', 'drive', 'street']","['red', 'double', 'hecker', 'bus', 'drive', 'street']",4.0,3,2763,4529,-1766,3118756
1004,"['passenger', 'train', 'wait', 'station']","['passenger', 'train', 'sit', 'station']",4.800000190734863,3,2721,5464,-2743,7524049
1005,"['woman', 'dinner', 'table', 'write', 'notebook']","['woman', 'table', 'busy']",3.400000095367432,2,2318,3663,-1345,1809025
1006,"['apple', 'computer', 'sit', 'floor']","['farintosh', 'computer', 'sit', 'floor']",3.799999952316284,3,2731,4250,-1519,2307361
1007,"['close', 'brown', 'horse', 'head']","['view', 'horse', 'head']",3.400000095367432,2,2333,3573,-1240,1537600
1008,"['group', 'people', 'eat', 'table', 'outside']","['group', 'elderly', 'people', 'sit', 'table']",2.799999952316284,3,2737,2574,163,26569
1009,"['jockey', 'ride', 'horse']","['jockey', 'ride', 'horse', 'pen']",3.799999952316284,3,2768,4263,-1495,2235025
1010,"['man', 'ride', 'motorcycle', 'road']","['man', 'ride', 'red', 'motorcycle', 'road']",4.0,4,4157,4592,-435,189225
1011,"['woman', 'ride', 'brown', 'horse']","['young', 'girl', 'ride', 'brown', 'horse']",3.799999952316284,3,2801,4320,-1519,2307361
1012,"['kid', 'jump', 'ledge', 'bike']","['black', 'white', 'cat', 'play', 'blanket']",0.0,0,284,140,144,20736
1013,"['black', 'dog', 'stand', 'yellow', 'flower']","['black', 'dog', 'stand', 'field']",3.0,3,2805,3051,-246,60516
1014,"['close', 'bottle', 'water']","['close', 'view', 'bottle', 'water']",4.400000095367432,3,2822,4969,-2147,4609609
1015,"['close', 'brown', 'face', 'cat']","['close', 'ostrich', 'face']",0.6000000238418579,2,2309,656,1653,2732409
1016,"['sheep', 'stand', 'afield']","['sheep', 'grazing', 'field']",3.200000047683716,1,533,3097,-2564,6574096
1017,"['long', 'haired', 'cat', 'eye', 'close']","['close', 'cat', 'eye', 'close']",3.5999999046325684,3,2773,3897,-1124,1263376
1018,"['woman', 'gray', 'shirt', 'smile', 'camera', 'woman', 'make', 'face']","['woman', 'surprised', 'look', 'face', 'hold', 'smile', 'woman']",2.5999999046325684,3,2776,2411,365,133225
1019,"['silver', 'blue', 'amtrak', 'train', 'track', 'near', 'small', 'train', 'station']","['small', 'white', 'car', 'mark', 'gas', 'station']",0.6000000238418579,2,2375,633,1742,3034564
1020,"['person', 'blue', 'shirt', 'decline', 'near', 'coffee', 'table', 'television']","['person', 'stand', 'motorcycle', 'seat', 'pip', 'wheel']",0.0,1,1244,139,1105,1221025
1021,"['black', 'white', 'photo', 'woman', 'show', 'horse']","['black', 'white', 'photo', 'cow', 'stall']",1.399999976158142,3,2779,1401,1378,1898884
1022,"['dark', 'brown', 'horse', 'stand', 'field']","['brown', 'horse', 'stand', 'lush', 'green', 'field']",4.199999809265137,4,4133,4715,-582,338724
1023,"['pitch', 'tent', 'horse', 'background']","['black', 'white', 'lamb', 'lamb', 'background']",0.0,1,538,137,401,160801
1024,"['group', 'people', 'sit', 'table', 'food']","['group', 'people', 'sit', 'table', 'food', 'beer']",4.0,5,4852,4591,261,68121
1025,"['brown', 'horse', 'stand', 'lush', 'green', 'field']","['brown', 'horse', 'green', 'field']",3.799999952316284,4,4136,4306,-170,28900
1026,"['black', 'white', 'cow', 'hay']","['black', 'white', 'cow', 'pen', 'hay']",4.0,4,4137,4585,-448,200704
1027,"['elderly', 'woman', 'stand', 'kitchen', 'cat', 'foot']","['old', 'lady', 'stand', 'kitchen', 'cat', 'foot']",5.0,4,4144,5705,-1561,2436721
1028,"['school', 'bus', 'drive', 'uphill', 'rural', 'road']","['race', 'care', 'drive', 'dirt', 'road']",1.0,2,2349,920,1429,2042041
1029,"['camouflage', 'airplane', 'sit', 'grassy', 'field']","['camouflaged', 'plane', 'sit', 'green', 'grass']",4.400000095367432,1,542,4997,-4455,19847025
1030,"['young', 'woman', 'stand', 'room']","['indian', 'woman', 'indian', 'girl', 'near', 'water']",0.4000000059604645,1,557,556,1,1
1031,"['red', 'double', 'hecker', 'bus', 'drive', 'street']","['double', 'hecker', 'passenger', 'bus', 'drive', 'traffic']",4.0,4,4147,4625,-478,228484
1032,"['white', 'sheep', 'hillside', 'look', 'camera']","['skinny', 'cow', 'stand', 'grass']",1.2000000476837158,0,286,1172,-886,784996
1033,"['group', 'sheep', 'field']","['group', 'horse', 'graze', 'field']",1.600000023841858,2,2293,1539,754,568516
1034,"['close', 'distorted', 'photo', 'glass', 'joke', 'bottle']","['close', 'picture', 'desk', 'computer', 'paper']",0.0,1,545,198,347,120409
1035,"['crowded', 'office', 'desk', 'computer', 'monitor']","['computer', 'desk', 'monitor']",3.0,3,2658,3027,-369,136161
1036,"['man', 'sit', 'fluttered', 'room']","['man', 'lie', 'bed', 'fluttered', 'room']",3.200000047683716,3,2671,3104,-433,187489
1037,"['white', 'cow', 'green', 'pasture']","['horse', 'pasture']",1.399999976158142,1,546,1297,-751,564001
1038,"['black', 'cow', 'walk', 'tree', 'pasture']","['walk', 'tree', 'pasture']",3.799999952316284,3,2696,4265,-1569,2461761
1039,"['people', 'sit', 'table', 'restaurant']","['people', 'sit', 'table']",1.7999999523162842,3,2708,1718,990,980100
1040,"['smile', 'woman', 'beer', 'sit', 'outside', 'smile', 'woman']","['woman', 'sit', 'outside', 'laugh']",3.200000047683716,3,2684,3099,-415,172225
1041,"['bird', 'hold', 'metal', 'gate']","['multi', 'colored', 'bird', 'cling', 'wire', 'fence']",3.200000047683716,1,549,3089,-2540,6451600
1042,"['skinny', 'cow', 'stand', 'grass']","['white', 'duck', 'stand', 'ground']",0.6000000238418579,1,550,630,-80,6400
1043,"['woman', 'lay', 'man', 'sit', 'sofa']","['man', 'woman', 'smile', 'camera', 'sit', 'blue', 'sofa']",2.200000047683716,4,4005,2031,1974,3896676
1044,"['woman', 'big', 'necklace']","['young', 'woman', 'black', 'necklace']",3.400000095367432,2,2278,3581,-1303,1697809
1045,"['grown', 'cow', 'horn', 'stand', 'field']","['grown', 'horse', 'stand', 'middle', 'grassy', 'field']",1.7999999523162842,3,2651,1720,931,866761
1046,"['cruise', 'line', 'lock', 'shoreline']","['cruise', 'ship', 'lock', 'shore']",4.400000095367432,2,2292,4983,-2691,7241481
1047,"['black', 'white', 'cat', 'lie', 'bush']","['black', 'white', 'cat', 'yellow', 'eye', 'lounge', 'dirt']",2.400000095367432,3,2690,2249,441,194481
1048,"['grown', 'white', 'cow', 'stand', 'grass', 'road']","['brown', 'white', 'cow', 'stand', 'grassy', 'area', 'tree']",3.5999999046325684,3,2707,3937,-1230,1512900
1049,"['small', 'dog', 'look', 'camera', 'stand', 'grass']","['man', 'woman', 'smile', 'camera', 'stand', 'kitchen']",0.800000011920929,2,2261,824,1437,2064969
1050,"['calf', 'yellow', 'tag', 'left', 'ear', 'look', 'camera']","['man', 'glass', 'plastic', 'bottle', 'foreground']",0.6000000238418579,0,289,626,-337,113569
1051,"['black', 'white', 'photo', 'couch', 'purse', 'end']","['black', 'white', 'photo', 'cow', 'tree']",0.0,3,2700,195,2505,6275025
1052,"['man', 'boat', 'float', 'water']","['large', 'green', 'boat', 'float']",2.400000095367432,2,2265,2255,10,100
1053,"['rear', 'view', 'chevrolet', 'sport', 'car']","['rear', 'view', 'red', 'chevrolet', 'concept', 'car']",3.5999999046325684,4,3970,3946,24,576
1054,"['person', 'wear', 'helmet', 'ride', 'bike', 'near', 'white', 'structure']","['person', 'wear', 'bike', 'helmet', 'ride', 'bike', 'path', 'tree']",3.200000047683716,5,4869,3100,1769,3129361
1055,"['black', 'white', 'photo', 'old', 'train', 'station']","['black', 'white', 'photo', 'motorcycle', 'lay', 'ground']",0.2000000029802322,3,2711,412,2299,5285401
1056,"['grey', 'white', 'cabby', 'cat', 'sleep', 'purple', 'fabric']","['black', 'white', 'cat', 'sleep', 'brown', 'trap']",2.400000095367432,3,3156,2237,919,844561
1057,"['woman', 'hold', 'small', 'baby']","['smile', 'woman', 'hold', 'small', 'baby']",4.0,4,3974,4527,-553,305809
1058,"['group', 'horse', 'graze', 'grassy', 'field']","['group', 'horse', 'graze', 'field']",4.599999904632568,4,3978,5193,-1215,1476225
1059,"['man', 'sit', 'table', 'drink']","['man', 'sit', 'table', 'beer', 'food']",3.400000095367432,3,2825,3630,-805,648025
1060,"['people', 'dress', 'white', 'standing', 'grass', 'field']","['person', 'stand', 'underneath', 'overcast', 'near', 'highway']",0.4000000059604645,0,290,550,-260,67600
1061,"['orange', 'cabby', 'cat', 'sleep', 'sofa']","['man', 'watch', 'foot', 'bed']",0.6000000238418579,0,291,631,-340,115600
1062,"['eagles', 'perch', 'branch']","['bald', 'eagle', 'perch', 'branch']",3.799999952316284,2,2266,4258,-1992,3968064
1063,"['striped', 'cat', 'lay', 'bag', 'cat', 'litter']","['domestic', 'cat', 'lay', 'cat', 'litter']",3.799999952316284,3,3079,4277,-1198,1435204
1064,"['man', 'small', 'child', 'living', 'room', 'lose', 'camera']","['man', 'woman', 'lose', 'camera']",2.400000095367432,3,3076,2296,780,608400
1065,"['home', 'office', 'computer', 'monitor', 'equipment', 'desk']","['room', 'computer', 'monitor']",3.0,2,2258,2980,-722,521284
1066,"['bird', 'stand', 'snow']","['cardinal', 'stand', 'snow']",3.799999952316284,2,2257,4315,-2058,4235364
1067,"['black', 'vehicle', 'mark', 'view', 'low', 'lie', 'mountain']","['black', 'car', 'mark', 'dirt', 'country']",2.5999999046325684,2,2256,2415,-159,25281
1068,"['passenger', 'train', 'snow']","['passenger', 'train', 'wait', 'station']",2.200000047683716,2,2271,1999,272,73984
1069,"['black', 'bird', 'sit', 'ground']","['blackbird', 'sit', 'ground']",5.0,2,2274,5726,-3452,11916304
1070,"['black', 'white', 'bull', 'look', 'camera']","['black', 'white', 'dog', 'look', 'camera']",2.0,4,4052,1913,2139,4575321
1071,"['young', 'girl', 'ride', 'white', 'grey', 'horse']","['young', 'blonde', 'girl', 'ride', 'gear', 'sit', 'gray', 'white', 'horse']",3.799999952316284,5,5008,4316,692,478864
1072,"['black', 'white', 'sheep', 'walk', 'white', 'sheep']","['little', 'black', 'white', 'calf', 'tag', 'ear']",0.800000011920929,2,2287,816,1471,2163841
1073,"['living', 'room', 'dining', 'table', 'background']","['boy', 'wheel', 'plank', 'beach', 'background']",0.0,1,630,191,439,192721
1074,"['dining', 'room', 'table', 'get', 'afternoon', 'sun']","['dining', 'room', 'wooden', 'dining', 'table', 'set', 'playmate']",2.200000047683716,3,3069,2122,947,896809
1075,"['red', 'move', 'mark', 'sidewalk', 'graffiti']","['red', 'soon', 'sit', 'street', 'building']",3.5999999046325684,1,632,3967,-3335,11122225
1076,"['seagull', 'float', 'water']","['little', 'bird', 'float', 'water']",3.5999999046325684,2,2279,3968,-1689,2852721
1077,"['black', 'dog', 'stand', 'material', 'construction', 'site']","['sign', 'toller', 'girl', 'sit', 'pot', 'flower', 'marble', 'post']",0.0,0,274,188,86,7396
1078,"['woman', 'lose', 'apartment', 'building', 'snow']","['woman', 'stand', 'building', 'snow']",4.400000095367432,3,3066,5117,-2051,4206601
1079,"['cow', 'graze', 'road']","['sheep', 'grazing', 'field']",1.0,0,292,979,-687,471969
1080,"['mountain', 'goat', 'graze', 'aline', 'lake']","['animal', 'graze', 'mountain', 'body', 'water']",3.200000047683716,2,2276,3194,-918,842724
1081,"['black', 'white', 'cow', 'fence']","['black', 'white', 'cow', 'metal', 'gate', 'partly', 'cloudy', 'blue', 'sky']",3.200000047683716,3,3064,3211,-147,21609
1082,"['passenger', 'train', 'wait', 'station']","['passenger', 'train', 'wait', 'city', 'train', 'station']",4.0,4,4045,4377,-332,110224
1083,"['white', 'animal', 'run', 'snow', 'cover', 'wood']","['white', 'dog', 'run', 'snow', 'cover', 'wood']",3.400000095367432,5,4972,3437,1535,2356225
1084,"['man', 'sit', 'grass', 'look', 'sky']","['train', 'ride', 'track', 'snow']",0.0,0,271,187,84,7056
1085,"['black', 'flat', 'screen', 'television', 'place', 'floor']","['flat', 'screen', 'floor']",4.0,3,3063,4390,-1327,1760929
1086,"['silver', 'bicycle', 'mark', 'living', 'room']","['bicycle', 'dining', 'room']",2.400000095367432,2,2228,2270,-42,1764
1087,"['black', 'train', 'train', 'track']","['train', 'train', 'track']",4.099999904632568,2,2227,4701,-2474,6120676
1088,"['black', 'train', 'train', 'track']","['train', 'train', 'track']",4.099999904632568,2,2223,4702,-2479,6145441
1089,"['orange', 'cabby', 'cat', 'sleep', 'sofa']","['wear', 'big', 'sitting', 'green', 'couch']",0.0,0,254,185,69,4761
1090,"['bald', 'eagle', 'perch', 'rope']","['bald', 'eagle', 'perch', 'branch']",2.5999999046325684,3,3096,2419,677,458329
1091,"['couple', 'lose', 'picture', 'couch']","['young', 'couple', 'sit', 'couch']",4.0,2,2221,4485,-2264,5125696
1092,"['man', 'play', 'guitar', 'have', 'drink']","['young', 'boy', 'red', 'blue', 'jacket', 'feed', 'sheep']",0.0,0,255,183,72,5184
1093,"['cat', 'sit', 'sofa', 'look', 'window']","['cat', 'look', 'window']",3.799999952316284,3,3103,4297,-1194,1425636
1094,"['red', 'double', 'hecker', 'bus']","['red', 'double', 'hecker', 'bus', 'hood']",3.75,4,4038,4040,-2,4
1095,"['close', 'animal', 'long', 'face', 'stand', 'grass', 'near', 'tree']","['close', 'woman', 'black', 'boot', 'blue', 'motorcycle']",0.0,1,640,181,459,210681
1096,"['brown', 'white', 'dog', 'sit', 'flora', 'patter', 'chair']","['small', 'orange', 'white', 'dog', 'collar', 'bell', 'relax', 'flower', 'print', 'pillow']",1.7999999523162842,2,2212,1693,519,269361
1097,"['group', 'people', 'sit', 'restaurant', 'table']","['group', 'people', 'sit', 'table', 'food']",4.199999809265137,4,4076,4787,-711,505521
1098,"['sheep', 'cliff', 'look', 'camera']","['sheep', 'stand', 'look', 'camera', 'face', 'opposite', 'direction']",2.0,3,3101,1933,1168,1364224
1099,"['black', 'white', 'photo', 'train', 'station']","['black', 'white', 'photo', 'cat', 'lie']",1.600000023841858,3,3098,1585,1513,2289169
1100,"['row', 'locomotive', 'riding', 'field']","['dark', 'brown', 'horse', 'stand', 'field']",1.2000000476837158,1,642,1232,-590,348100
1101,"['white', 'apple', 'computer', 'sit', 'beige', 'carting', 'bedroom']","['apple', 'computer', 'sit', 'floor']",3.5999999046325684,3,3107,3834,-727,528529
1102,"['dog', 'tap', 'small', 'table']","['dog', 'sleep', 'table']",4.599999904632568,2,2244,5250,-3006,9036036
1103,"['boat', 'sail', 'sail', 'water']","['nail', 'boat', 'sail', 'water']",3.5999999046325684,3,3097,3838,-741,549081
1104,"['red', 'sport', 'car', 'race', 'track']","['red', 'sport', 'car', 'drive', 'quickly', 'track']",4.599999904632568,4,4036,5253,-1217,1481089
1105,"['black', 'bird', 'sit', 'concrete', 'slab']","['small', 'dog', 'sit', 'white', 'wall']",0.800000011920929,1,645,764,-119,14161
1106,"['victory', 'miner', 'bus', 'white', 'red', 'gold', 'stripe']","['white', 'tour', 'bus', 'red', 'orange', 'yellow', 'stripe']",3.200000047683716,4,4034,3127,907,822649
1107,"['red', 'double', 'hecker', 'bus', 'street']","['red', 'double', 'hecker', 'bus', 'city', 'street']",4.400000095367432,5,4951,5113,-162,26244
1108,"['group', 'river', 'barge', 'tree', 'background']","['young', 'girl', 'wear', 'bike', 'helmet', 'bicycle', 'background']",0.4000000059604645,1,658,578,80,6400
1109,"['seagull', 'float', 'water']","['large', 'cruise', 'ship', 'float', 'water']",1.2000000476837158,2,2236,1239,997,994009
1110,"['motorcycle', 'mark', 'car']","['bmw', 'motorcycle', 'mark', 'car']",3.0,3,3088,3025,63,3969
1111,"['gray', 'cat', 'look', 'window']","['cat', 'look', 'window']",4.0,3,3087,4452,-1365,1863225
1112,"['black', 'white', 'photo', 'cow', 'tree']","['black', 'white', 'photo', 'cow', 'walk', 'tree', 'field']",4.199999809265137,5,4994,4903,91,8281
1113,"['post', 'plant', 'sunlight', 'window']","['post', 'plant', 'sprouting']",2.799999952316284,2,2351,2645,-294,86436
1114,"['people', 'row', 'boat', 'near', 'shore']","['people', 'boat', 'green', 'water']",2.799999952316284,2,2350,2642,-292,85264
1115,"['girl', 'red', 'shirt', 'ride', 'brown', 'horse']","['white', 'dog', 'lay', 'bed', 'yellow', 'coverlet']",0.0,0,256,175,81,6561
1116,"['small', 'desk', 'chair', 'sundry', 'room']","['room', 'wall', 'washed', 'dwyer']",1.399999976158142,1,657,1352,-695,483025
1117,"['amtrak', 'passenger', 'train', 'wait', 'station']","['passenger', 'train', 'wait', 'station']",4.0,4,4020,4506,-486,236196
1118,"['large', 'jet', 'ground', 'airport']","['passenger', 'jet', 'fly', 'air']",1.7999999523162842,1,656,1688,-1032,1065024
1119,"['young', 'girl', 'wear', 'helmet', 'ride', 'pony']","['girl', 'wear', 'red', 'louse', 'ride', 'brown', 'horse']",2.0,3,3030,1799,1231,1515361
1120,"['people', 'sit', 'porch']","['people', 'sit', 'couch']",1.399999976158142,2,2343,1374,969,938961
1121,"['horse', 'stand', 'pen']","['group', 'horse', 'graze', 'field']",1.600000023841858,1,654,1464,-810,656100
1122,"['red', 'train', 'yellow', 'train', 'track']","['train', 'travel', 'track']",3.400000095367432,2,2340,3631,-1291,1666681
1123,"['people', 'sit', 'table', 'restaurant']","['group', 'people', 'sit', 'table', 'porch']",1.0,3,3025,952,2073,4297329
1124,"['lamb', 'stand', 'near', 'tiny', 'animal']","['sheep', 'stand', 'near', 'child']",1.399999976158142,2,2358,1373,985,970225
1125,"['person', 'ride', 'dirt', 'bike', 'outdoor']","['person', 'jump', 'motorbike', 'air']",2.200000047683716,1,660,2128,-1468,2155024
1126,"['cow', 'ear', 'tag', 'grassy', 'field']","['sheep', 'stand', 'green', 'hill']",0.2000000029802322,0,257,389,-132,17424
1127,"['nail', 'boat', 'sail', 'water']","['nail', 'boat', 'float', 'blue', 'water']",4.199999809265137,3,3020,4829,-1809,3272481
1128,"['woman', 'like', 'hat']","['smile', 'woman', 'sit', 'wear', 'like', 'hat']",4.199999809265137,3,3019,4796,-1777,3157729
1129,"['mark', 'white', 'double', 'hecker', 'bus']","['red', 'white', 'double', 'hecker', 'bus', 'mark']",4.199999809265137,5,4982,4806,176,30976
1130,"['field', 'black', 'faced', 'sheep']","['black', 'faced', 'sheep']",2.799999952316284,3,3018,2585,433,187489
1131,"['bird', 'perch', 'metal', 'band']","['small', 'bird', 'perch', 'metal', 'bar']",4.0,3,3016,4392,-1376,1893376
1132,"['table', 'blue', 'table', 'cloth', 'kitchen']","['wooden', 'cabinet', 'kitchen']",1.600000023841858,1,650,1503,-853,727609
1133,"['young', 'woman', 'bracelet', 'wear', 'like', 'jean']","['woman', 'wear', 'like', 'jean']",4.0,4,4057,4670,-613,375769
1134,"['brown', 'horse', 'grazing', 'field', 'green', 'grass']","['grown', 'horse', 'stand', 'middle', 'grassy', 'field']",4.0,2,2368,4645,-2277,5184729
1135,"['pot', 'liquid', 'center', 'trefoil', 'cover', 'plate']","['pot', 'food', 'place', 'center', 'red', 'tablecloth']",1.399999976158142,2,2365,1330,1035,1071225
1136,"['black', 'white', 'cow', 'stand', 'grassy', 'field']","['blue', 'jay', 'stand', 'grassy', 'field']",0.6000000238418579,3,3057,653,2404,5779216
1137,"['yellow', 'blue', 'airplane', 'fly', 'sky']","['white', 'airplane', 'fly', 'blue', 'sky']",3.200000047683716,4,4051,3170,881,776161
1138,"['woman', 'sit', 'chair', 'christmas', 'holding']","['train', 'sit', 'track', 'train', 'yard']",0.0,1,647,172,475,225625
1139,"['sign', 'young', 'people', 'sit', 'den', 'living', 'room']","['girl', 'sit', 'living', 'chair']",0.800000011920929,2,2360,771,1589,2524921
1140,"['brain', 'go', 'track']","['brain', 'glide', 'track']",4.599999904632568,2,2359,5266,-2907,8450649
1141,"['young', 'woman', 'dress', 'black']","['young', 'kiss', 'dress', 'sit', 'chair']",0.2000000029802322,2,2337,427,1910,3648100
1142,"['group', 'people', 'sit', 'table', 'drink']","['people', 'sit', 'table']",3.0,3,3052,2897,155,24025
1143,"['plane', 'fly', 'distance']","['woman', 'white', 'horse']",0.0,0,258,171,87,7569
1144,"['group', 'river', 'barge', 'tree', 'background']","['group', 'cow', 'field', 'yellow', 'tag', 'ear']",0.2000000029802322,1,627,411,216,46656
1145,"['living', 'room', 'dining', 'table', 'background']","['living', 'room', 'large', 'sofas', 'dining', 'table', 'background']",3.5999999046325684,5,4969,3884,1085,1177225
1146,"['fellow', 'stripe', 'cat', 'rest', 'blue', 'sofa']","['orange', 'cabby', 'cat', 'sleep', 'sofa']",4.0,2,2307,4662,-2355,5546025
1147,"['passenger', 'train', 'come', 'station']","['large', 'bird', 'fly', 'air']",0.0,0,260,271,-11,121
1148,"['people', 'waddle', 'red', 'canoe', 'tree', 'background']","['people', 'add', 'yellow', 'canoe', 'river', 'tree', 'background']",3.400000095367432,4,4016,3608,408,166464
1149,"['black', 'train', 'move', 'track']","['black', 'train', 'idle', 'track']",2.200000047683716,3,3050,2133,917,840889
1150,"['white', 'deep', 'mark', 'store']","['white', 'deep', 'mark', 'street']",3.5,3,3049,3706,-657,431649
1151,"['woman', 'stand', 'tour', 'bus']","['man', 'talk', 'plane']",0.4000000059604645,0,261,501,-240,57600
1152,"['man', 'ride', 'large', 'black', 'motorbike']","['child', 'sit', 'large', 'black', 'leather', 'chair']",0.0,2,2304,170,2134,4553956
1153,"['bicycle', 'mark', 'outside', 'bookstore']","['people', 'stand', 'outside', 'bookstore']",0.800000011920929,2,2303,769,1534,2353156
1154,"['lane', 'mid', 'flight', 'sunset']","['plane', 'fly', 'near', 'sunset']",3.799999952316284,1,596,4249,-3653,13344409
1155,"['red', 'bush', 'mark', 'garden']","['red', 'bush', 'mark', 'large', 'white', 'building', 'formal', 'garden']",3.400000095367432,4,3981,3594,387,149769
1156,"['yellow', 'parrot', 'cling', 'cage']","['yellow', 'orange', 'bird', 'hold', 'cage']",3.400000095367432,2,2302,3585,-1283,1646089
1157,"['couple', 'sailing', 'small', 'sailboat']","['man', 'sail', 'small', 'sailboat']",3.0,2,2298,2914,-616,379456
1158,"['silver', 'blue', 'motorcycle', 'sit', 'car']","['motorcycle', 'mark', 'car']",3.5999999046325684,2,2297,3867,-1570,2464900
1159,"['red', 'double', 'hecker', 'bus']","['red', 'double', 'hecker', 'bus']",5.0,4,3976,5703,-1727,2982529
1160,"['foot', 'stand', 'pretty', 'day', 'large', 'building', 'background']","['police', 'officer', 'stand', 'van', 'bus', 'background']",0.4000000059604645,2,2296,504,1792,3211264
1161,"['small', 'white', 'dog', 'chess', 'twig', 'lie', 'wooden', 'deck']","['white', 'dog', 'lay', 'wooden', 'floor', 'underneath', 'table']",1.600000023841858,3,3039,1505,1534,2353156
1162,"['standing', 'silver', 'train']","['standing', 'silver', 'rail', 'car']",4.400000095367432,2,2328,5007,-2679,7177041
1163,"['close', 'sheep', 'tongue', 'hang']","['close', 'image', 'sheep', 'tongue', 'hang']",5.0,4,3990,5690,-1700,2890000
1164,"['black', 'white', 'horn', 'cow', 'stand', 'field']","['black', 'white', 'cow', 'stand', 'field']",4.199999809265137,5,5004,4880,124,15376
1165,"['man', 'ride', 'white', 'horse', 'arena']","['man', 'ride', 'white', 'horse']",4.0,4,3991,4594,-603,363609
1166,"['train', 'sit', 'track', 'near', 'field']","['train', 'travel', 'track']",2.200000047683716,2,2320,2043,277,76729
1167,"['woman', 'small', 'child', 'sit', 'dinner', 'table', 'smile', 'camera']","['small', 'cat', 'lay', 'wooden', 'beam', 'look', 'camera']",0.4000000059604645,2,2319,502,1817,3301489
1168,"['buddha', 'statue', 'sit', 'table', 'wooden', 'table', 'runner']","['bird', 'stand', 'wooden', 'fencepost']",0.4000000059604645,1,602,473,129,16641
1169,"['red', 'bush', 'drive', 'garden']","['brain', 'pull', 'station']",0.0,0,262,174,88,7744
1170,"['row', 'grazing', 'snow', 'cover', 'field']","['cow', 'grazing', 'snow', 'cover', 'field']",3.799999952316284,4,4014,4102,-88,7744
1171,"['man', 'ride', 'white', 'horse']","['woman', 'ride', 'brown', 'horse']",1.7999999523162842,2,2209,1769,440,193600
1172,"['blue', 'shirt', 'stand', 'fountain']","['man', 'blue', 'shirt', 'part', 'stand', 'statue', 'man', 'gobble', 'stone', 'pave', 'place']",3.200000047683716,3,3179,3280,-101,10201
1173,"['girl', 'ride', 'gear', 'sit', 'stop', 'brown', 'horse']","['girl', 'red', 'shirt', 'ride', 'brown', 'horse']",4.0,4,3998,4578,-580,336400
1174,"['clear', 'plastic', 'chair', 'bookcase']","['clear', 'plastic', 'chair', 'book', 'shelf']",4.199999809265137,3,3192,4904,-1712,2930944
1175,"['dog', 'wear', 'gray', 'jacket']","['dog', 'lay', 'pet', 'jacket']",3.0,2,2088,2822,-734,538756
1176,"['sheep', 'stand', 'hillside']","['large', 'sheep', 'stand', 'hill']",4.0,2,2087,4601,-2514,6320196
1177,"['black', 'white', 'cow', 'stand', 'grassy', 'field']","['black', 'white', 'cow', 'stand', 'field']",3.799999952316284,5,4838,4088,750,562500
1178,"['woman', 'black', 'like', 'jean']","['woman', 'black', 'hat', 'stand', 'subway']",1.0,2,2121,947,1174,1378276
1179,"['girl', 'ride', 'brown', 'horse']","['jockey', 'wear', 'purple', 'ride', 'brown', 'horse']",2.200000047683716,3,3188,2065,1123,1261129
1180,"['standing', 'yellow', 'coquette']","['man', 'stand', 'yellow', 'sport', 'car']",3.200000047683716,1,608,3217,-2609,6806881
1181,"['man', 'sit', 'grass', 'look', 'sky']","['man', 'stand', 'sidewalk', 'horse']",0.0,1,610,177,433,187489
1182,"['man', 'pose', 'large', 'fountain', 'statue']","['blue', 'shirt', 'stand', 'fountain']",2.799999952316284,1,625,2611,-1986,3944196
1183,"['white', 'cat', 'stand', 'carpet']","['sheep', 'stand', 'forest']",0.4000000059604645,1,611,577,34,1156
1184,"['flat', 'screen', 'floor']","['flat', 'screen', 'sit', 'floor']",5.0,3,3184,5670,-2486,6180196
1185,"['brown', 'horse', 'stand', 'grassy', 'field']","['man', 'sail', 'small', 'sailboat']",0.0,0,263,178,85,7225
1186,"['sheep', 'stand', 'doorway']","['ram', 'stand', 'snowy', 'ground']",1.399999976158142,1,612,1283,-671,450241
1187,"['room', 'computer', 'monitor']","['room', 'computer', 'monitor', 'row']",4.0,3,3183,4528,-1345,1809025
1188,"['line', 'outside', 'bookstore', 'street']","['yellow', 'motorcycle', 'mark', 'street']",0.4000000059604645,1,954,573,381,145161
1189,"['passenger', 'jet', 'sit', 'runaway']","['large', 'passenger', 'jet', 'fly', 'close', 'ground']",1.7999999523162842,2,2084,1646,438,191844
1190,"['old', 'green', 'bottle', 'sit', 'table']","['man', 'suit', 'sit', 'table']",0.4000000059604645,2,2052,584,1468,2155024
1191,"['white', 'horse', 'stare', 'fence']","['horse', 'stand', 'pen']",3.0,1,613,2803,-2190,4796100
1192,"['black', 'white', 'cow', 'pause', 'gate']","['white', 'airplane', 'fly', 'sky']",0.0,1,614,179,435,189225
1193,"['black', 'white', 'cow', 'stand', 'grassy', 'field']","['black', 'white', 'horn', 'cow', 'stand', 'field']",4.0,5,4942,4692,250,62500
1194,"['black', 'white', 'photo', 'cat', 'lie']","['black', 'white', 'image', 'cat', 'lay', 'rug']",4.199999809265137,3,3121,4841,-1720,2958400
1195,"['man', 'woman', 'stand', 'smile', 'camera']","['man', 'woman', 'lose', 'camera']",4.199999809265137,3,3119,4845,-1726,2979076
1196,"['orange', 'white', 'cat', 'asleep', 'leather', 'chair']","['ginger', 'cat', 'sit', 'office', 'chair']",3.0,2,2076,3049,-973,946729
1197,"['white', 'cat', 'stand', 'carpet']","['pretty', 'white', 'stripe', 'cat', 'head', 'hang', 'table']",1.600000023841858,2,2075,1581,494,244036
1198,"['grey', 'white', 'domestic', 'kitten', 'lie', 'desk']","['man', 'bicycle', 'lay', 'green', 'grass']",0.2000000029802322,0,265,386,-121,14641
1199,"['woman', 'lose', 'apartment', 'building', 'snow']","['white', 'bus', 'mark', 'grass', 'building']",0.0,1,616,186,430,184900
1200,"['young', 'woman', 'bracelet', 'wear', 'like', 'jean']","['woman', 'wear', 'jean', 'dark', 'like', 'bracelet']",4.599999904632568,5,4892,5234,-342,116964
1201,"['table', 'chair', 'room', 'picture', 'wall', 'ceiling', 'fan']","['school', 'bus', 'drive', 'road', 'green', 'tree', 'grass', 'background']",0.0,0,267,189,78,6084
1202,"['man', 'sit', 'cross', 'legge', 'bed', 'watch', 'small']","['man', 'sit', 'bed', 'close', 'small', 'television']",3.400000095367432,4,4172,3431,741,549081
1203,"['headlight', 'blue', 'car']","['close', 'headlight', 'blue', 'car']",4.199999809265137,3,3117,4847,-1730,2992900
1204,"['passenger', 'train', 'come', 'station']","['passenger', 'train', 'sit', 'station']",2.400000095367432,3,3115,2212,903,815409
1205,"['airplane', 'face', 'camera']","['lone', 'cow', 'sit', 'cold', 'yard']",0.0,0,268,194,74,5476
1206,"['woman', 'ride', 'brown', 'horse']","['person', 'dress', 'white', 'brown', 'horse']",3.200000047683716,2,2068,3232,-1164,1354896
1207,"['jockey', 'ride', 'horse']","['jockey', 'ride', 'horse', 'pen']",3.799999952316284,3,3134,4074,-940,883600
1208,"['dog', 'blend', 'stuff', 'animal']","['dog', 'sit', 'couch', 'stuff', 'animal']",3.400000095367432,3,3149,3496,-347,120409
1209,"['train', 'run', 'track']","['train', 'run', 'track', 'rural', 'area']",4.0,3,3145,4639,-1494,2232036
1210,"['stand', 'snowy', 'mountain', 'watch', 'plane']","['man', 'stand', 'mountain', 'watch', 'plane']",4.400000095367432,4,4095,5084,-989,978121
1211,"['bird', 'flap', 'wing', 'water']","['large', 'black', 'bird', 'sit', 'water']",3.200000047683716,2,2190,3309,-1119,1252161
1212,"['cruise', 'line', 'lock', 'port']","['cruise', 'ship', 'lock', 'coast']",3.200000047683716,2,2206,3310,-1104,1218816
1213,"['red', 'double', 'hecker', 'bus', 'crowded', 'street']","['white', 'bus', 'partially', 'snow', 'public', 'street']",2.0,2,2201,1885,316,99856
1214,"['woman', 'pet', 'dog', 'fenced', 'area']","['woman', 'pet', 'dog', 'gaze', 'yard']",4.800000190734863,3,2890,5408,-2518,6340324
1215,"['black', 'white', 'cat', 'play', 'blanket']","['black', 'white', 'cat', 'get', 'basket', 'yarn']",2.200000047683716,3,2889,2010,879,772641
1216,"['man', 'mountain', 'bike', 'go', 'incline']","['man', 'ride', 'mountain', 'bike', 'rock', 'clear', 'day']",3.200000047683716,3,2888,3302,-414,171396
1217,"['cat', 'decline', 'office', 'chair']","['ginger', 'cat', 'sit', 'office', 'chair']",3.799999952316284,3,2879,4193,-1314,1726596
1218,"['group', 'horse', 'graze', 'field']","['brown', 'horse', 'grazing', 'field', 'green', 'grass']",2.5999999046325684,2,2128,2480,-352,123904
1219,"['group', 'people', 'have', 'drink']","['row', 'locomotive', 'riding', 'field']",0.0,0,269,196,73,5329
1220,"['dog', 'fence', 'tunnel', 'look', 'ahead']","['woman', 'pose', 'dining', 'room', 'baby']",0.0,0,270,197,73,5329
1221,"['sheep', 'dirt', 'road', 'view', 'passenger', 'vehicle']","['sheep', 'middle', 'gravel', 'road']",3.400000095367432,2,2161,3611,-1450,2102500
1222,"['yellow', 'blue', 'airplane', 'fly', 'sky']","['line', 'red', 'white', 'aircraft', 'fly', 'formation', 'trailing', 'smoke']",1.0,1,427,925,-498,248004
1223,"['train', 'sit', 'train', 'station']","['blue', 'train', 'station']",4.0,2,2156,4372,-2216,4910656
1224,"['train', 'sit', 'track', 'near', 'field']","['baby', 'sit', 'grass']",0.0,1,429,199,230,52900
1225,"['red', 'double', 'hecker', 'bus', 'take', 'passenger']","['red', 'double', 'hecker', 'bus', 'pick', 'passenger', 'city']",4.400000095367432,5,4933,5099,-166,27556
1226,"['gun', 'sit', 'couch', 'hold', 'bee', 'girl', 'lie', 'law']","['woman', 'watch', 'street', 'bite', 'cross']",0.0,0,294,166,128,16384
1227,"['woman', 'kitchen', 'look', 'object']","['woman', 'kitchen', 'take', 'picture']",2.799999952316284,2,2614,2745,-131,17161
1228,"['race', 'horse', 'gallop', 'rider']","['horse', 'gallop', 'wear', 'number']",2.799999952316284,2,2610,2739,-129,16641
1229,"['steam', 'engine', 'train', 'move', 'camera']","['large', 'bird', 'prey', 'fly', 'camera']",0.800000011920929,1,432,800,-368,135424
1230,"['black', 'white', 'photo', 'glass', 'bottle', 'local', 'old']","['black', 'white', 'picture', 'short', 'squat', 'local', 'cold', 'bottle']",4.199999809265137,4,4109,4800,-691,477481
1231,"['small', 'bird', 'perch', 'icy', 'branch']","['yellow', 'bird', 'perch', 'branch']",3.200000047683716,3,2909,3324,-415,172225
1232,"['boy', 'glass', 'tie', 'computer']","['boy', 'look', 'computer', 'screen']",3.200000047683716,2,2605,3313,-708,501264
1233,"['red', 'truck', 'spine', 'tire', 'black', 'leave', 'frame']","['red', 'truck', 'spinning', 'tire', 'emit', 'smoke']",3.200000047683716,3,2902,3312,-410,168100
1234,"['living', 'room', 'table', 'chair', 'sofa', 'alongside', 'large', 'palm']","['living', 'room', 'blue', 'sofa', 'camp', 'bed', 'wooden', 'bench', 'dresser']",2.400000095367432,3,2897,2192,705,497025
1235,"['smile', 'woman', 'hold', 'small', 'baby']","['woman', 'sit', 'sofa', 'hold', 'baby']",3.400000095367432,3,2872,3461,-589,346921
1236,"['gas', 'station', 'tree', 'background']","['police', 'officer', 'stand', 'van', 'bus', 'background']",0.0,1,442,138,304,92416
1237,"['blue', 'yellow', 'plane', 'fly', 'boat']","['blue', 'yellow', 'plane', 'flight']",4.199999809265137,3,2841,4826,-1985,3940225
1238,"['horse', 'stand', 'near', 'gate', 'horse', 'background']","['group', 'river', 'barge', 'tree', 'background']",0.0,1,443,141,302,91204
1239,"['bottle', 'table']","['old', 'green', 'bottle', 'sit', 'table']",2.400000095367432,2,2586,2214,372,138384
1240,"['steam', 'engine', 'come', 'train', 'track', 'near', 'tree']","['train', 'train', 'station']",1.399999976158142,1,445,1382,-937,877969
1241,"['train', 'train', 'station']","['train', 'mark', 'train', 'station']",4.199999809265137,2,2584,4870,-2286,5225796
1242,"['woman', 'sit', 'sofa', 'hold', 'baby']","['bird', 'sit', 'log', 'lake']",0.4000000059604645,1,446,518,-72,5184
1243,"['bird', 'fly', 'water', 'tender']","['bird', 'fly', 'near', 'bird', 'leader']",3.5999999046325684,2,2581,3909,-1328,1763584
1244,"['cow', 'stand', 'large', 'field']","['horse', 'stand', 'field']",1.600000023841858,2,2579,1458,1121,1256641
1245,"['group', 'sheep', 'grazing', 'hill']","['group', 'sheep', 'hill']",4.0,3,2831,4520,-1689,2852721
1246,"['man', 'stand', 'train']","['man', 'stand', 'raise', 'statue']",2.0,2,2580,1793,787,619369
1247,"['woman', 'lose', 'camera', 'give', 'thumb', 'sign']","['smile', 'young', 'woman', 'give', 'thumb', 'sign']",4.400000095367432,4,3855,5056,-1201,1442401
1248,"['woman', 'hold', 'small', 'baby', 'sit', 'sofa']","['woman', 'sit', 'sofa', 'hold', 'baby']",4.800000190734863,5,4849,5424,-575,330625
1249,"['double', 'hecker', 'red', 'united', 'bus', 'city', 'street']","['doubly', 'hecker', 'red', 'bus', 'drive', 'road']",4.0,3,2845,4504,-1659,2752281
1250,"['woman', 'sit', 'brown', 'couch']","['woman', 'stand', 'outside', 'bus']",1.0,1,448,1071,-623,388129
1251,"['grey', 'cat', 'green', 'eye', 'look', 'camera']","['grey', 'black', 'white', 'cat', 'look', 'camera']",3.200000047683716,4,3845,3273,572,327184
1252,"['bird', 'sit', 'branch']","['sheep', 'stand', 'tree']",0.0,0,317,154,163,26569
1253,"['group', 'people', 'sit', 'table', 'restaurant']","['people', 'sit', 'table', 'restaurant']",3.799999952316284,4,3860,4177,-317,100489
1254,"['black', 'white', 'cow', 'stand', 'grass', 'partly', 'cloudy', 'blue', 'sky']","['black', 'white', 'cow', 'metal', 'gate', 'partly', 'cloudy', 'blue', 'sky']",2.400000095367432,7,5328,2200,3128,9784384
1255,"['guy', 'white', 'horse']","['man', 'ride', 'white', 'horse', 'arena']",3.200000047683716,2,2558,3257,-699,488601
1256,"['dairy', 'cow', 'drink', 'pond']","['cow', 'drink', 'pond']",4.599999904632568,3,2855,5242,-2387,5697769
1257,"['share', 'sheep', 'pen']","['white', 'sheep', 'enclosure']",2.400000095367432,1,453,2201,-1748,3055504
1258,"['black', 'dog', 'lie', 'grass']","['black', 'dog', 'lie', 'grass']",5.0,4,3836,5502,-1666,2775556
1259,"['young', 'people', 'sit', 'table', 'slide', 'glass', 'door', 'person', 'point']","['people', 'sit', 'face', 'table', 'point']",4.199999809265137,4,3864,4794,-930,864900
1260,"['man', 'woman', 'hold', 'hand', 'walk', 'beach']","['man', 'beard', 'skullcap', 'boy', 'walk', 'ocean', 'shore']",2.200000047683716,2,2631,2100,531,281961
1261,"['men', 'sheep', 'look', 'camera']","['cat', 'look', 'camera']",1.2000000476837158,2,2628,1121,1507,2271049
1262,"['black', 'white', 'dog', 'look', 'camera']","['small', 'black', 'white', 'goat', 'pen', 'look', 'camera']",1.399999976158142,4,3929,1391,2538,6441444
1263,"['black', 'table', 'white', 'fully', 'chair']","['woman', 'child']",0.0,0,318,165,153,23409
1264,"['red', 'double', 'hecker', 'bus', 'take', 'passenger']","['red', 'double', 'hecker', 'bus', 'drive', 'street']",2.200000047683716,4,3928,2104,1824,3326976
1265,"['nail', 'boat', 'sail', 'water']","['sailboat', 'sailing', 'cloudy', 'day']",3.400000095367432,0,319,3642,-3323,11042329
1266,"['blue', 'bird', 'perch', 'gloved', 'hand', 'person']","['bird', 'perch', 'person', 'gloved', 'hand']",4.199999809265137,5,4882,4873,9,81
1267,"['girl', 'ride', 'brown', 'white', 'horse']","['girl', 'ride', 'brown', 'horse']",3.5999999046325684,4,3921,3905,16,256
1268,"['black', 'train', 'track']","['car', 'mark', 'train', 'track']",1.0,2,2437,1004,1433,2053489
1269,"['young', 'boy', 'color', 'red', 'blue', 'carbon']","['young', 'blonde', 'girl', 'ride', 'gear', 'sit', 'gray', 'white', 'horse']",0.0,1,409,250,159,25281
1270,"['group', 'people', 'living', 'room']","['group', 'people', 'walk', 'past', 'giant', 'mushroom']",0.800000011920929,2,2433,788,1645,2706025
1271,"['millard', 'tame', 'white', 'duck', 'grass', 'near', 'water']","['small', 'child', 'pink', 'dress', 'sit', 'table']",0.0,0,320,253,67,4489
1272,"['cat', 'sit', 'bicycle', 'door']","['horse', 'stand', 'field', 'fence']",0.0,0,321,268,53,2809
1273,"['girl', 'red', 'bag', 'stand', 'street']","['black', 'dog', 'stare', 'sheep']",0.0,0,322,256,66,4356
1274,"['horse', 'rider', 'ride', 'white', 'horse']","['woman', 'lead', 'white', 'horse']",3.400000095367432,2,2430,3662,-1232,1517824
1275,"['long', 'train', 'train', 'track']","['train', 'train', 'track']",4.199999809265137,2,2424,4881,-2457,6036849
1276,"['black', 'dog', 'look', 'black', 'sheep']","['black', 'dog', 'look', 'brown', 'sheep', 'pen']",3.0,4,3958,2814,1144,1308736
1277,"['room', 'computer', 'picture', 'wall']","['home', 'office', 'computer', 'monitor', 'equipment', 'desk']",2.799999952316284,1,412,2667,-2255,5085025
1278,"['black', 'white', 'photo', 'cow', 'walk', 'tree', 'field']","['black', 'white', 'dog', 'look', 'camera']",1.0,2,2454,1027,1427,2036329
1279,"['silver', 'areomexico', 'met', 'miner', 'sit', 'tartar']","['aeromexico', 'silver', 'plane', 'runaway']",4.199999809265137,1,424,4888,-4464,19927296
1280,"['man', 'dirt', 'bike', 'jump', 'high']","['man', 'motorbike', 'jump', 'sky']",3.400000095367432,2,2446,3569,-1123,1261129
1281,"['people', 'sail', 'small', 'white', 'sail', 'boat']","['couple', 'sailing', 'small', 'sailboat']",4.199999809265137,1,417,4906,-4489,20151121
1282,"['white', 'airplane', 'mark', 'cement']","['blue', 'motorcycle', 'mark', 'sidewalk']",0.800000011920929,1,419,779,-360,129600
1283,"['cow', 'grazing', 'field']","['sheep', 'grazing', 'field']",0.800000011920929,2,2445,775,1670,2788900
1284,"['man', 'sit', 'mess', 'table', 'lawton']","['man', 'sit', 'look', 'lawton', 'computer', 'mess', 'table']",4.800000190734863,5,5014,5465,-451,203401
1285,"['dining', 'table', 'candle', 'wine', 'weapon']","['wooden', 'table', 'set', 'candle', 'wine', 'purple', 'plastic', 'bowl']",3.0,3,3004,2770,234,54756
1286,"['people', 'waddle', 'red', 'canoe', 'reflect', 'water']","['people', 'red', 'canoe', 'clear', 'lake']",3.200000047683716,3,2999,3271,-272,73984
1287,"['scantily', 'clothe', 'woman', 'stand', 'car']","['scantily', 'clad', 'woman', 'stand', 'small', 'red', 'vehicle']",3.799999952316284,3,2965,4234,-1269,1610361
1288,"['red', 'double', 'hecker', 'bus', 'take', 'passenger']","['red', 'double', 'hecker', 'bus', 'hood']",2.200000047683716,4,3882,2078,1804,3254416
1289,"['buddha', 'statue', 'hold', 'candle', 'sit', 'table']","['man', 'fish', 'small', 'boat', 'lake']",0.0,0,326,206,120,14400
1290,"['people', 'sit', 'dinner', 'table', 'smile', 'camera']","['elderly', 'woman', 'sit', 'dinner', 'table', 'man']",2.0,3,2933,1818,1115,1243225
1291,"['multi', 'colored', 'train', 'track']","['black', 'train', 'track']",2.799999952316284,2,2522,2714,-192,36864
1292,"['white', 'red', 'bus', 'travel', 'street']","['red', 'bus', 'street']",2.200000047683716,3,2922,2139,783,613089
1293,"['red', 'blue', 'plane', 'fly', 'landing', 'year']","['wwii', 'fighter', 'plane', 'landing', 'gear']",3.200000047683716,2,2539,3240,-701,491401
1294,"['small', 'boat', 'go', 'creek']","['boat', 'move', 'river']",3.0,1,497,2895,-2398,5750404
1295,"['woman', 'man', 'sit', 'long', 'table', 'restaurant']","['group', 'people', 'sit', 'table', 'italian', 'restaurant']",3.0,3,2940,2894,46,2116
1296,"['goat', 'stand', 'field', 'tree']","['large', 'boat', 'pull', 'small', 'white', 'boat']",0.0,0,327,211,116,13456
1297,"['black', 'white', 'photo', 'living', 'room', 'large', 'window', 'sofa', 'chair']","['black', 'white', 'scene', 'furnish', 'room', 'view', 'outlooke', 'forest']",3.0,3,2963,2890,73,5329
1298,"['close', 'brown', 'horse', 'blue', 'halted']","['close', 'horse', 'wear', 'blue', 'halted']",3.5999999046325684,4,3889,3879,10,100
1299,"['large', 'black', 'bird', 'sit', 'water']","['bird', 'swim', 'water']",2.5999999046325684,2,2503,2516,-13,169
1300,"['close', 'cat', 'cream', 'sofa']","['soame', 'cat', 'rest', 'white', 'sofa']",3.400000095367432,2,2474,3600,-1126,1267876
1301,"['person', 'jump', 'bicycle', 'perform', 'trick']","['person', 'ride', 'dirt', 'bike', 'outdoor']",2.25,1,498,2162,-1664,2768896
1302,"['yellow', 'school', 'bus', 'mark', 'rural', 'area']","['yellow', 'school', 'bus', 'mark', 'field']",4.0,4,3903,4462,-559,312481
1303,"['dog', 'wit', 'yellow', 'chair', 'green', 'dumpster']","['bulldog', 'sit', 'yellow', 'chair', 'large', 'waste', 'receptacle']",3.200000047683716,2,2494,3225,-731,534361
1304,"['woman', 'sit', 'red', 'motorcycle']","['white', 'sheep', 'stand', 'green', 'hill']",0.0,0,328,212,116,13456
1305,"['sheep', 'stand', 'table', 'auction']","['coolly', 'sheep', 'auction', 'house']",4.199999809265137,2,2493,4905,-2412,5817744
1306,"['close', 'black', 'train', 'engine']","['close', 'white', 'sheep', 'black', 'head']",0.0,2,2490,213,2277,5184729
1307,"['orange', 'white', 'cat', 'asleep', 'leather', 'chair']","['orange', 'white', 'cat', 'lay', 'blanket', 'black', 'leather', 'chair']",4.0,5,4975,4455,520,270400
1308,"['train', 'ride', 'track']","['train', 'come', 'track', 'row', 'tree']",3.0,2,2485,2923,-438,191844
1309,"['black', 'white', 'cow', 'stand', 'grassy', 'field']","['black', 'white', 'horn', 'cow', 'stand', 'field']",3.799999952316284,5,4831,4225,606,367236
1310,"['double', 'hecker', 'red', 'united', 'bus', 'city', 'street']","['double', 'hecker', 'bus', 'drive', 'city', 'street']",4.0,5,4980,4447,533,284089
1311,"['television', 'desk', 'hotel', 'room', 'lamp', 'lighting']","['television', 'lawton', 'computer', 'hotel', 'room']",2.5999999046325684,3,2948,2504,444,197136
1312,"['man', 'ride', 'small', 'bicycle']","['man', 'wheel', 'bike']",2.799999952316284,1,504,2690,-2186,4778596
1313,"['woman', 'wear', 'navy', 'dress', 'cut', 'cake', 'white', 'table']","['person', 'wear', 'helmet', 'sit', 'bicycle', 'sunny', 'day']",0.4000000059604645,1,506,499,7,49
1314,"['black', 'train', 'move', 'track']","['train', 'travel', 'track']",4.0,2,2495,4449,-1954,3818116
1315,"['close', 'picture', 'white', 'purple', 'motorcycle']","['close', 'picture', 'desk', 'computer', 'paper']",1.0,2,2497,1098,1399,1957201
1316,"['young', 'girl', 'ride', 'brown', 'horse']","['woman', 'ride', 'brown', 'horse']",3.799999952316284,3,2952,4217,-1265,1600225
1317,"['woman', 'kitchen', 'look', 'object']","['man', 'suit', 'sit', 'table']",0.0,0,329,214,115,13225
1318,"['woman', 'lose', 'baby']","['woman', 'pose', 'baby']",2.200000047683716,2,2482,2028,454,206116
1319,"['group', 'people', 'sit', 'table', 'contain', 'food']","['people', 'sit', 'living', 'room']",2.799999952316284,2,2471,2659,-188,35344
1320,"['blue', 'motorcycle', 'mark', 'sidewalk']","['blue', 'move', 'mark', 'sidewalk']",4.0,3,2954,4463,-1509,2277081
1321,"['red', 'double', 'hecker', 'bus', 'city', 'street']","['red', 'double', 'hecker', 'bus', 'drive', 'street']",4.800000190734863,5,4959,5394,-435,189225
1322,"['train', 'inside', 'train', 'station']","['train', 'sit', 'train', 'station']",2.400000095367432,2,2469,2179,290,84100
1323,"['man', 'ride', 'white', 'horse']","['woman', 'white', 'horse']",2.200000047683716,2,2470,2039,431,185761
1324,"['man', 'woman', 'smile', 'camera', 'sit', 'blue', 'sofa']","['man', 'woman', 'smile', 'camera', 'stand', 'kitchen']",2.200000047683716,4,4532,2063,2469,6095961
1325,"['large', 'cruise', 'ship', 'harbor', 'tree']","['cruise', 'ship', 'lock', 'coast']",3.400000095367432,2,2479,3508,-1029,1058841
1326,"['cow', 'cross', 'road', 'intervention']","['cow', 'cross', 'paved', 'street']",3.799999952316284,2,2528,4216,-1688,2849344
1327,"['cow', 'grazing', 'median', 'road']","['cow', 'grazing', 'patch', 'grass', 'roadway']",4.0,2,2533,4415,-1882,3541924
1328,"['black', 'cow', 'brown', 'cow', 'stand', 'plain', 'promote', 'tree']","['black', 'cow', 'brown', 'cow', 'stand', 'small', 'copse', 'tree', 'field']",4.199999809265137,5,4953,4731,222,49284
1329,"['red', 'double', 'hecker', 'bus', 'drive', 'street']","['double', 'hecker', 'bus', 'city', 'street']",3.5999999046325684,4,4598,3836,762,580644
1330,"['cow', 'ear', 'tag', 'grassy', 'field']","['person', 'grassy', 'field', 'tend', 'sheep']",1.2000000476837158,2,2524,1119,1405,1974025
1331,"['close', 'end', 'purple', 'white', 'motor', 'cycle']","['close', 'rear', 'red', 'sport', 'car']",1.2000000476837158,1,517,1111,-594,352836
1332,"['woman', 'shop', 'clothing', 'store']","['woman', 'clothing', 'store']",4.599999904632568,3,2928,5264,-2336,5456896
1333,"['group', 'people', 'sit', 'restaurant', 'table']","['group', 'people', 'sit', 'table', 'restaurant']",4.599999904632568,5,4956,5263,-307,94249
1334,"['close', 'brown', 'horse', 'head']","['close', 'yellow', 'school', 'bus']",0.0,1,521,224,297,88209
1335,"['person', 'red', 'cap', 'stand', 'brick', 'support', 'beam']","['brown', 'horse', 'stand', 'grass', 'scrub']",0.0,1,493,225,268,71824
1336,"['bay', 'foal', 'walk', 'mother', 'grassy', 'field']","['close', 'young', 'horse', 'walk', 'large', 'horse']",2.5999999046325684,1,523,2405,-1882,3541924
1337,"['woman', 'stand', 'brown', 'cow']","['woman', 'glass', 'stand', 'cow', 'field']",3.799999952316284,3,2931,4210,-1279,1635841
1338,"['dog', 'peak', 'truck']","['dog', 'seek', 'van']",3.5999999046325684,1,461,3835,-3374,11383876
1339,"['woman', 'blue', 'shift', 'dress', 'cutting', 'food']","['woman', 'blue', 'dress', 'cut', 'cake']",3.799999952316284,3,2934,4175,-1241,1540081
1340,"['black', 'white', 'cat', 'look', 'camera']","['grey', 'black', 'white', 'cat', 'look', 'camera']",3.5999999046325684,5,4971,3856,1115,1243225
1341,"['brunette', 'girl', 'sit', 'stop', 'red', 'yellow', 'motorcycle', 'car']","['couple', 'lose', 'red', 'yellow', 'motorcycle']",3.200000047683716,3,2936,3119,-183,33489
1342,"['small', 'white', 'cat', 'stand', 'sink']","['grey', 'white', 'cat', 'sit', 'bathroom', 'sink']",3.5999999046325684,3,2937,3872,-935,874225
1343,"['man', 'seat', 'red', 'tender', 'bicycle']","['man', 'tender', 'bicycle']",3.5999999046325684,3,2938,3871,-933,870489
1344,"['computer', 'desk']","['computer', 'operate', 'desk']",4.0,2,2520,4515,-1995,3980025
1345,"['small', 'child', 'smile', 'camera']","['small', 'child', 'sit', 'cement', 'wall', 'near', 'white', 'flower']",1.600000023841858,2,2523,1523,1000,1000000
1346,"['little', 'bird', 'float', 'water']","['duck', 'float', 'water']",2.400000095367432,2,2462,2306,156,24336
1347,"['white', 'bus', 'word', 'julia', 'near', 'water', 'big', 'ship']","['white', 'bus', 'water', 'barge', 'background']",3.799999952316284,3,2966,4172,-1206,1454436
1348,"['old', 'blue', 'white', 'train', 'track']","['blue', 'train', 'mountainous', 'area']",2.5999999046325684,2,2405,2477,-72,5184
1349,"['fellow', 'boat', 'beach']","['yellow', 'boat', 'shore']",4.0,1,465,4494,-4029,16232841
1350,"['kitchendiner', 'paper', 'lay', 'blue', 'clothe', 'dining', 'table']","['small', 'kitchen', 'fluttered', 'table', 'blue', 'table', 'cloth']",3.400000095367432,2,2407,3487,-1080,1166400
1351,"['brain', 'station']","['train', 'inside', 'indoor', 'station']",3.799999952316284,1,468,4136,-3668,13454224
1352,"['gray', 'cat', 'sit', 'window', 'ledge', 'look', 'camera']","['cat', 'stand', 'window', 'sill', 'look', 'camera']",4.0,4,4444,4471,-27,729
1353,"['play', 'guitar', 'sit']","['red', 'white', 'bus', 'drive', 'road']",0.0,0,331,136,195,38025
1354,"['red', 'double', 'hecker', 'bus', 'drive', 'street']","['double', 'hecker', 'bus', 'city', 'street']",4.199999809265137,4,4445,4754,-309,95481
1355,"['cow', 'graze', 'grassy', 'field']","['cow', 'grazing', 'field']",4.599999904632568,2,2413,5255,-2842,8076964
1356,"['brown', 'train', 'sit', 'railroad', 'track']","['white', 'train', 'sit', 'track']",2.25,3,2998,2157,841,707281
1357,"['black', 'white', 'horn', 'cow', 'stand', 'field']","['black', 'white', 'photo', 'cat', 'sit', 'sofa']",0.4000000059604645,2,2416,488,1928,3717184
1358,"['tiny', 'blonde', 'child', 'blue', 'dress', 'sit', 'table', 'near', 'mother']","['young', 'blonde', 'girl', 'wear', 'helmet', 'sit', 'red', 'bicycle']",1.600000023841858,2,2400,1550,850,722500
1359,"['group', 'people', 'sit', 'restaurant', 'table']","['group', 'people', 'sit', 'table', 'porch']",2.5999999046325684,4,4449,2495,1954,3818116
1360,"['black', 'white', 'cow', 'pen', 'hay']","['black', 'white', 'cat', 'lie', 'dirt']",0.4000000059604645,2,2381,490,1891,3575881
1361,"['red', 'double', 'hecker', 'bus']","['leave', 'red', 'double', 'hecker', 'bus']",3.200000047683716,4,4455,3103,1352,1827904
1362,"['close', 'view', 'horse', 'head']","['view', 'horse', 'head']",3.200000047683716,3,3002,3106,-104,10816
1363,"['old', 'fashioned', 'wooden', 'sailing', 'ship', 'ocean']","['wooden', 'yacht', 'ocean']",3.200000047683716,2,2382,3116,-734,538756
1364,"['sheep', 'stand', 'mountainous', 'area']","['large', 'sheep', 'stand', 'hill']",4.400000095367432,2,2387,5048,-2661,7080921
1365,"['white', 'plane', 'runaway']","['white', 'airplane', 'runaway']",4.800000190734863,2,2397,5353,-2956,8737936
1366,"['puppy', 'pet']","['puppy', 'hold', 'pet']",4.400000095367432,2,2390,5030,-2640,6969600
1367,"['elegant', 'dining', 'room', 'wood', 'furniture']","['elegant', 'pink', 'dining', 'room', 'wooden', 'furniture']",3.799999952316284,4,4433,4133,300,90000
1368,"['woman', 'lay', 'man', 'sit', 'sofa']","['man', 'short', 'sit', 'sofa']",2.0,3,3006,1839,1167,1361889
1369,"['motorbike', 'dirt', 'track']","['dirt', 'baker', 'ride', 'dirt', 'hill']",3.5999999046325684,1,479,3862,-3383,11444689
1370,"['black', 'white', 'cat', 'look', 'camera']","['black', 'white', 'dog', 'look', 'camera']",2.200000047683716,4,4411,2116,2295,5267025
1371,"['gray', 'cat', 'green', 'eye', 'look', 'camera']","['grey', 'cat', 'green', 'eye', 'look', 'camera']",5.0,5,5015,5555,-540,291600
1372,"['lamb', 'stand', 'grassy', 'hill']","['dirt', 'baker', 'ride', 'dirt', 'hill']",0.2000000029802322,1,480,420,60,3600
1373,"['man', 'white', 'wine', 'bottle', 'woman', 'red', 'turtleneck', 'white', 'vest']","['man', 'woman', 'lose', 'field', 'bottle', 'wine']",3.0,4,4419,2876,1543,2380849
1374,"['lone', 'cow', 'sit', 'cold', 'yard']","['black', 'white', 'cow', 'stand', 'field']",1.7999999523162842,1,481,1642,-1161,1347921
1375,"['double', 'hecker', 'bus', 'drive', 'city', 'street']","['red', 'double', 'hecker', 'bus', 'drive', 'street']",3.5999999046325684,5,5006,3857,1149,1320201
1376,"['large', 'black', 'white', 'cat', 'rest', 'windowsill']","['small', 'white', 'cat', 'sit', 'sink']",1.7999999523162842,2,2448,1648,800,640000
1377,"['boy', 'feed', 'sheep']","['boy', 'feed', 'sheep', 'hay']",4.199999809265137,3,2990,4762,-1772,3139984
1378,"['girl', 'black', 'desktop', 'hold', 'open', 'box', 'worn', 'lakes', 'carbon', 'milk']","['girl', 'wear', 'black', 'short', 'boot', 'stand', 'blue', 'motorcycle']",0.0,2,2458,35,2423,5870929
1379,"['close', 'small', 'cactus', 'pot']","['close', 'woman', 'hold', 'white', 'puppy']",0.800000011920929,1,485,874,-389,151321
1380,"['white', 'sheep', 'stand', 'green', 'hill']","['sheep', 'stand', 'hillside']",4.0,2,2460,4393,-1933,3736489
1381,"['black', 'white', 'bird', 'body', 'water', 'grass', 'background']","['bus', 'road', 'ferry', 'wheel', 'background']",0.0,1,486,40,446,198916
1382,"['wooden', 'bicycle', 'owning']","['group', 'elderly', 'people', 'sit', 'dining', 'table']",0.0,0,333,42,291,84681
1383,"['black', 'white', 'photo', 'dilapidated', 'wooden', 'fence']","['black', 'white', 'photo', 'old', 'wooden', 'fence', 'near', 'dirty', 'street']",4.5,5,4875,5140,-265,70225
1384,"['brown', 'horse', 'stand', 'green', 'meadow']","['brown', 'horse', 'stand', 'tall', 'grass']",2.5999999046325684,3,2974,2484,490,240100
1385,"['man', 'wear', 'bike', 'helmet']","['man', 'stand', 'bicycle', 'outside', 'shop']",1.600000023841858,1,425,1537,-1112,1236544
1386,"['man', 'play', 'video', 'game', 'store']","['playing', 'game', 'store']",3.400000095367432,2,2429,3603,-1174,1378276
1387,"['group', 'people', 'sit', 'table', 'porch']","['group', 'people', 'sit', 'table', 'food']",3.5999999046325684,4,4509,3926,583,339889
1388,"['young', 'girl', 'wear', 'bike', 'helmet', 'bicycle', 'background']","['woman', 'hold', 'small', 'dog', 'leash', 'chair', 'background']",0.0,1,489,43,446,198916
1389,"['stop', 'sign', 'stick']","['stop', 'sign', 'adorn', 'stick']",5.0,3,2978,5533,-2555,6528025
1390,"['bicycle', 'mark', 'outside', 'bookstore']","['green', 'bike', 'mark', 'outside', 'book', 'store']",4.0,2,2620,4402,-1782,3175524
1391,"['brown', 'double', 'hecker', 'tour', 'bus', 'street', 'ferry', 'wheel']","['double', 'hecker', 'bus', 'drive', 'ferry', 'wheel']",4.400000095367432,5,4880,5102,-222,49284
1392,"['black', 'white', 'chair', 'sit', 'brick', 'wall', 'window', 'bamboo', 'plant', 'vase']","['black', 'headed', 'sheep', 'cover', 'thick', 'white', 'wool', 'stand', 'pasture', 'sheep']",0.6000000238418579,2,2619,680,1939,3759721
1393,"['man', 'black', 'uniform', 'white', 'horse']","['man', 'tax', 'white', 'horse']",3.5999999046325684,3,2984,3928,-944,891136
1394,"['woman', 'stand', 'living', 'room', 'black', 'dog']","['woman', 'stand', 'living', 'room', 'black', 'dog', 'look', 'camera']",4.0,6,5185,4369,816,665856
1395,"['people', 'waddle', 'red', 'canoe', 'reflect', 'water']","['people', 'waddle', 'red', 'canoe', 'tree', 'background']",3.200000047683716,4,4477,3199,1278,1633284
1396,"['close', 'view', 'headlight', 'blue', 'old', 'fashioned', 'car']","['close', 'headlight', 'blue', 'car']",4.0,4,4479,4375,104,10816
1397,"['war', 'drive', 'near', 'model', 'building']","['vehicle', 'drive', 'infant', 'senate', 'building']",2.400000095367432,2,2606,2244,362,131044
1398,"['blue', 'orange', 'airplane', 'fly', 'landing', 'gear']","['red', 'blue', 'plane', 'fly', 'landing', 'year']",2.5999999046325684,3,2987,2460,527,277729
1399,"['black', 'white', 'cat', 'lie', 'blanket']","['black', 'white', 'cat', 'sleep', 'purple', 'blanket']",4.0,4,4483,4380,103,10609
1400,"['building', 'temporary', 'sign', 'entrance', 'parking', 'lot']","['road', 'rear', 'image', 'tail', 'light', 'bus']",0.2000000029802322,0,315,380,-65,4225
1401,"['group', 'people', 'sit', 'table', 'contain', 'food']","['group', 'people', 'sit', 'table', 'porch']",3.400000095367432,4,4594,3549,1045,1092025
1402,"['man', 'woman', 'sit', 'sofa', 'hold', 'small', 'baby']","['woman', 'sit', 'sofa', 'hold', 'baby']",3.200000047683716,5,4834,3169,1665,2772225
1403,"['black', 'white', 'cat', 'lie', 'blanket']","['black', 'white', 'cat', 'sleep', 'purple', 'blanket']",3.0,4,4484,2771,1713,2934369
1404,"['black', 'white', 'photo', 'love', 'seat']","['black', 'white', 'photo', 'bicycle']",1.7999999523162842,3,2850,1636,1214,1473796
1405,"['living', 'room', 'dining', 'table', 'background']","['view', 'living', 'room', 'dining', 'room', 'background']",4.199999809265137,4,4482,4767,-285,81225
1406,"['red', 'gray', 'train', 'go', 'tunnel']","['red', 'gray', 'train', 'travel', 'tunnel', 'tree']",4.25,4,4481,4913,-432,186624
1407,"['red', 'double', 'hecker', 'bus', 'hood', 'open']","['old', 'red', 'london', 'double', 'hecker', 'bus', 'hood', 'raise']",4.199999809265137,5,4836,4736,100,10000
1408,"['man', 'ride', 'white', 'horse']","['woman', 'lead', 'white', 'horse']",1.7999999523162842,2,2603,1695,908,824464
1409,"['view', 'living', 'room', 'dining', 'room', 'background']","['living', 'room', 'large', 'sofas', 'dining', 'table', 'background']",3.799999952316284,4,4475,4122,353,124609
1410,"['orange', 'kitten', 'lie', 'leather', 'couch']","['young', 'couple', 'sit', 'black', 'couch']",0.800000011920929,1,466,858,-392,153664
1411,"['person', 'wear', 'bike', 'helmet', 'talk', 'cell', 'phone']","['person', 'wear', 'helmet', 'ride', 'bike', 'near', 'white', 'structure']",3.0,4,4470,2805,1665,2772225
1412,"['subway', 'train', 'pull', 'station']","['white', 'train', 'pull', 'station']",3.5999999046325684,3,2863,3961,-1098,1205604
1413,"['bicycle', 'mark', 'shop']","['green', 'bike', 'mark', 'outside', 'book', 'store']",3.799999952316284,1,462,4121,-3659,13388281
1414,"['man', 'stand', 'beach']","['woman', 'stand', 'tour', 'bus']",0.0,1,490,53,437,190969
1415,"['long', 'haired', 'black', 'dog', 'stand', 'grassy', 'field']","['blue', 'jay', 'stand', 'grassy', 'field']",1.399999976158142,3,2865,1307,1558,2427364
1416,"['small', 'desk', 'chair', 'near', 'sundry', 'closet']","['room', 'wall', 'washed', 'dwyer']",0.2000000029802322,0,313,392,-79,6241
1417,"['red', 'double', 'hecker', 'bus', 'drive', 'street']","['red', 'double', 'hecker', 'bus', 'drive', 'street']",4.599999904632568,6,5196,5278,-82,6724
1418,"['goose', 'flap', 'wing', 'body', 'water']","['black', 'swan', 'flap', 'wing', 'water']",3.0,3,2868,2807,61,3721
1419,"['boy', 'lay', 'couch', 'dog']","['boy', 'lie', 'couch', 'puppy']",4.400000095367432,2,2598,5114,-2516,6330256
1420,"['black', 'white', 'image', 'cat', 'lay', 'rug']","['black', 'white', 'picture', 'cat', 'lay', 'rug']",5.0,5,4843,5513,-670,448900
1421,"['large', 'jet', 'ground', 'airport']","['large', 'airplane', 'mark', 'airport', 'night']",3.5999999046325684,2,2594,3973,-1379,1901641
1422,"['woman', 'sit', 'cafe']","['man', 'catch', 'fish', 'swamp']",0.0,0,297,55,242,58564
1423,"['right', 'bottle', 'karp', 'later', 'line', 'floor']","['right', 'bottle', 'karp', 'beer', 'line', 'wooden', 'floor']",4.0,5,4846,4407,439,192721
1424,"['small', 'child', 'smile', 'camera']","['cat', 'look', 'camera']",1.399999976158142,1,519,1312,-793,628849
1425,"['woman', 'ride', 'brown', 'horse']","['person', 'dress', 'blue', 'ride', 'brown', 'horse']",2.5999999046325684,3,2826,2524,302,91204
1426,"['photo', 'television', 'screen', 'show', 'movie']","['wall', 'mount', 'flat', 'screen', 'show', 'movie']",3.200000047683716,3,2828,3165,-337,113569
1427,"['bird', 'perch', 'flowerpot']","['bird', 'perch', 'flowerpot', 'stuck', 'wall']",4.199999809265137,3,2829,4713,-1884,3549456
1428,"['white', 'cat', 'sit', 'inside', 'sink']","['grey', 'white', 'cat', 'sit', 'bathroom', 'sink']",3.400000095367432,4,4502,3667,835,697225
1429,"['young', 'woman', 'ride', 'gear', 'horse']","['young', 'girl', 'ride', 'gear', 'horse']",4.400000095367432,4,4507,5101,-594,352836
1430,"['people', 'sail', 'small', 'boat']","['woman', 'sailboat']",3.799999952316284,0,299,4118,-3819,14584761
1431,"['small', 'bird', 'tiny', 'branch']","['small', 'bird', 'perch', 'icy', 'branch']",3.0,3,2833,2775,58,3364
1432,"['animal', 'sit', 'rock']","['eagle', 'sit', 'long', 'branch']",1.600000023841858,1,502,1522,-1020,1040400
1433,"['cat', 'sit', 'couch', 'look', 'window']","['cat', 'sit', 'couch', 'look', 'window', 'sea', 'photo']",4.199999809265137,5,4855,4711,144,20736
1434,"['young', 'woman', 'hear', 'sheep']","['woman', 'sneer', 'sheep']",4.400000095367432,2,2576,5086,-2510,6300100
1435,"['young', 'rider', 'take', 'ride', 'brown', 'horse']","['young', 'female', 'rider', 'brown', 'horse']",3.799999952316284,4,4504,4117,387,149769
1436,"['people', 'seat', 'restaurant', 'table', 'look', 'camera']","['group', 'people', 'sit', 'restaurant', 'table']",3.0,3,2838,2776,62,3844
1437,"['little', 'white', 'lamb', 'nose', 'wood']","['white', 'lamb', 'nose', 'wooden', 'box']",3.799999952316284,3,2840,4116,-1276,1628176
1438,"['young', 'girl', 'ride', 'white', 'grey', 'horse']","['little', 'girl', 'ride', 'white', 'grey', 'horse']",4.599999904632568,5,4921,5219,-298,88804
1439,"['black', 'dog', 'stand', 'material', 'construction', 'site']","['black', 'dog', 'stand', 'room', 'construct']",3.200000047683716,3,2843,3154,-311,96721
1440,"['bird', 'flap', 'wing', 'water']","['black', 'swan', 'flap', 'wing', 'water']",3.5999999046325684,3,2844,3929,-1085,1177225
1441,"['black', 'white', 'cat', 'lie', 'blanket']","['black', 'white', 'cat', 'lay', 'cat', 'bed']",3.75,3,2870,4033,-1163,1352569
1442,"['young', 'woman', 'ride', 'gear', 'horse']","['woman', 'ride', 'brown', 'horse']",3.799999952316284,3,2871,4114,-1243,1545049
1443,"['plane', 'reply']","['small', 'turboprop', 'plane', 'load', 'tartar']",3.400000095367432,1,413,3644,-3231,10439361
1444,"['white', 'leather', 'couch', 'purse', 'throw', 'blanket']",['television'],0.0,0,302,33,269,72361
1445,"['kitchen', 'wooden', 'cabinet', 'furniture']","['kitchen', 'wooden', 'table', 'cabinet']",4.199999809265137,3,2898,4734,-1836,3370896
1446,"['cat', 'attack', 'corn', 'dusk', 'broom']","['grey', 'white', 'cat', 'sit', 'bathroom', 'sink']",0.800000011920929,1,418,776,-358,128164
1447,"['couple', 'hold', 'baby']","['couple', 'newton', 'baby']",4.199999809265137,2,2637,4710,-2073,4297329
1448,"['small', 'bird', 'eat', 'tender']","['bird', 'eat', 'bird', 'tender']",4.25,3,2907,4923,-2016,4064256
1449,"['close', 'white', 'sheep', 'black', 'head']","['close', 'sheep', 'black', 'head']",4.0,4,4446,4642,-196,38416
1450,"['young', 'boy', 'lay', 'sofa', 'dog']","['small', 'boy', 'lay', 'sofa', 'dog']",5.0,4,4430,5526,-1096,1201216
1451,"['red', 'bird', 'perch', 'tree']","['small', 'red', 'grey', 'bird', 'perch', 'tree']",3.200000047683716,4,4428,3124,1304,1700416
1452,"['bush', 'mark', 'street']","['fellow', 'soon', 'mark', 'alley', 'way']",0.4000000059604645,1,410,506,-96,9216
1453,"['black', 'white', 'dog', 'look', 'camera']","['grey', 'black', 'white', 'cat', 'look', 'camera']",1.0,4,4424,1042,3382,11437924
1454,"['train', 'railroad', 'track']","['train', 'train', 'track']",4.800000190734863,2,2626,5432,-2806,7873636
1455,"['large', 'silver', 'locomotive', 'engine', 'shed']","['close', 'silver', 'train', 'engine', 'red', 'strike']",3.0,2,2367,3039,-672,451584
1456,"['woman', 'sit', 'table', 'drink', 'basketball', 'picture', 'background']","['woman', 'safi', 'drink', 'sit', 'table']",2.5999999046325684,4,4421,2387,2034,4137156
1457,"['green', 'steam', 'engine', 'travel', 'railroad', 'track']","['black', 'steam', 'train', 'travel', 'railroad', 'track']",3.0,4,4420,3044,1376,1893376
1458,"['small', 'red', 'car', 'semi', 'truck']","['red', 'sport', 'car', 'white', 'semi', 'truck']",4.0,4,4417,4665,-248,61504
1459,"['man', 'pose', 'photo', 'train']","['man', 'stand', 'platform', 'silver', 'train']",3.400000095367432,2,2153,3476,-1323,1750329
1460,"['bicycling', 'black', 'black', 'red', 'racing', 'bike']","['cycling', 'black', 'white', 'liar', 'speeding', 'past', 'spectator']",3.400000095367432,1,416,3430,-3014,9084196
1461,"['kitchen', 'sink', 'countertop', 'bowl', 'shelf']","['small', 'kitchen', 'item', 'stack', 'shelf', 'counter']",3.799999952316284,2,2155,4124,-1969,3876961
1462,"['television', 'mess', 'room', 'bookcase']","['room', 'television', 'sterno', 'bookshelf']",3.200000047683716,2,2158,3148,-990,980100
1463,"['black', 'white', 'cat', 'sleep', 'purple', 'blanket']","['black', 'white', 'cat', 'lay', 'ground', 'sun']",2.799999952316284,3,2874,2670,204,41616
1464,"['woman', 'ride', 'bicycle', 'large', 'concrete', 'area']","['woman', 'ride', 'mountain', 'bike', 'large', 'concrete', 'area']",3.799999952316284,5,4944,4140,804,646416
1465,"['cow', 'stand', 'large', 'field']","['cow', 'graze', 'field']",2.799999952316284,2,2160,2664,-504,254016
1466,"['bald', 'man', 'touch', 'nose', 'black', 'horse', 'fence']","['bald', 'man', 'beard', 'pet', 'nose', 'black', 'white', 'horse', 'fence']",3.400000095367432,6,5202,3444,1758,3090564
1467,"['man', 'stand', 'yellow', 'sport', 'car']","['man', 'stand', 'yellow', 'corvette']",4.0,3,2877,4643,-1766,3118756
1468,"['black', 'white', 'photo', 'cow', 'stall']","['black', 'white', 'photo', 'cattle', 'trough']",3.200000047683716,3,2878,3128,-250,62500
1469,"['double', 'hecker', 'bus', 'london', 'eye', 'ferry', 'wheel', 'background']","['brown', 'double', 'hecker', 'tour', 'bus', 'street', 'ferry', 'wheel']",4.199999809265137,5,4896,4743,153,23409
1470,"['yellow', 'black', 'bird', 'eat', 'bird', 'tender']","['flock', 'bird', 'fly', 'body', 'water']",0.6000000238418579,1,438,715,-277,76729
1471,"['man', 'stand', 'train']","['man', 'stand', 'platform', 'silver', 'train']",3.799999952316284,3,2893,4171,-1278,1633284
1472,"['small', 'plane', 'mark', 'fairfield', 'cloudy', 'sky', 'overhead']","['small', 'white', 'plane', 'mark', 'airport', 'cloudy', 'day']",4.599999904632568,4,4179,5203,-1024,1048576
1473,"['boat', 'water', 'near', 'small', 'plane']","['boat', 'water', 'small', 'airplane', 'dock']",3.400000095367432,3,2887,3524,-637,405769
1474,"['man', 'ride', 'white', 'horse', 'arena']","['domestic', 'animal', 'stand', 'pen']",0.6000000238418579,0,309,666,-357,127449
1475,"['farintosh', 'computer', 'sit', 'floor']","['computer', 'floor']",4.199999809265137,2,2379,4756,-2377,5650129
1476,"['black', 'white', 'cat', 'sit', 'brown', 'chair', 'look']","['dog', 'sit', 'yellow', 'chair', 'green', 'dumpster']",0.4000000059604645,2,2169,517,1652,2729104
1477,"['sheep', 'stand', 'afield']","['large', 'dog', 'stand', 'sheep', 'field']",2.799999952316284,2,2191,2743,-552,304704
1478,"['group', 'elderly', 'people', 'sit', 'table']","['group', 'elderly', 'people', 'pose', 'dining', 'table']",3.400000095367432,4,4434,3484,950,902500
1479,"['woman', 'brown', 'hair', 'smile']","['woman', 'indian', 'dress', 'crowded', 'room', 'smile']",2.799999952316284,2,2205,2677,-472,222784
1480,"['black', 'white', 'photo', 'train', 'station']","['black', 'white', 'photo', 'cat', 'sit', 'sofa']",1.600000023841858,3,3136,1564,1572,2471184
1481,"['dog', 'fence', 'tunnel', 'look', 'ahead']","['girl', 'guy', 'lose', 'bow', 'boat']",0.0,0,310,116,194,37636
1482,"['black', 'white', 'cow', 'look', 'fence']","['black', 'white', 'cat', 'lay', 'ground', 'sun']",0.6000000238418579,2,2189,691,1498,2244004
1483,"['people', 'motorcycle', 'market', 'square']","['people', 'ride', 'move', 'urban', 'setting']",1.7999999523162842,1,663,1698,-1035,1071225
1484,"['close', 'sheep', 'grass']","['close', 'lamb', 'ear', 'ragged', 'stand', 'grass']",1.7999999523162842,2,2174,1697,477,227529
1485,"['domestic', 'cat', 'lay', 'cat', 'litter']","['domestic', 'cat', 'black', 'trap']",2.0,2,2175,1899,276,76176
1486,"['green', 'bird', 'fly', 'wooden', 'telephone', 'pole']","['green', 'bird', 'fly', 'telephone', 'wire']",3.200000047683716,4,4459,3168,1291,1666681
1487,"['person', 'sit', 'motorcycle', 'man', 'stand']","['man', 'stand', 'helmet', 'man', 'motorcycle', 'parking', 'lot']",3.0,3,3141,2955,186,34596
1488,"['cow', 'grazing', 'field']","['cow', 'graze', 'field']",2.5999999046325684,2,2177,2432,-255,65025
1489,"['blue', 'bird', 'perch', 'gloved', 'hand']","['bird', 'perch', 'person', 'gloved', 'hand']",4.400000095367432,4,4443,5014,-571,326041
1490,"['baby', 'hold', 'ketchup', 'packet']","['baby', 'highchair', 'hold', 'ketchup', 'packet']",4.0,4,4441,4687,-246,60516
1491,"['close', 'view', 'horse', 'head']","['close', 'brown', 'horse', 'head']",4.199999809265137,3,3147,4760,-1613,2601769
1492,"['train', 'train', 'station']","['train', 'station']",5.0,2,2182,5490,-3308,10942864
1493,"['dark', 'brown', 'horse', 'stand', 'field']","['horse', 'stand', 'field']",3.5999999046325684,3,3151,3955,-804,646416
1494,"['small', 'cat', 'lay', 'wooden', 'beam', 'look', 'camera']","['small', 'dog', 'wear', 'sweet', 'look', 'camera']",0.800000011920929,3,3154,829,2325,5405625
1495,"['black', 'bird', 'sit', 'ground']","['bird', 'sit', 'branch']",2.5,2,2127,2332,-205,42025
1496,"['small', 'brown', 'bird', 'eat', 'bird', 'tender', 'hang', 'tree']","['small', 'red', 'grey', 'bird', 'perch', 'tree']",2.0,3,3120,1906,1214,1473796
1497,"['pair', 'dog', 'play', 'purple', 'ball']","['dog', 'play', 'purple', 'football']",4.400000095367432,3,3112,4990,-1878,3526884
1498,"['bird', 'land', 'water']","['boat', 'float', 'water']",0.6000000238418579,1,855,667,188,35344
1499,"['child', 'stand', 'near', 'fence']","['child', 'stand', 'fence']",4.599999904632568,3,3114,5314,-2200,4840000
1500,"['black', 'dog', 'emerge', 'water', 'white', 'ball', 'mouth']","['black', 'dog', 'walk', 'water', 'white', 'ball', 'mouth']",4.800000190734863,6,5058,5404,-346,119716
1501,"['girl', 'purple', 'shirt', 'pink', 'headband', 'lose']","['young', 'girl', 'wear', 'hat', 'blue', 'jean', 'swing']",0.4000000059604645,1,854,523,331,109561
1502,"['brown', 'dog', 'dig', 'hole', 'plant']","['group', 'people', 'walk', 'railroad', 'track']",0.0,0,312,80,232,53824
1503,"['brown', 'white', 'dog', 'swim', 'swimming', 'pool']","['brown', 'white', 'dog', 'swim', 'backward', 'swimming', 'pool']",4.599999904632568,6,5061,5313,-252,63504
1504,"['boy', 'red', 'lead', 'ride', 'hill']","['multicolour', 'dog', 'red', 'collar', 'crouch', 'grass']",0.0,1,851,84,767,588289
1505,"['black', 'brown', 'dog', 'run', 'wood']","['dog', 'run', 'wood']",4.0,3,3116,4558,-1442,2079364
1506,"['dog', 'run', 'grass']","['dog', 'play', 'grass']",4.400000095367432,2,2071,4995,-2924,8549776
1507,"['young', 'girl', 'hold', 'peace', 'sign']","['little', 'girl', 'hold', 'pole', 'city', 'street']",0.6000000238418579,2,2073,717,1356,1838736
1508,"['man', 'hang', 'line', 'cliff', 'water']","['sitting', 'pier', 'bottle', 'water']",0.6000000238418579,1,848,724,124,15376
1509,"['man', 'crouch', 'hold', 'camera']","['crouch', 'man', 'hold', 'large', 'camera']",4.599999904632568,4,4586,5310,-724,524176
1510,"['ride', 'bicycle', 'narrow', 'path']","['man', 'ride', 'bicycle', 'paved', 'road']",2.5999999046325684,2,2080,2418,-338,114244
1511,"['man', 'wear', 'orange', 'coat', 'speak', 'walk', 'snow']","['man', 'woman', 'dress', 'old', 'fashion', 'clothing', 'sit', 'outside', 'table']",0.6000000238418579,1,846,698,148,21904
1512,"['dog', 'jump', 'air', 'catch', 'toy']","['black', 'dog', 'jump', 'air', 'catch', 'toy']",4.0,5,4891,4570,321,103041
1513,"['brown', 'dog', 'lay', 'blue', 'cover']","['person', 'diving', 'clear', 'blue', 'water']",0.0,1,852,94,758,574564
1514,"['boy', 'play', 'field']","['people', 'head', 'cover', 'scarf']",0.0,0,253,95,158,24964
1515,"['dog', 'run', 'grass']","['dog', 'run', 'snow']",2.200000047683716,2,2064,2091,-27,729
1516,"['boy', 'broken', 'arm', 'rest', 'bed']","['boy', 'broken', 'arm', 'sleep']",4.0,3,3124,4628,-1504,2262016
1517,"['boy', 'trick', 'skateboard']","['boy', 'trick', 'skateboard']",4.800000190734863,3,3125,5433,-2308,5326864
1518,"['dog', 'play', 'snow']","['dog', 'play', 'water']",2.5999999046325684,2,2045,2394,-349,121801
1519,"['little', 'girl', 'ribbon', 'hair', 'pick', 'nose']","['little', 'girl', 'purple', 'shirt', 'helmet', 'ride', 'soon']",1.2000000476837158,2,2046,1110,936,876096
1520,"['young', 'girl', 'go', 'tube', 'slide']","['young', 'girl', 'swinge', 'tire', 'swing']",1.7999999523162842,2,2049,1656,393,154449
1521,"['people', 'bicycle', 'racing', 'include', 'man', 'wheeled', 'bike']","['man', 'ride', 'wheel', 'wheelchair']",2.5999999046325684,1,877,2395,-1518,2304324
1522,"['group', 'people', 'wear', 'funny', 'ear']","['group', 'people', 'ride', 'race']",0.800000011920929,2,2050,752,1298,1684804
1523,"['dog', 'sherman', 'shirt', 'sleep', 'blanket']","['brown', 'dog', 'superman', 'shirt', 'lay', 'blue', 'blanket']",4.0,3,3127,4525,-1398,1954404
1524,"['white', 'brown', 'dog', 'run', 'grass']","['brown', 'white', 'dog', 'run', 'grass']",4.800000190734863,5,4931,5435,-504,254016
1525,"['brown', 'dog', 'rest', 'paw', 'lawton', 'keyboard']","['dog', 'sit', 'paw', 'lawton', 'computer']",3.799999952316284,3,3128,4165,-1037,1075369
1526,"['young', 'girl', 'glass', 'sit', 'hold', 'american', 'flag']","['girl', 'glass', 'look', 'american', 'flag', 'near', 'wooded', 'area']",2.5999999046325684,4,4571,2403,2168,4700224
1527,"['small', 'white', 'brown', 'dog', 'jump', 'horizontal', 'pole']","['brown', 'white', 'dog', 'jump', 'red', 'yellow', 'pole']",3.0,5,4927,2943,1984,3936256
1528,"['dog', 'run', 'grassy', 'area']","['dog', 'run', 'grassy', 'field']",4.800000190734863,3,3180,5438,-2258,5098564
1529,"['man', 'swinge', 'rope', 'water']","['man', 'warm', 'clothe', 'swinge', 'monkey', 'bar', 'night']",1.600000023841858,2,2062,1469,593,351649
1530,"['sign', 'man', 'sign', 'woman', 'sit', 'black', 'massage', 'chair']","['sign', 'man', 'woman', 'relax', 'massage', 'chair']",4.599999904632568,5,4889,5292,-403,162409
1531,"['girl', 'playing', 'pile', 'colourful', 'ball']","['little', 'girl', 'play', 'pit', 'colourful', 'ball']",5.0,3,3185,5519,-2334,5447556
1532,"['old', 'man', 'stand', 'outside', 'truck']","['woman', 'dress', 'green', 'roller', 'state', 'outside', 'event']",0.0,1,872,306,566,320356
1533,"['smile', 'man', 'effective', 'class']","['gentleman', 'smile', 'show', 'effective', 'sunglass']",4.599999904632568,2,2111,5282,-3171,10055241
1534,"['people', 'stand', 'sidewalk']","['people', 'sidewalk']",4.800000190734863,2,2112,5423,-3311,10962721
1535,"['white', 'dog', 'run', 'snow']","['white', 'bear', 'walk', 'snow', 'cover', 'ground', 'cast', 'shadow', 'snow']",1.399999976158142,2,2116,1319,797,635209
1536,"['young', 'boy', 'brown', 'jacket', 'play', 'snow']","['dog', 'play', 'snow']",1.2000000476837158,2,2119,1147,972,944784
1537,"['man', 'pick', 'big', 'rock']","['woman', 'pick', 'large', 'rock']",2.400000095367432,2,2123,2279,-156,24336
1538,"['white', 'brown', 'dog', 'run', 'grass']","['brown', 'white', 'dog', 'run', 'grass']",4.599999904632568,5,4842,5284,-442,195364
1539,"['carry', 'tool', 'box', 'sidewalk']","['woman', 'ride', 'blue', 'bicycle', 'park']",0.0,0,191,282,-91,8281
1540,"['man', 'wear', 't', 'shirt', 'say', 'gigolo', 'stand', 'counter', 'talk']","['man', 'wear', 'shirt', 'say', 'gigolo', 'stand', 'desk', 'area', 'camera']",3.400000095367432,6,5130,3486,1644,2702736
1541,"['tent', 'campfire', 'submit', 'forest']","['white', 'dog', 'beach', 'carry', 'stick', 'mouth']",0.0,0,192,288,-96,9216
1542,"['large', 'dog', 'run', 'grass']","['bridle', 'dog', 'run', 'grass']",4.199999809265137,3,3198,4781,-1583,2505889
1543,"['dog', 'swim', 'stick', 'mouth']","['dog', 'run', 'stick', 'mouth']",2.5999999046325684,3,3199,2414,785,616225
1544,"['man', 'play', 'fetch', 'brown', 'dog']","['woman', 'play', 'brown', 'dog']",2.3299999237060547,3,3201,2164,1037,1075369
1545,"['dog', 'run', 'sand', 'stick', 'mouth']","['dog', 'run', 'creek', 'stick', 'mouth']",3.5999999046325684,4,4522,3945,577,332929
1546,"['man', 'stand', 'water', 'near', 'waterfall']","['man', 'wage', 'water', 'watch', 'water', 'fall']",3.400000095367432,2,2093,3481,-1388,1926544
1547,"['dog', 'jump', 'catch', 'tennis', 'ball']","['red', 'dog', 'jump', 'catch', 'tennis', 'ball', 'mouth']",3.0,5,4876,2988,1888,3564544
1548,"['man', 'jump', 'water']","['man', 'air']",2.400000095367432,1,867,2280,-1413,1996569
1549,"['woman', 'black', 'shirt', 'stand', 'banana', 'fruit', 'stand']","['woman', 'wear', 'black', 'stand', 'pick', 'truck']",2.400000095367432,3,3160,2277,883,779689
1550,"['child', 'jump', 'swimming', 'pool']","['dog', 'jump', 'swimming', 'pool']",1.2000000476837158,3,3167,1131,2036,4145296
1551,"['little', 'boy', 'jump', 'chair']","['young', 'boy', 'jump', 'chair', 'house']",4.800000190734863,3,3169,5476,-2307,5322249
1552,"['girl', 'swe', 'long', 'wet', 'hair', 'lake']","['person', 'ride', 'dirt', 'bike']",0.0,0,194,344,-150,22500
1553,"['dog', 'play', 'shore']","['dog', 'play', 'snow']",2.799999952316284,2,2210,2689,-479,229441
1554,"['little', 'girl', 'walk', 'boardwalk', 'blue', 'dome', 'background']","['man', 'go', 'jump', 'bike', 'river', 'background']",0.0,1,865,325,540,291600
1555,"['woman', 'sit', 'bench', 'face', 'obscure', 'woman', 'carry', 'inflammable', 'tiger', 'woman', 'kidney', 'snow', 'white', 'costume']","['girl', 'sit', 'bench', 'hold', 'inflammable', 'tiger', 'girl', 'colourful', 'outfit']",2.200000047683716,4,4549,2012,2537,6436369
1556,"['guy', 'girl', 'smile', 'camera']","['dog', 'white', 'brown', 'run', 'field', 'grass']",0.0,0,196,312,-116,13456
1557,"['dog', 'swim', 'stick', 'mouth']","['dog', 'swim', 'water', 'stick', 'mouth']",5.0,4,4407,5532,-1125,1265625
1558,"['black', 'people', 'play', 'snow']","['black', 'people', 'frolic', 'snow']",5.0,3,3110,5557,-2447,5987809
1559,"['girl', 'hold', 'scar', 'movie', 'ulcer']","['girl', 'hold', 'sack', 'stand', 'field']",1.399999976158142,2,2330,1331,999,998001
1560,"['boy', 'run', 'beach', 'play', 'game']","['young', 'boy', 'young', 'man', 'run', 'beach', 'water']",3.200000047683716,3,3040,3114,-74,5476
1561,"['girl', 'wear', 'purple', 'sash', 'watch', 'skirt']","['group', 'girl', 'stand', 'wear', 'jean', 'skirt', 'sherman', 'shirt']",1.600000023841858,3,3041,1507,1534,2353156
1562,"['man', 'wear', 'grey', 'jacket', 'stand', 'street']","['boy', 'wear', 'blue', 'life', 'jacket', 'hold', 'green', 'boat']",0.6000000238418579,2,2301,624,1677,2812329
1563,"['brown', 'black', 'dog', 'jump', 'catch', 'red', 'ball']","['brown', 'black', 'dog', 'jump', 'red', 'ball']",5.0,6,5045,5503,-458,209764
1564,"['dog', 'run', 'leave']","['white', 'dog', 'run', 'ocean']",1.7999999523162842,2,2306,1745,561,314721
1565,"['white', 'black', 'dog', 'jump', 'pool']","['woman', 'black', 'apron', 'stand', 'mirror']",0.0,1,825,316,509,259081
1566,"['black', 'white', 'dog', 'carry', 'stick', 'mouth']","['black', 'white', 'dog', 'stick', 'paw']",3.0,4,4241,2931,1310,1716100
1567,"['deer', 'jump', 'fence']","['deer', 'jump', 'fence']",5.0,3,3058,5544,-2486,6180196
1568,"['little', 'girl', 'hold', 'wooden', 'stick']","['little', 'girl', 'swim', 'pool']",2.200000047683716,2,2377,1988,389,151321
1569,"['black', 'dog', 'jump', 'water']","['dog', 'walk', 'snow']",2.400000095367432,1,821,2286,-1465,2146225
1570,"['group', 'people', 'red', 'fire', 'truck']","['group', 'people', 'stand', 'red', 'fire', 'truck']",4.199999809265137,5,4986,4707,279,77841
1571,"['boy', 'jump', 'blue', 'pool', 'water']","['young', 'boy', 'jump', 'pool', 'belly']",3.400000095367432,3,3022,3680,-658,432964
1572,"['blonde', 'dog', 'catch', 'ball', 'mouth', 'snow']","['little', 'blonde', 'girl', 'sit', 'green', 'chair']",0.0,1,818,338,480,230400
1573,"['child', 'play', 'laugh', 'floor']","['child', 'play', 'floor']",3.799999952316284,3,3024,4153,-1129,1274641
1574,"['man', 'sit', 'fishing', 'pole', 'near', 'body', 'water']","['man', 'sit', 'rock', 'fold', 'deck', 'chair', 'fishing', 'pole']",3.400000095367432,4,4281,3617,664,440896
1575,"['woman', 'dog', 'stand', 'grass']","['man', 'carry', 'sign', 'stand', 'rain']",0.0,1,817,336,481,231361
1576,"['man', 'blue', 'shirt', 'run', 'stadium', 'field']","['man', 'wear', 'blue', 'hat', 'shirt', 'ride', 'white', 'horse']",1.0,3,3032,1032,2000,4000000
1577,"['black', 'dog', 'run', 'water']","['black', 'dog', 'run', 'water']",4.800000190734863,4,4277,5384,-1107,1225449
1578,"['child', 'jump', 'trampling']","['man', 'shed', 'orange', 'slide']",0.0,0,198,333,-135,18225
1579,"['large', 'brown', 'dog', 'crouch', 'grassy', 'field']","['brown', 'dog', 'run', 'field']",3.0,3,3034,2965,69,4761
1580,"['dog', 'run', 'grass']","['dog', 'run', 'snow']",2.200000047683716,2,2353,2040,313,97969
1581,"['sky', 'speed', 'snow']","['brown', 'dog', 'carry', 'frisbee', 'run', 'snow']",0.2000000029802322,1,814,384,430,184900
1582,"['people', 'play', 'golf', 'golf', 'course']","['people', 'golf', 'course', 'play', 'golf']",5.0,4,4268,5546,-1278,1633284
1583,"['boy', 'girl', 'play', 'beach']","['dog', 'play', 'wave', 'ball']",0.800000011920929,1,813,749,64,4096
1584,"['child', 'red', 'coat', 'lay', 'red', 'mat']","['toller', 'ready', 'climb', 'red', 'piece', 'equipment']",0.800000011920929,1,812,754,58,3364
1585,"['dog', 'play', 'grass']","['dog', 'play', 'grass']",5.0,3,3092,5497,-2405,5784025
1586,"['child', 'blue', 'white', 'team', 'uniform', 'chase', 'soccer', 'ball']","['young', 'boy', 'blue', 'soccer', 'uniform', 'chase', 'ball']",4.0,5,4957,4599,358,128164
1587,"['football', 'player', 'swinge', 'pitch']","['baseball', 'player', 'hit', 'ball']",2.799999952316284,1,810,2736,-1926,3709476
1588,"['man', 'kite', 'surge', 'away', 'camera']","['man', 'sky', 'surge', 'water']",2.799999952316284,2,2248,2748,-500,250000
1589,"['black', 'dog', 'run', 'grass']","['boy', 'run', 'green', 'grass']",1.0,2,2229,1101,1128,1272384
1590,"['little', 'boy', 'little', 'girl', 'play', 'outside']","['young', 'boy', 'young', 'girl', 'walk']",2.0,2,2213,1926,287,82369
1591,"['people', 'sit', 'end', 'dock']","['people', 'sit', 'dock']",4.199999809265137,3,3106,4729,-1623,2634129
1592,"['dog', 'yard']","['dog', 'stream']",2.0,1,816,1928,-1112,1236544
1593,"['man', 'case', 'dog', 'try', 'pass', 'barrier', 'enter', 'play', 'area']","['man', 'follow', 'black', 'white', 'dog', 'take', 'obstacle', 'course']",2.200000047683716,2,2224,1979,245,60025
1594,"['large', 'brown', 'white', 'dog', 'run', 'snow']","['gerard', 'dog', 'run', 'snowy', 'field']",4.0,2,2285,4597,-2312,5345344
1595,"['bloody', 'man', 'woman', 'pose', 'picture']","['man', 'woman', 'dress', 'warmly', 'pose', 'picture']",2.0,4,4224,1930,2294,5262436
1596,"['yellow', 'dog', 'play', 'grassy', 'area', 'near', 'flower']","['girl', 'play', 'swing']",0.4000000059604645,1,827,582,245,60025
1597,"['boy', 'play', 'noble', 'pool']","['boy', 'play', 'foam', 'noble', 'toy', 'pool']",4.599999904632568,4,4223,5305,-1082,1170724
1598,"['big', 'brown', 'dog', 'run', 'snow']","['brown', 'dog', 'run', 'grass']",2.0,3,3081,1912,1169,1366561
1599,"['young', 'boy', 'jump', 'pool', 'outstretched', 'arm']","['dog', 'jump', 'backward', 'pool']",1.2000000476837158,2,2546,1149,1397,1951609
1600,"['girl', 'hold', 'yellow', 'balloon', 'animal']","['child', 'hold', 'yellow', 'balloon']",4.0,3,2670,4411,-1741,3031081
1601,"['dog', 'share', 'toy', 'field', 'vegetation']","['snowboarder', 'air', 'snow']",0.1700000017881393,0,201,371,-170,28900
1602,"['blood', 'haired', 'lady', 'white', 'pose', 'camera']","['black', 'white', 'dog', 'run', 'mouth', 'open']",0.0,1,840,356,484,234256
1603,"['dog', 'run', 'field', 'chase', 'ball']","['child', 'run', 'grass']",0.2000000029802322,1,839,381,458,209764
1604,"['girl', 'sit', 'statue']","['blonde', 'girl', 'sit', 'statue']",3.799999952316284,3,2655,4144,-1489,2217121
1605,"['girl', 'orange', 'light', 'candle']","['girl', 'orange', 'shirt', 'light', 'candle']",4.0,4,4210,4595,-385,148225
1606,"['white', 'dog', 'run', 'field', 'yellow', 'flower']","['dog', 'red', 'collar', 'run', 'forest', 'middle', 'winter']",1.600000023841858,2,2284,1487,797,635209
1607,"['infant', 'sit', 'cot', 'reach', 'touch', 'face', 'old', 'boy']","['boy', 'ill', 'touch', 'face', 'toller']",2.200000047683716,3,2643,1983,660,435600
1608,"['dog', 'shake', 'water']","['dog', 'shake', 'water']",5.0,3,2689,5499,-2810,7896100
1609,"['young', 'boy', 'run', 'pavement']","['black', 'dog', 'run', 'edge', 'ocean']",0.5,1,835,609,226,51076
1610,"['young', 'child', 'side', 'orange', 'slide']","['little', 'boy', 'denis', 'overall', 'side', 'orange', 'slide']",3.670000076293945,3,2691,3986,-1295,1677025
1611,"['black', 'white', 'dog', 'run', 'red', 'white', 'pole']","['black', 'white', 'dog', 'living', 'room', 'stand', 'hind', 'leg']",1.600000023841858,3,2714,1486,1228,1507984
1612,"['individual', 'lose', 'skin', 'skin', 'sign']","['people', 'skin', 'stand', 'skin', 'sign']",4.400000095367432,2,2344,4967,-2623,6880129
1613,"['man', 'white', 'suit', 'walk', 'street', 'hold', 'newspaper']","['man', 'white', 'suit', 'walk', 'outside', 'carry', 'newspaper']",4.599999904632568,5,4840,5302,-462,213444
1614,"['black', 'dog', 'blue', 'collar', 'run', 'snow']","['black', 'dog', 'wear', 'blue', 'collar', 'run', 'snow']",5.0,6,5096,5495,-399,159201
1615,"['dog', 'run', 'camera']","['brown', 'white', 'dog', 'run', 'grass']",0.800000011920929,2,2357,826,1531,2343961
1616,"['boy', 'swinge', 'swing']","['girl', 'swing']",2.400000095367432,1,829,2303,-1474,2172676
1617,"['group', 'youngster', 'swim', 'lake', 'water']","['child', 'play', 'swim', 'water']",4.400000095367432,2,2376,4961,-2585,6682225
1618,"['blue', 'white', 'soccer', 'team', 'play']","['hopeless', 'woman', 'face', 'paint', 'cover', 'mud']",0.0,0,202,273,-71,5041
1619,"['brown', 'dog', 'catch', 'green', 'frisbee']","['brown', 'dog', 'wait', 'frisbee', 'come', 'catch']",3.799999952316284,4,4375,4147,228,51984
1620,"['black', 'white', 'dog', 'swim', 'large', 'green', 'lake']","['black', 'dog', 'run', 'fast', 'shallow', 'water']",2.200000047683716,2,2364,2035,329,108241
1621,"['large', 'black', 'dog', 'play', 'grassy', 'field']","['white', 'dog', 'run']",2.200000047683716,1,881,2032,-1151,1324801
1622,"['brown', 'black', 'dog', 'splint', 'snow']","['black', 'dog', 'run', 'quickly', 'ground']",2.799999952316284,2,2363,2746,-383,146689
1623,"['man', 'backpack', 'look', 'left']","['adult', 'male', 'wear', 'backpack', 'walk', 'look', 'left']",3.799999952316284,3,2808,4148,-1340,1795600
1624,"['elderly', 'man', 'blue', 'shirt', 'hold', 'piece', 'canvas', 'art']","['black', 'man', 'walk', 'building', 'big', 'city']",0.0,1,952,278,674,454276
1625,"['skinny', 'young', 'boy', 'play', 'sand', 'water']","['dog', 'shake', 'water']",0.4000000059604645,1,882,588,294,86436
1626,"['small', 'dog', 'run', 'obstacle', 'course']","['small', 'dog', 'jump', 'obstacle']",3.799999952316284,3,2799,4149,-1350,1822500
1627,"['brown', 'dog', 'run', 'wood']","['brown', 'dog', 'run', 'grass']",3.200000047683716,3,2798,3087,-289,83521
1628,"['group', 'people', 'stand', 'window', 'watch']","['group', 'people', 'stand', 'wait']",3.400000095367432,3,2730,3547,-817,667489
1629,"['dog', 'jump', 'barrier', 'agility', 'competition']","['dog', 'jump', 'obstacle', 'course', 'fence']",4.400000095367432,2,2321,5009,-2688,7225344
1630,"['people', 'race', 'ice', 'state']","['ice', 'state', 'round', 'corner']",3.200000047683716,2,2317,3085,-768,589824
1631,"['woman', 'contestant', 'walk', 'dog', 'dog']","['woman', 'walk', 'dog', 'dog']",4.800000190734863,3,2748,5345,-2597,6744409
1632,"['man', 'barge']","['man', 'lie', 'grass', 'long', 'hair', 'beard']",0.0,1,931,283,648,419904
1633,"['brown', 'dog', 'run', 'grass']","['brown', 'dog', 'run', 'grass']",4.800000190734863,4,4391,5383,-992,984064
1634,"['person', 'ride', 'bike', 'trail', 'wood']","['small', 'child', 'yellow', 'shirt', 'hold', 'arm', 'side']",0.4000000059604645,0,203,572,-369,136161
1635,"['woman', 'black', 'dress', 'smile', 'silver', 'truck']","['girl', 'wear', 'black', 'smile', 'silver', 'truck', 'background']",3.5999999046325684,4,4317,3974,343,117649
1636,"['dog', 'beach', 'near', 'ball']","['guy', 'go', 'lay', 'basketball', 'court']",0.6000000238418579,0,204,655,-451,203401
1637,"['dog', 'bound', 'brown', 'grass']","['dog', 'bind', 'grass']",2.5999999046325684,2,2461,2483,-22,484
1638,"['woman', 'play', 'young', 'boy', 'park']","['woman', 'kiss', 'play', 'park']",3.200000047683716,3,2732,3079,-347,120409
1639,"['dog', 'emerge', 'form', 'water', 'stick', 'mouth']","['dog', 'run', 'camera', 'stick', 'mouth']",2.400000095367432,3,2780,2232,548,300304
1640,"['dog', 'play', 'snow']","['boy', 'play', 'sand']",0.800000011920929,1,929,786,143,20449
1641,"['dog', 'carry', 'leash', 'mouth']","['fluffy', 'dog', 'carry', 'black', 'leash', 'mouth']",4.199999809265137,4,4337,4708,-371,137641
1642,"['man', 'jean', 'play', 'ball', 'woman', 'jeans', 'stand', 'nearby', 'look', 'away']","['man', 'tie', 'red', 'arm', 'band', 'man', 'arm', 'street']",0.0,1,927,335,592,350464
1643,"['sky', 'fall', 'snow']","['sky', 'fall', 'face', 'snow']",4.0,3,3770,4587,-817,667489
1644,"['dog', 'red', 'toy', 'mouth']","['brown', 'dog', 'carry', 'stick', 'mouth']",2.200000047683716,2,2538,2056,482,232324
1645,"['hockey', 'player', 'fight', 'ice']","['hockey', 'player', 'struggle', 'ice']",4.800000190734863,3,3749,5382,-1633,2666689
1646,"['barrier', 'play', 'wood', 'floor', 'home']","['supply', 'play', 'red', 'chew', 'toy', 'field']",1.600000023841858,1,933,1476,-543,294849
1647,"['dog', 'run', 'field']","['dog', 'play', 'field']",4.199999809265137,2,2396,4725,-2329,5424241
1648,"['man', 'gray', 'suit', 'lock', 'bicycle']","['man', 'woman', 'stand', 'city', 'street']",0.4000000059604645,1,926,459,467,218089
1649,"['man', 'black', 'leather', 'jacket', 'sleep', 'subway', 'car']","['man', 'black', 'leather', 'jacket', 'fall', 'asleep', 'public', 'transportation']",4.599999904632568,4,4307,5297,-990,980100
1650,"['dog', 'leap', 'hardly']","['dog', 'leap', 'hardly']",4.800000190734863,3,3648,5390,-1742,3034564
1651,"['man', 'set', 'electronic', 'equipment']","['dog', 'wrest', 'ground', 'snow']",0.0,0,205,343,-138,19044
1652,"['black', 'dog', 'walk', 'grass', 'stick', 'mouth']","['boy', 'hold', 'net', 'snake', 'close', 'ground']",0.0,0,206,313,-107,11449
1653,"['girl', 'run', 'dog', 'dry', 'field']","['grey', 'dog', 'dog', 'play', 'grassy', 'field']",2.200000047683716,2,2168,2047,121,14641
1654,"['dog', 'play', 'snow']","['black', 'dog', 'snow']",4.0,2,2063,4620,-2557,6538249
1655,"['dog', 'leap', 'dock', 'water']","['black', 'dog', 'leap', 'dock', 'water']",4.0,4,4378,4614,-236,55696
1656,"['group', 'old', 'man', 'walk', 'street']","['couple', 'walk', 'street']",2.0,2,2314,1935,379,143641
1657,"['dog', 'stand', 'snow', 'blue', 'fence']","['dog', 'play', 'shallow', 'rocky', 'shore']",2.200000047683716,1,923,2044,-1121,1256641
1658,"['black', 'white', 'dog', 'run', 'field']","['black', 'white', 'dog', 'run', 'grass']",4.800000190734863,4,4351,5370,-1019,1038361
1659,"['boy', 'black', 'wave', 'arm', 'people', 'field']","['man', 'black', 'shirt', 'roller', 'blaze', 'past', 'bench', 'city']",0.4000000059604645,1,922,482,440,193600
1660,"['elderly', 'woman', 'ride', 'bicycle', 'city', 'street']","['elderly', 'woman', 'walk', 'uphill', 'cross', 'street']",2.0,3,3714,1950,1764,3111696
1661,"['young', 'boy', 'munch', 'yellow', 'ball']","['small', 'dog', 'jump', 'yellow', 'beam']",0.4000000059604645,1,921,474,447,199809
1662,"['group', 'young', 'ballerina', 'dance', 'studio']","['group', 'young', 'lady', 'bikinis']",1.399999976158142,2,2341,1336,1005,1010025
1663,"['young', 'boy', 'white', 'dress', 'shirt', 'play', 'grassy', 'plain']","['woman', 'get', 'hair', 'salon']",0.0,0,207,315,-108,11664
1664,"['man', 'dog', 'play', 'tug', 'war']","['man', 'dance', 'colourful', 'wall']",0.4000000059604645,1,920,479,441,194481
1665,"['wet', 'child', 'shiver', 'towel', 'pool']","['wet', 'child', 'shiver', 'towel', 'pool']",4.599999904632568,5,4761,5289,-528,278784
1666,"['white', 'dog', 'run', 'beach']","['white', 'dog', 'run', 'beach']",5.0,4,4363,5548,-1185,1404225
1667,"['dog', 'run', 'sandy', 'beach']","['dog', 'walk', 'beach']",3.400000095367432,2,2263,3627,-1364,1860496
1668,"['man', 'hold', 'handle', 'water']","['man', 'hold', 'candle', 'air']",3.200000047683716,2,2255,3105,-850,722500
1669,"['white', 'dog', 'walk', 'snow']","['black', 'dog', 'walk', 'snow']",3.0,3,3772,2942,830,688900
1670,"['white', 'brown', 'dog', 'run', 'grass']","['dog', 'run', 'grass']",3.200000047683716,3,3766,3111,655,429025
1671,"['boy', 'go', 'inflammable', 'slide']","['boy', 'red', 'side', 'inflammable', 'ride']",3.799999952316284,2,2246,4155,-1909,3644281
1672,"['dog', 'play', 'ball', 'puddle']","['dog', 'stand', 'puddle', 'yellow', 'tennis', 'ball']",3.799999952316284,3,3342,4156,-814,662596
1673,"['dog', 'play', 'water']","['dog', 'run', 'snow']",1.399999976158142,1,934,1334,-400,160000
1674,"['dog', 'play', 'snow']","['kiss', 'play', 'dog']",1.2000000476837158,2,2352,1108,1244,1547536
1675,"['girl', 'bend', 'beach']","['girl', 'bend', 'beach']",4.800000190734863,3,3350,5361,-2011,4044121
1676,"['dog', 'play', 'fetch', 'snow']","['dog', 'play', 'grass']",2.200000047683716,2,2348,1976,372,138384
1677,"['suffer', 'ride', 'small', 'wave']","['suffer', 'perform', 'trick', 'wave']",3.5999999046325684,2,2323,3958,-1635,2673225
1678,"['people', 'walk', 'beach', 'sunset']","['people', 'walk', 'shore', 'sunset']",5.0,3,3358,5550,-2192,4804864
1679,"['supply', 'play', 'grass']","['dog', 'wrest', 'grass']",4.0,1,936,4607,-3671,13476241
1680,"['young', 'girl', 'sit', 'santa', 'lap']","['little', 'girl', 'sit', 'santa', 'lap']",4.800000190734863,4,4273,5350,-1077,1159929
1681,"['black', 'white', 'dog', 'run', 'mouth', 'open']","['black', 'white', 'dog', 'swim', 'blue', 'water']",2.200000047683716,3,3236,1972,1264,1597696
1682,"['young', 'boy', 'jump', 'air', 'beach']","['boy', 'jump', 'air', 'beach']",4.800000190734863,4,4262,5396,-1134,1285956
1683,"['man', 'tuxedo', 'walk', 'step']","['man', 'tuxedo', 'walk', 'set', 'step']",5.0,4,4239,5554,-1315,1729225
1684,"['red', 'short', 'white', 'shirt', 'kick', 'soccer', 'ball']","['black', 'dog', 'stand', 'surf', 'hold', 'red', 'rubber', 'ball']",0.0,2,2203,322,1881,3538161
1685,"['man', 'dog', 'rocky', 'seashore']","['dog', 'stand', 'rock', 'water']",4.800000190734863,1,950,5458,-4508,20322064
1686,"['grown', 'dog', 'splash', 'water']","['dog', 'splash', 'water']",2.400000095367432,3,3291,2269,1022,1044484
1687,"['smile', 'woman', 'beach', 'bury', 'seated']","['girl', 'cowboy', 'hat', 'sheep', 'leash']",1.0,0,190,899,-709,502681
1688,"['dog', 'big', 'ear', 'hold', 'small', 'stick', 'mouth']","['puppy', 'big', 'ear', 'chew', 'stick']",3.799999952316284,3,3304,4158,-854,729316
1689,"['large', 'brown', 'dog', 'jump', 'tall', 'grass']","['girl', 'wear', 'blue', 'shirt', 'run', 'science', 'center']",0.0,0,208,311,-103,10609
1690,"['dog', 'fight', 'snow']","['dog', 'play', 'snow']",2.5999999046325684,2,2199,2398,-199,39601
1691,"['brown', 'dog', 'middle', 'line', 'dog', 'chase', 'dirty', 'tennis', 'ball', 'dirt']","['white', 'dog', 'brown', 'dog', 'chase', 'ball']",2.799999952316284,4,4250,2691,1559,2430481
1692,"['grey', 'hound', 'active', 'grassy', 'field']","['bunch', 'bite', 'race', 'track']",0.0,0,189,327,-138,19044
1693,"['people', 'race', 'sidecar', 'motorcycle', 'mud']","['dog', 'carry', 'long', 'stick', 'mouth']",0.0,0,187,328,-141,19881
1694,"['man', 'sit', 'rocky', 'mountain']","['person', 'stick', 'head', 'tent', 'mountain']",2.400000095367432,1,944,2274,-1330,1768900
1695,"['man', 'stand', 'boat', 'pull', 'boat', 'close', 'bamboo', 'stick']","['man', 'black', 'hat', 'standing', 'brick', 'wall', 'sign']",0.0,1,943,341,602,362404
1696,"['man', 'play', 'white', 'guitar']","['man', 'play', 'white', 'guitar', 'singing']",3.200000047683716,4,4251,3187,1064,1132096
1697,"['person', 'skijore', 'dog', 'mountain']","['brown', 'dog', 'play', 'ball', 'water']",0.0,1,941,340,601,361201
1698,"['shortness', 'young', 'people', 'play', 'water']","['lot', 'people', 'play', 'water', 'beach']",2.400000095367432,3,3294,2304,990,980100
1699,"['close', 'hummingbird']","['close', 'hummingbird', 'flying']",3.5999999046325684,2,2194,3942,-1748,3055504
1700,"['woman', 'black', 'dress', 'walk', 'street']","['woman', 'watch', 'dog', 'jump', 'stair']",0.800000011920929,1,939,872,67,4489
1701,"['man', 'woman', 'look', 'camera']","['man', 'woman', 'laugh']",2.3299999237060547,2,2193,2166,27,729
1702,"['brown', 'dog', 'run', 'dirty', 'muddy', 'grass']","['large', 'brown', 'dog', 'run', 'outside', 'dirt']",3.5999999046325684,3,3298,3944,-646,417316
1703,"['dog', 'pull', 'man', 'bicycle', 'snow']","['dog', 'pull', 'man', 'type', 'bike', 'snow']",5.0,4,4253,5505,-1252,1567504
1704,"['baby', 'red', 'hat', 'sit', 'strolled', 'hold', 'doll']","['man', 'gray', 'shirt', 'sit', 'field', 'flower']",0.0,1,937,337,600,360000
1705,"['child', 'play', 'hay', 'outdoor', 'throw', 'camera', 'lens']","['young', 'child', 'play', 'hay', 'throw', 'camera']",4.800000190734863,5,4731,5478,-747,558009
1706,"['climber', 'stand', 'rock', 'face', 'pink', 'rope']","['child', 'run', 'snow', 'fence', 'background']",0.0,0,171,330,-159,25281
1707,"['black', 'dog', 'wear', 'orange', 'collar', 'entangle', 'fishing', 'wire']","['black', 'dog', 'wear', 'red', 'collar', 'shake', 'water']",1.7999999523162842,4,4254,1755,2499,6245001
1708,"['dog', 'play', 'dirt']","['dancer', 'lose', 'camera', 'red', 'white', 'dress']",0.0,0,172,329,-157,24649
1709,"['golden', 'dog', 'run', 'grass']","['large', 'beige', 'dog', 'run', 'grass']",3.400000095367432,3,3303,3518,-215,46225
1710,"['dog', 'run', 'grass']","['dog', 'run', 'grass']",4.800000190734863,3,3280,5473,-2193,4809249
1711,"['man', 'red', 'short', 'walk', 'rock', 'river', 'carry', 'stick']","['man', 'walk', 'rock', 'water', 'flow']",3.400000095367432,3,3278,3521,-243,59049
1712,"['rowing', 'boat']","['man', 'trick', 'skateboard']",0.0,0,173,308,-135,18225
1713,"['dog', 'run', 'racetrack']","['dog', 'round', 'bend', 'racetrack']",4.800000190734863,2,2139,5467,-3328,11075584
1714,"['black', 'brown', 'dog', 'walk', 'snow', 'near', 'building']","['old', 'man', 'stand', 'outside', 'old', 'board', 'building']",0.800000011920929,1,898,758,140,19600
1715,"['dog', 'jump', 'swimming', 'pool', 'duck']","['dog', 'jump', 'swimming', 'pool']",3.400000095367432,4,4259,3540,719,516961
1716,"['dog', 'run', 'forest', 'winter', 'time']","['dog', 'run', 'lot', 'twig']",3.200000047683716,2,2136,3180,-1044,1089936
1717,"['girl', 'play', 'image', 'big', 'screen']","['girl', 'hold', 'umbrella', 'back', 'camera']",0.4000000059604645,1,896,571,325,105625
1718,"['people', 'run', 'race', 'street']","['puppy', 'run', 'street']",1.0,2,2135,1008,1127,1270129
1719,"['man', 'swimming', 'trunk', 'stand', 'rock']","['man', 'gray', 'shirt', 'limb', 'large', 'rock', 'wall']",1.0,2,2134,1018,1116,1245456
1720,"['white', 'dog', 'walk', 'snow']","['dog', 'black', 'collar', 'barking', 'snow']",2.0,2,2133,1893,240,57600
1721,"['woman', 'wear', 'pink', 'shirt', 'jump', 'air', 'arm', 'leg', 'spread', 'side']","['man', 'wear', 'suspend', 'sunglasse', 'leap', 'air', 'arm', 'leg', 'spread']",2.400000095367432,5,4733,2278,2455,6027025
1722,"['dog', 'run', 'grass']","['dog', 'run', 'brush']",2.799999952316284,2,2130,2722,-592,350464
1723,"['dog', 'run', 'sand']","['dog', 'run', 'water']",2.799999952316284,2,2145,2655,-510,260100
1724,"['woman', 'attempt', 'ride', 'small', 'wave']","['man', 'woman', 'sit', 'outside', 'sun']",0.0,1,892,272,620,384400
1725,"['black', 'white', 'dog', 'swim', 'river']","['black', 'man', 'dog', 'beach']",0.6000000238418579,2,2147,678,1469,2157961
1726,"['standing', 'jagged', 'rock', 'near', 'ocean']","['man', 'stand', 'rock', 'overlook', 'ocean']",4.599999904632568,2,2148,5281,-3133,9815689
1727,"['girl', 'black', 'blue', 'wet', 'suit', 'surge']","['woman', 'wear', 'black', 'blue', 'stripe', 'suit', 'surge', 'wave']",4.400000095367432,4,4348,5010,-662,438244
1728,"['woman', 'lead', 'dog', 'obstacle', 'course']","['woman', 'lead', 'small', 'dog', 'obstacle', 'course']",4.599999904632568,5,4734,5280,-546,298116
1729,"['dog', 'beach']","['dog', 'walk', 'beach']",2.400000095367432,2,2163,2275,-112,12544
1730,"['young', 'boy', 'stand', 'gray', 'tile', 'area']","['young', 'boy', 'practice', 'rate', 'grm']",1.0,2,2162,970,1192,1420864
1731,"['dog', 'run', 'food', 'mouth']","['dog', 'run', 'yellow', 'ball', 'mouth']",2.200000047683716,3,3265,2123,1142,1304164
1732,"['dog', 'run', 'beach']","['dog', 'run', 'beach']",4.800000190734863,3,3267,5446,-2179,4748041
1733,"['black', 'white', 'dog', 'swim', 'pool']","['black', 'white', 'dog', 'run', 'mouth']",2.0,3,3269,1894,1375,1890625
1734,"['dog', 'head', 'inside', 'red', 'green', 'gift', 'bag']","['pet', 'playfully', 'investigate', 'content', 'gift', 'bag']",3.799999952316284,2,2154,4162,-2008,4032064
1735,"['yellow', 'skirt', 'man', 'wear', 'golden', 'sun', 'mask']","['man', 'yellow', 'shirt', 'wear', 'gold', 'sun', 'shape', 'mask']",5.0,5,4732,5524,-792,627264
1736,"['man', 'call', 'sheer', 'rock', 'face', 'rope', 'support']","['young', 'man', 'ski', 'jump', 'purple', 'board']",0.4000000059604645,1,885,545,340,115600
1737,"['child', 'hand', 'head']","['little', 'boy', 'stand', 'hand', 'head']",4.199999809265137,2,2152,4763,-2611,6817321
1738,"['man', 'wear', 'orange', 'vest', 'can', 'blue', 'water']","['man', 'orange', 'jacket', 'raise', 'hand', 'sky', 'sand']",1.7999999523162842,2,2151,1714,437,190969
1739,"['old', 'man', 'black', 'trench', 'coat', 'stand', 'marketplace']","['baby', 'wear', 'red', 'shirt', 'walk', 'place']",1.2000000476837158,0,176,1139,-963,927369
1740,"['man', 'climb', 'cliff', 'face']","['man', 'limb', 'sheer', 'cliff', 'face']",4.800000190734863,3,3275,5437,-2162,4674244
1741,"['girl', 'panama', 'part', 'appear', 'dance']","['girl', 'baseball', 'cap', 'eat', 'snack', 'outside']",0.6000000238418579,1,883,719,164,26896
1742,"['white', 'brown', 'dog', 'play', 'black', 'toy']","['white', 'brown', 'dog', 'play', 'tug', 'o', 'war']",3.400000095367432,4,4553,3527,1026,1052676
1743,"['boy', 'play', 'baseball']","['man', 'play', 'baseball']",3.0,2,2378,2941,-563,316969
1744,"['boy', 'wear', 'red', 'shirt', 'run', 'grass', 'furry', 'dog']","['sport', 'fan', 'wear', 'face', 'paint', 'stand']",0.0,1,907,354,553,305809
1745,"['black', 'dog', 'retrieve', 'snow']","['skateboarder', 'jump', 'street']",0.0,0,177,365,-188,35344
1746,"['smile', 'man', 'baby', 'girl', 'lose', 'photo']","['smile', 'man', 'hold', 'small', 'child', 'wear', 'pink', 'red']",3.200000047683716,2,2618,3172,-554,306916
1747,"['dog', 'jump', 'frisbee', 'snow']","['dog', 'jump', 'snow']",3.200000047683716,3,3536,3193,343,117649
1748,"['brown', 'white', 'dog', 'pink', 'collar', 'bark', 'brown', 'dog', 'blue', 'collar', 'snow']","['dog', 'red', 'collar', 'bear', 'tooth', 'dog', 'blue', 'collar']",3.400000095367432,3,3539,3640,-101,10201
1749,"['brown', 'dog', 'bite']","['brown', 'dog', 'bite', 'sand']",4.199999809265137,3,3540,4739,-1199,1437601
1750,"['skateboarder', 'attempt', 'trick', 'low', 'wall']","['boy', 'skateboard', 'trick', 'railing']",4.0,1,900,4526,-3626,13147876
1751,"['young', 'girl', 'lip', 'water']","['young', 'girl', 'wear', 'purple', 'run', 'water']",2.799999952316284,3,3541,2740,801,641601
1752,"['snowboarder', 'ride', 'snowboard', 'railing', 'flight', 'step']","['boy', 'grind', 'skateboard', 'concrete', 'wall']",0.800000011920929,0,179,757,-578,334084
1753,"['woman', 'man', 'hat', 'socialize', 'outside']","['young', 'woman', 'knit', 'cap', 'stand', 'wall', 'coming', 'dizzy']",1.399999976158142,1,912,1372,-460,211600
1754,"['small', 'boy', 'bathroom', 'sit', 'metal', 'chair']","['boy', 'robe', 'sit', 'chair']",4.199999809265137,3,3542,4744,-1202,1444804
1755,"['black', 'dog', 'run', 'snow']","['black', 'pit', 'bull', 'dog', 'run', 'dirt']",2.200000047683716,3,3544,2073,1471,2163841
1756,"['group', 'teenager', 'dance', 'wooden', 'floor']","['group', 'people', 'dark', 'color', 'clothing', 'line', 'dancing', 'wooden', 'floor']",3.400000095367432,3,3547,3533,14,196
1757,"['young', 'boy', 'ride', 'bike']","['young', 'girl', 'lay', 'blue', 'inflammable', 'toy']",0.4000000059604645,1,910,511,399,159201
1758,"['black', 'dog', 'run', 'snow']","['black', 'dog', 'run', 'beach']",1.7999999523162842,3,3548,1654,1894,3587236
1759,"['dog', 'snow', 'fence']","['dog', 'drink', 'water', 'lake']",1.0,1,915,956,-41,1681
1760,"['girl', 'run', 'river', 'bank', 'black', 'dog']","['little', 'boy', 'pet', 'tiger', 'lay']",0.2000000029802322,0,181,417,-236,55696
1761,"['teenage', 'girl', 'run', 'beach', 'shouting', 'old', 'man', 'walk']","['young', 'child', 'run', 'shore', 'beach']",1.7999999523162842,2,2602,1658,944,891136
1762,"['brown', 'white', 'dog', 'walk', 'man', 'skateboard']","['blood', 'child', 'lay', 'branch', 'tree', 'green', 'field']",0.0,0,182,98,84,7056
1763,"['ride', 'surfboard', 'wave']","['man', 'black', 'surfboard', 'ride', 'wave']",4.0,3,3550,4547,-997,994009
1764,"['man', 'red', 'shirt', 'climb', 'mountain']","['man', 'climb', 'mountain']",4.199999809265137,3,3551,4747,-1196,1430416
1765,"['man', 'ride', 'motorcycle', 'wear', 'black', 'uniform']","['white', 'motorcycle', 'ride', 'race', 'track']",1.399999976158142,2,2564,1369,1195,1428025
1766,"['black', 'dog', 'swim', 'river']","['black', 'dog', 'dig', 'snow']",1.2000000476837158,2,2561,1114,1447,2093809
1767,"['man', 'woman', 'smile']","['man', 'woman', 'laugh']",3.200000047683716,2,2559,3206,-647,418609
1768,"['man', 'stand', 'rock', 'mountain', 'watch', 'sun', 'set']","['man', 'stand', 'mountain', 'watch', 'sunset']",4.800000190734863,4,4564,5431,-867,751689
1769,"['little', 'girl', 'play', 'trampling']","['little', 'boy', 'play', 'playground']",1.399999976158142,2,2551,1365,1186,1406596
1770,"['girl', 'jump', 'high', 'air']","['dog', 'muscle', 'grass', 'near', 'lake']",0.2000000029802322,0,183,408,-225,50625
1771,"['woman', 'hold', 'black', 'purse', 'smoke', 'cigarette']","['woman', 'black', 'bag', 'smoke', 'cigarette']",4.800000190734863,4,4566,5358,-792,627264
1772,"['dog', 'run', 'grass']","['brown', 'dog', 'run', 'grass']",4.199999809265137,3,3532,4750,-1218,1483524
1773,"['man', 'long', 'hair', 'look', 'camera']","['woman', 'stand', 'wall', 'near', 'video', 'camera']",1.0,1,901,940,-39,1521
1774,"['grown', 'dog', 'run', 'grass']","['dog', 'run', 'grass']",4.0,3,3531,4565,-1034,1069156
1775,"['people', 'wear', 'hat', 'sit', 'look', 'camera']","['man', 'wear', 'blue', 'shirt', 'make', 'crouch', 'face']",0.0,1,809,85,724,524176
1776,"['girl', 'play', 'people', 'flower']","['young', 'girl', 'wear', 'skirt', 'play', 'garden']",3.200000047683716,2,2548,3202,-654,427716
1777,"['girl', 'pink', 'shirt', 'sprawl', 'limb', 'impair']","['man', 'dress', 'santa', 'suit', 'climb', 'large', 'concrete', 'building']",0.0,0,184,99,85,7225
1778,"['little', 'girl', 'red', 'shirt', 'pull', 'kite']","['girl', 'red', 'shirt', 'take', 'picture', 'phone']",1.399999976158142,3,3510,1358,2152,4631104
1779,"['child', 'slide', 'snow']","['sleeping', 'street']",0.0,0,185,72,113,12769
1780,"['dog', 'play', 'water']","['dog', 'swim', 'water']",4.199999809265137,2,2574,4755,-2181,4756761
1781,"['white', 'dog', 'run', 'sand']","['white', 'dog', 'run', 'sand']",5.0,4,4555,5539,-984,968256
1782,"['little', 'girl', 'hand', 'air', 'sit', 'man', 'lay', 'blanket']","['kid', 'run', 'opposite', 'direction', 'play', 'game']",0.2000000029802322,0,186,421,-235,55225
1783,"['red', 'white', 'race', 'car', 'race', 'dirt', 'racetrack']","['person', 'ride', 'dirt', 'bike', 'race', 'dirt', 'track']",1.399999976158142,2,2600,1356,1244,1547536
1784,"['black', 'white', 'dog', 'run', 'cow', 'field']","['large', 'black', 'white', 'dog', 'run', 'ocean', 'water']",2.200000047683716,4,4543,2102,2441,5958481
1785,"['man', 'straw', 'hat', 'shade', 'phone', 'walk', 'busy', 'sidewalk']","['man', 'lie', 'street', 'head', 'shoulder', 'marked', 'car', 'pack']",0.6000000238418579,1,711,665,46,2116
1786,"['man', 'messenger', 'bag', 'gray', 'tile', 'wall']","['red', 'jacket', 'stand', 'lighthorse']",0.800000011920929,0,210,825,-615,378225
1787,"['dog', 'swim', 'water']","['dog', 'swim', 'water']",3.200000047683716,3,3516,3198,318,101124
1788,"['little', 'white', 'curly', 'haired', 'dog', 'run', 'pavement', 'stick', 'mouth']","['white', 'curly', 'haired', 'dog', 'run', 'stick', 'mouth']",4.599999904632568,7,5349,5312,37,1369
1789,"['blonde', 'woman', 'wear', 'black', 'american', 'flag', 'tartar', 'cap']","['red', 'haired', 'woman', 'wear', 'black', 'beset', 'adorn', 'american', 'flag']",2.799999952316284,5,4753,2734,2019,4076361
1790,"['person', 'hold', 'net', 'stand', 'water']","['black', 'woman', 'black', 'child', 'sit', 'thatched', 'tent']",0.6000000238418579,0,211,690,-479,229441
1791,"['woman', 'red', 'tracksuit', 'squeeze', 'lemon', 'press']","['young', 'woman', 'pink', 'hood', 'take', 'picture']",0.4000000059604645,1,708,558,150,22500
1792,"['man', 'walk', 'dog', 'leash', 'street']","['man', 'walk', 'dog', 'city']",4.199999809265137,3,3520,4759,-1239,1535121
1793,"['dog', 'run', 'snow']","['dog', 'run', 'dirt']",2.200000047683716,2,2577,2095,482,232324
1794,"['small', 'boy', 'play', 'snow']","['brown', 'white', 'dog', 'play', 'snow']",1.600000023841858,2,2578,1563,1015,1030225
1795,"['woman', 'blue', 'shirt', 'short', 'sit', 'table']","['smile', 'young', 'woman', 'tourquoise', 'shirt', 'banana', 'pose', 'table', 'outdoor']",3.200000047683716,3,3523,3196,327,106929
1796,"['white', 'dog', 'run', 'snow']","['dog', 'run', 'snow']",3.200000047683716,3,3524,3171,353,124609
1797,"['black', 'dog', 'run', 'snow']","['race', 'car', 'driver', 'drive', 'car', 'mud']",0.0,0,233,129,104,10816
1798,"['dog', 'wear', 'green', 'sweeter', 'backpack', 'walk', 'snow']","['small', 'dog', 'wear', 'green', 'sweeter', 'backpack', 'walk', 'snow']",4.400000095367432,7,5326,5016,310,96100
1799,"['group', 'people', 'sit', 'desk']","['group', 'girl', 'beach']",0.6000000238418579,1,703,684,19,361
1800,"['dog', 'run', 'field']","['dog', 'run', 'grassy', 'field']",2.799999952316284,3,3526,2672,854,729316
1801,"['man', 'woman', 'hand', 'chin', 'stand', 'christmas', 'tree']","['man', 'white', 'beard', 'blue', 'cap', 'stand', 'doorway', 'workshop']",0.4000000059604645,2,2583,562,2021,4084441
1802,"['black', 'white', 'dog', 'stick', 'paw']","['black', 'dog', 'white', 'dog', 'stand', 'snow']",1.2000000476837158,3,3529,1124,2405,5784025
1803,"['white', 'dog', 'run', 'snow']","['black', 'white', 'dog', 'run', 'grass']",1.399999976158142,3,3545,1349,2196,4822416
1804,"['man', 'skin', 'snow', 'cover', 'hill', 'mountain', 'background']","['dog', 'enjoy', 'rome', 'water', 'mountain', 'sand', 'background']",0.6000000238418579,2,2591,683,1908,3640464
1805,"['man', 'bike', 'nest', 'river']","['man', 'bike', 'high', 'jump']",1.2000000476837158,2,2593,1145,1448,2096704
1806,"['sky', 'go', 'snowy', 'hill']","['brown', 'dog', 'lay', 'snow']",0.4000000059604645,0,234,526,-292,85264
1807,"['dog', 'run', 'grass']","['dog', 'run', 'dirt']",3.5999999046325684,2,2596,3953,-1357,1841449
1808,"['man', 'spray', 'fluid', 'long', 'beach']","['guy', 'sit', 'bike', 'wheel', 'air']",0.6000000238418579,0,235,693,-458,209764
1809,"['person', 'red', 'vest', 'touch', 'blue', 'ice', 'state', 'person']","['lady', 'fasten', 'ice', 'state', 'snow']",2.200000047683716,2,2597,2129,468,219024
1810,"['girl', 'ounce', 'upside', 'head', 'trampling']","['girl', 'bound', 'head', 'trampling']",4.800000190734863,3,3588,5420,-1832,3356224
1811,"['woman', 'stand', 'tree', 'smile']","['man', 'walk', 'tree', 'city', 'skyline']",2.0,1,717,1954,-1237,1530169
1812,"['boy', 'lip', 'swimming', 'pool']","['boy', 'wear', 'red', 'blue', 'swim', 'trunk', 'jump', 'head', 'swimming', 'pool']",2.400000095367432,3,3591,2300,1291,1666681
1813,"['little', 'boy', 'cover', 'bubble']","['child', 'stand', 'pool', 'cover', 'foam', 'bubble']",4.199999809265137,2,2550,4757,-2207,4870849
1814,"['boy', 'look', 'girl', 'girl', 'ignore']","['boy', 'diving', 'pool', 'couple', 'watch']",0.2000000029802322,1,732,383,349,121801
1815,"['black', 'dog', 'blue', 'collar', 'run', 'snow']","['black', 'dog', 'red', 'collar', 'play', 'snow']",3.200000047683716,4,4600,3143,1457,2122849
1816,"['bird', 'sit', 'tree']","['bird', 'sit', 'leaflet', 'tree']",3.799999952316284,3,3594,4169,-575,330625
1817,"['brown', 'dog', 'chess', 'orange', 'ball']","['dog', 'orange', 'ball', 'mouth']",4.0,3,3595,4680,-1085,1177225
1818,"['brown', 'dog', 'jump', 'air', 'catch', 'ball']","['young', 'woman', 'jump', 'air', 'catch', 'ball']",0.6000000238418579,4,4592,668,3924,15397776
1819,"['child', 'walk', 'picnic', 'table']","['boy', 'hope', 'picnic', 'table', 'park']",3.200000047683716,2,2562,3142,-580,336400
1820,"['dog', 'snow']","['dog', 'snow']",3.0,2,2563,3007,-444,197136
1821,"['salvation', 'run', 'beach']","['salvation', 'run', 'beach']",4.800000190734863,3,3600,5460,-1860,3459600
1822,"['dog', 'run', 'snow']","['dog', 'run', 'snow']",5.0,3,3602,5496,-1894,3587236
1823,"['black', 'dog', 'run', 'grass']","['dog', 'run', 'grassy', 'field']",2.0,2,2568,1963,605,366025
1824,"['man', 'red', 'black', 'hit', 'soccer', 'ball', 'head']","['man', 'red', 'stripe', 'soccer', 'shirt', 'head', 'ball']",3.5999999046325684,5,4690,3951,739,546121
1825,"['brown', 'dog', 'walk', 'grass']","['dog', 'case', 'tree']",1.2000000476837158,1,726,1140,-414,171396
1826,"['woman', 'place', 'baby', 'skateboard', 'beach']","['woman', 'hold', 'small', 'baby', 'skateboard', 'beach']",4.599999904632568,4,4588,5223,-635,403225
1827,"['black', 'dog', 'bite', 'light', 'brown', 'dog', 'ear', 'playful', 'manner']","['black', 'dog', 'playfully', 'bit', 'dog', 'living', 'room', 'set']",4.0,2,2632,4677,-2045,4182025
1828,"['eagle', 'walk', 'beach', 'watering']","['eagle', 'walk', 'calm', 'shore']",4.400000095367432,2,2635,4963,-2328,5419584
1829,"['black', 'white', 'dog', 'run', 'grass']","['black', 'white', 'dog', 'run', 'grass']",5.0,5,4689,5537,-848,719104
1830,"['dog', 'run', 'snow', 'tennis', 'ball']","['boy', 'stung', 'air', 'bicycle']",0.0,0,237,105,132,17424
1831,"['black', 'dog', 'walk', 'grass', 'stick', 'mouth']","['black', 'dog', 'run', 'grass', 'toy', 'mouth']",3.200000047683716,4,4591,3132,1459,2128681
1832,"['man', 'walk', 'policeman', 'stand', 'crossway', 'city', 'street']","['policeman', 'stand', 'crossway', 'city']",3.0,4,4516,3064,1452,2108304
1833,"['black', 'dog', 'white', 'dog', 'play', 'street']","['black', 'dog', 'white', 'dog', 'play', 'street']",4.599999904632568,5,4700,5201,-501,251001
1834,"['large', 'black', 'white', 'dog', 'swim', 'water']","['black', 'white', 'dog', 'stick', 'muddy', 'water']",3.5999999046325684,4,4488,3950,538,289444
1835,"['little', 'boy', 'clown', 'commander', 'head']","['boy', 'metal', 'commander', 'head']",4.199999809265137,3,3582,4751,-1169,1366561
1836,"['construction', 'worker', 'sit', 'beam', 'take', 'break']","['man', 'put', 'shirt', 'near', 'elevator']",0.0,0,238,104,134,17956
1837,"['man', 'woman', 'laugh']","['man', 'woman', 'kiss']",1.2000000476837158,2,2608,1120,1488,2214144
1838,"['black', 'brown', 'white', 'dog', 'run', 'field']","['white', 'brown', 'dog', 'run', 'field']",2.8299999237060547,5,4706,2752,1954,3818116
1839,"['child', 'play', 'swimming', 'pool', 'adult', 'man', 'watch']","['child', 'play', 'pool', 'adult', 'look']",4.599999904632568,4,4447,5204,-757,573049
1840,"['kiss', 'splash', 'water']","['dog', 'play', 'bed']",0.0,0,240,29,211,44521
1841,"['brown', 'white', 'dog', 'walk', 'shallow', 'water']","['white', 'brown', 'dog', 'appear', 'walk', 'water']",4.599999904632568,5,4702,5205,-503,253009
1842,"['woman', 'read', 'public', 'transportation']","['man', 'fall', 'asleep', 'public', 'transportation']",1.600000023841858,2,2615,1587,1028,1056784
1843,"['bulldog', 'run', 'grassy', 'park', 'people', 'stand', 'background']","['dog', 'run', 'large', 'body', 'water', 'cause', 'splash']",1.7999999523162842,1,718,1665,-947,896809
1844,"['young', 'boy', 'ride', 'bike', 'brick', 'road']","['person', 'trick', 'bike', 'camp', 'surround', 'tree']",2.200000047683716,1,699,1992,-1293,1671849
1845,"['young', 'man', 'skateboard', 'state', 'park']","['boy', 'blue', 't', 'shirt', 'airborne', 'skateboard', 'state', 'park']",3.799999952316284,3,3566,4142,-576,331776
1846,"['girl', 'jump', 'rope', 'sidewalk', 'near', 'parking', 'garage']","['girl', 'jump', 'rope', 'sidewalk', 'parking', 'garage', 'left']",4.400000095367432,6,5215,4975,240,57600
1847,"['person', 'water', 'beach', 'sun', 'set']","['person', 'surfboard', 'water']",3.0,2,2621,3070,-449,201601
1848,"['dog', 'jump', 'impair', 'catch', 'frisbee']","['brown', 'dog', 'jump', 'pink', 'frisbee']",4.0,3,3568,4644,-1076,1157776
1849,"['dog', 'return', 'play', 'toy', 'master']","['dog', 'race', 'snow']",1.0,1,698,998,-300,90000
1850,"['female', 'jump', 'swing']","['girl', 'jump', 'swing']",4.599999904632568,2,2623,5206,-2583,6671889
1851,"['woman', 'young', 'girl', 'pose', 'bear', 'statue', 'store']","['man', 'jersey', 'stand', 'large', 'crowd']",0.6000000238418579,0,241,723,-482,232324
1852,"['shortness', 'man', 'play', 'football', 'lawn']","['shortness', 'man', 'catch', 'football']",4.400000095367432,3,3569,5015,-1446,2090916
1853,"['girl', 'wear', 'green', 'twist', 'hand']","['young', 'boy', 'wear', 'green', 'short', 'pose', 'awkwardly', 'brick', 'background']",0.800000011920929,2,2625,765,1860,3459600
1854,"['man', 'red', 'jacket', 'hold', 'bike', 'picture']","['woman', 'red', 'jacket', 'video', 'take', 'natural', 'landscape']",0.4000000059604645,2,2627,575,2052,4210704
1855,"['boy', 'jump', 'crowded', 'public', 'pool']","['man', 'jump', 'snowboard']",0.800000011920929,1,679,763,-84,7056
1856,"['clown', 'strike', 'pose', 'camera']","['child', 'orange', 'brodie', 'board', 'wave']",0.6000000238418579,0,242,700,-458,209764
1857,"['kiss', 'hold', 'hand', 'jump', 'swimming', 'pool']","['dog', 'play', 'snow']",0.0,0,243,16,227,51529
1858,"['boy', 'push', 'wagon', 'tompkin']","['child', 'squat', 'wagon', 'tompkin']",2.799999952316284,2,2592,2704,-112,12544
1859,"['soccer', 'player', 'battle', 'ball', 'intense', 'match']","['little', 'orange', 'white', 'dog', 'snow']",0.0,0,244,10,234,54756
1860,"['black', 'dog', 'walk', 'tall', 'grass']","['black', 'dog', 'run', 'grass']",3.799999952316284,3,3570,4111,-541,292681
1861,"['black', 'dog', 'play', 'snow']","['black', 'dog', 'dig', 'snow']",3.400000095367432,3,3571,3428,143,20449
1862,"['dog', 'jump', 'chain']","['dog', 'leap', 'chain']",5.0,2,2438,5511,-3073,9443329
1863,"['girl', 'black', 'purse', 'sit', 'wooden', 'bench']","['young', 'woman', 'black', 'purse', 'sit', 'wooden', 'bench']",4.599999904632568,5,4807,5207,-400,160000
1864,"['black', 'yellow', 'dog']","['black', 'dog', 'brown', 'white', 'dog', 'play', 'field']",2.200000047683716,2,2435,2053,382,145924
1865,"['child', 'ball', 'pit']","['child', 'play', 'ball', 'pit']",3.400000095367432,3,3574,3465,109,11881
1866,"['large', 'white', 'grey', 'dog', 'run', 'yellow', 'tunnel', 'obstacle', 'course']","['white', 'black', 'dog', 'run', 'yellow', 'orange', 'tube']",3.5999999046325684,4,4431,3940,491,241081
1867,"['swimmer', 'backstroke', 'swimming', 'pool']","['person', 'stroke', 'swimming', 'pool']",4.800000190734863,2,2428,5369,-2941,8649481
1868,"['man', 'stand', 'astride', 'bike', 'rocky', 'trail', 'lake']","['woman', 'wear', 'white', 'headband', 'purple', 'tank', 'black', 'glove']",0.0,0,246,9,237,56169
1869,"['brown', 'dog', 'run', 'green', 'grass']","['brown', 'dog', 'run', 'river']",2.400000095367432,3,3576,2289,1287,1656369
1870,"['small', 'white', 'dog', 'large', 'brown', 'dog', 'play', 'grass']","['small', 'light', 'dog', 'run', 'past', 'large', 'brown', 'dog', 'stand', 'grass']",3.400000095367432,5,4804,3475,1329,1766241
1871,"['woman', 'hold', 'dog', 'dog', 'stand', 'nearby', 'field']","['lady', 'hold', 'dog', 'dog', 'play', 'yard']",3.400000095367432,2,2425,3474,-1049,1100401
1872,"['black', 'dog', 'walk', 'water']","['black', 'dog', 'walk', 'snow']",2.400000095367432,3,3579,2288,1291,1666681
1873,"['black', 'dog', 'run', 'snow']","['black', 'dog', 'swim', 'ball', 'mouth']",1.7999999523162842,2,2423,1684,739,546121
1874,"['woman', 'dress', 'green', 'play', 'dog']","['dog', 'lick', 'girl', 'hand', 'lay']",1.600000023841858,1,668,1580,-912,831744
1875,"['homeless', 'man', 'stand', 'outside', 'cardboard', 'sign']","['homeless', 'young', 'man', 'hold', 'cardboard', 'sign']",4.599999904632568,4,4415,5210,-795,632025
1876,"['brown', 'dog', 'wage', 'water']","['dog', 'splash', 'murky', 'water']",3.5999999046325684,2,2439,3939,-1500,2250000
1877,"['man', 'orange', 'shirt', 'wear', 'white', 'helmet', 'ride', 'bike']","['man', 'wear', 'blue', 'helmet', 'ride', 'molar']",2.799999952316284,4,4416,2709,1707,2913849
1878,"['little', 'boy', 'stand', 'wedding', 'party', 'laugh']","['person', 'stand', 'stage', 'seated', 'crowd']",1.7999999523162842,1,667,1715,-1048,1098304
1879,"['person', 'snowmobile']","['person', 'snowmobile', 'mid', 'jump']",3.5999999046325684,2,2441,3938,-1497,2241009
1880,"['man', 'stand', 'shore', 'hit', 'ball', 'paddle']","['teenage', 'girl', 'stand', 'beach', 'listen', 'good']",0.800000011920929,1,665,760,-95,9025
1881,"['photo', 'show', 'man', 'take', 'break']","['person', 'swim', 'cap', 'gorge', 'take', 'breath']",0.4000000059604645,1,664,586,78,6084
1882,"['brown', 'dog', 'run', 'sand']","['brown', 'dog', 'run', 'sand']",4.599999904632568,4,4418,5211,-793,628849
1883,"['black', 'dog', 'chase', 'red', 'frisbee']","['black', 'people', 'run', 'snow']",1.399999976158142,1,670,1275,-605,366025
1884,"['girl', 'ponytail', 'ride', 'amusement', 'park', 'ride']","['young', 'girl', 'ride', 'amusement', 'park']",3.0,4,4423,3036,1387,1923769
1885,"['dog', 'dig', 'sand']","['brown', 'dog', 'dig', 'sand']",4.199999809265137,3,3508,4775,-1267,1605289
1886,"['man', 'sit', 'sidewalk', 'store']","['woman', 'bathing', 'suit', 'walk', 'dog', 'beach']",0.0,0,249,6,243,59049
1887,"['black', 'white', 'spot', 'dog', 'jump', 'stream']","['black', 'white', 'spot', 'dog', 'jump', 'small', 'stream', 'water']",4.599999904632568,6,5168,5213,-45,2025
1888,"['person', 'box', 'bike']","['man', 'bike', 'mid', 'air']",3.0,1,695,3033,-2338,5466244
1889,"['dog', 'run', 'tall', 'grass']","['dog', 'run', 'grassy', 'area']",4.599999904632568,2,2456,5214,-2758,7606564
1890,"['little', 'white', 'dog', 'wear', 'leash', 'jump', 'red', 'ball']","['black', 'white', 'dog', 'return', 'stick', 'snow']",1.0,2,2455,1037,1418,2010724
1891,"['group', 'people', 'stand', 'outside', 'building']","['large', 'group', 'people', 'form', 'line', 'outside']",3.200000047683716,3,3435,3175,260,67600
1892,"['group', 'child', 'dance', 'backward']","['group', 'child', 'stretch', 'colored', 'mat']",1.600000023841858,2,2452,1575,877,769129
1893,"['group', 'teenager', 'jump', 'air', 'beach']","['group', 'young', 'people', 'jump', 'air', 'beach']",4.800000190734863,4,4425,5439,-1014,1028196
1894,"['boy', 'wave', 'sparkle']","['young', 'boy', 'twist', 'sparkle', 'air']",4.400000095367432,2,2449,5088,-2639,6964321
1895,"['people', 'sit', 'fire', 'night']","['group', 'people', 'stand', 'sit', 'ground', 'night']",2.5999999046325684,3,3437,2444,993,986049
1896,"['different', 'breed', 'brown', 'white', 'dog', 'play', 'beach']","['dog', 'play', 'sand', 'beach']",4.0,3,3439,4631,-1192,1420864
1897,"['man', 'woman', 'dress', 'empire', 'costume']","['man', 'woman', 'dress', 'costume']",3.400000095367432,4,4491,3638,853,727609
1898,"['boy', 'wear', 'hat', 'playground']","['boy', 'hat', 'laugh', 'sit', 'near', 'playground', 'equipment']",2.400000095367432,3,3442,2227,1215,1476225
1899,"['dog', 'play', 'snow']","['dog', 'play', 'snow']",5.0,3,3443,5525,-2082,4334724
1900,"['woman', 'hold', 'baby', 'man', 'look', 'man', 'hold', 'child', 'watch']","['woman', 'stand', 'arm', 'store', 'woman', 'hold', 'camera']",0.4000000059604645,2,2444,464,1980,3920400
1901,"['white', 'fluffy', 'dog', 'run', 'pure', 'white', 'snow']","['fluffy', 'white', 'dog', 'run', 'snow']",4.599999904632568,5,4820,5218,-398,158404
1902,"['woman', 'hold', 'newspaper']","['man', 'rollerblade', 'metal', 'bar']",0.0,0,250,31,219,47961
1903,"['group', 'man', 'play', 'brass', 'instrument']","['group', 'gun', 'play', 'instrument', 'outside']",3.400000095367432,3,3444,3643,-199,39601
1904,"['girl', 'shore', 'watch', 'people', 'boat', 'fish']","['male', 'red', 'white', 'play', 'basketball', 'game']",0.0,0,231,32,199,39601
1905,"['snowboarder', 'jump', 'air']","['snowboarder', 'fly', 'air']",4.0,2,2421,4667,-2246,5044516
1906,"['white', 'dog', 'red', 'ear', 'run', 'snow']","['wet', 'black', 'dog', 'red', 'collar', 'river']",0.6000000238418579,2,2419,714,1705,2907025
1907,"['little', 'girl', 'little', 'boy', 'hold', 'hand', 'shiny', 'slide']","['little', 'girl', 'aisle', 'dress', 'run', 'sandy', 'playground']",0.4000000059604645,2,2418,469,1949,3798601
1908,"['lid', 'play', 'soccer', 'field']","['boy', 'play', 'soccer', 'field']",4.199999809265137,3,3446,4723,-1277,1630729
1909,"['man', 'jump', 'rooftop']","['young', 'man', 'jump', 'balcony']",2.799999952316284,2,2395,2718,-323,104329
1910,"['child', 'pull', 'sit', 'red', 'wagon', 'sand']","['young', 'boy', 'pull', 'boy', 'wear', 'silly', 'hat', 'radio', 'ulcer', 'wagon']",3.400000095367432,2,2394,3646,-1252,1567504
1911,"['owl', 'wing', 'widespread', 'day']","['bird', 'wing', 'spread', 'fly']",2.400000095367432,1,685,2242,-1557,2424249
1912,"['man', 'blue', 'cap', 'sit', 'stool', 'tree']","['dog', 'stand', 'beach', 'ball', 'nearby']",0.0,0,229,64,165,27225
1913,"['woman', 'sing', 'microphone', 'guy', 'play', 'guitar']","['woman', 'sing', 'microphone', 'guitar', 'player', 'background']",4.400000095367432,4,4506,5081,-575,330625
1914,"['sheep', 'graze', 'grassy', 'field', 'dog', 'walk']","['small', 'group', 'goat', 'grass', 'black', 'white', 'dog', 'background']",2.799999952316284,1,683,2713,-2030,4120900
1915,"['cycling', 'make', 'bike', 'jump', 'rock']","['man', 'jump', 'bicycle', 'air', 'rock']",4.400000095367432,2,2391,5080,-2689,7230721
1916,"['young', 'girl', 'pink', 'hat', 'yellow', 'building', 'background']","['young', 'girl', 'pink', 'dress', 'hand']",1.7999999523162842,3,3448,1686,1762,3104644
1917,"['girl', 'pink', 'dress', 'ride', 'bike', 'white', 'picket', 'fence']","['girl', 'red', 'dress', 'ride', 'bike', 'white', 'fence']",4.0,6,5184,4678,506,256036
1918,"['brown', 'furry', 'animal', 'stand', 'plant']","['dog', 'part', 'stand', 'wood']",1.399999976158142,1,733,1282,-549,301401
1919,"['child', 'red', 'shirt', 'black', 'wake', 'board', 'splash', 'beach', 'wave']","['man', 'rowboat', 'row', 'blue', 'water']",1.0,0,212,929,-717,514089
1920,"['white', 'dog', 'run', 'field']","['brown', 'white', 'dog', 'run', 'field']",3.400000095367432,4,4464,3632,832,692224
1921,"['teenage', 'girl', 'smile']","['little', 'girl', 'kid', 'swing']",0.800000011920929,1,806,882,-76,5776
1922,"['bird', 'interesting', 'grass']","['dog', 'play', 'outdoor']",0.2000000029802322,0,213,434,-221,48841
1923,"['stand', 'snowy', 'mountain']","['mountain', 'limber', 'stand', 'mountain', 'look']",3.400000095367432,2,2384,3623,-1239,1535121
1924,"['child', 'field', 'red', 'flower']","['kiss', 'play', 'field', 'red', 'flower']",4.800000190734863,3,3452,5444,-1992,3968064
1925,"['young', 'man', 'jump', 'rock', 'lake']","['young', 'man', 'red', 'swimming', 'trunk', 'jump', 'large', 'rock', 'water']",4.0,4,4469,4684,-215,46225
1926,"['small', 'black', 'dog', 'grass']","['black', 'dog', 'run', 'grass']",3.5999999046325684,3,3454,3956,-502,252004
1927,"['lady', 'dress', 'simon', 'look', 'camera']","['girl', 'dress', 'black', 'sit', 'room', 'make', 'suggestive', 'pose', 'camera']",1.0,2,2388,1035,1353,1830609
1928,"['group', 'people', 'fire', 'hot', 'air', 'balloon']","['large', 'group', 'people', 'ride', 'brown', 'white', 'horse']",0.0,2,2399,61,2338,5466244
1929,"['child', 'play', 'fight', 'sword']","['child', 'parent', 'pet', 'horse']",0.0,1,782,60,722,521284
1930,"['man', 'wind', 'sail', 'ocean']","['dog', 'run', 'ocean']",1.399999976158142,1,781,1290,-509,259081
1931,"['dog', 'race', 'dirt', 'track']","['war', 'race', 'dirt', 'track']",1.399999976158142,3,3455,1314,2141,4583881
1932,"['people', 'hold', 'hand', 'walk', 'field']","['man', 'walk', 'past', 'murat', 'car']",1.2000000476837158,1,780,1144,-364,132496
1933,"['brown', 'dog', 'case', 'frisbee']","['brown', 'dog', 'squat', 'grass']",1.600000023841858,2,2417,1520,897,804609
1934,"['woman', 'red', 'overall', 'stand', 'sidewalk']","['woman', 'red', 'overall', 'stand', 'sidewalk']",5.0,5,4782,5521,-739,546121
1935,"['dog', 'run', 'backward', 'leave']","['dog', 'run', 'field']",2.799999952316284,2,2415,2733,-318,101124
1936,"['supply', 'play', 'grass']","['supply', 'play', 'grass']",5.0,3,3409,5518,-2109,4447881
1937,"['black', 'white', 'dog', 'play', 'outside']","['child', 'black', 'dog', 'play', 'snow']",1.0,3,3410,1048,2362,5579044
1938,"['dog', 'run', 'water']","['black', 'dog', 'run', 'water']",1.0,3,3411,1049,2362,5579044
1939,"['woman', 'sit', 'brick', 'wall']","['woman', 'walk', 'red', 'bag']",1.2000000476837158,1,776,1138,-362,131044
1940,"['brown', 'dog', 'carry', 'stick', 'mouth']","['dog', 'swim', 'stick', 'mouth']",2.5999999046325684,3,3414,2510,904,817216
1941,"['young', 'woman', 'mean', 'plate', 'meal']","['young', 'woman', 'hopeless', 'paint', 'mud']",0.800000011920929,2,2409,837,1572,2471184
1942,"['person', 'limb', 'snowy', 'hill', 'dog', 'follow']","['person', 'limb', 'snowy', 'hill', 'black', 'dog', 'follow']",3.799999952316284,6,5173,4119,1054,1110916
1943,"['brown', 'dog', 'sit', 'beach']","['dog', 'run', 'beach']",2.0,2,2404,1786,618,381924
1944,"['cuba', 'river', 'submerge', 'water']","['cuba', 'river', 'underwater']",5.0,2,2403,5516,-3113,9690769
1945,"['man', 'ride', 'bike', 'dirt', 'hill']","['trick', 'bicycling', 'grind', 'handrail']",1.7999999523162842,0,216,1712,-1496,2238016
1946,"['large', 'gray', 'dog', 'play', 'deep', 'snow']","['dog', 'play', 'snow']",2.5999999046325684,3,3419,2525,894,799236
1947,"['man', 'ride', 'bike', 'beach', 'ocean']","['man', 'walk', 'cow', 'road']",0.800000011920929,1,779,835,-56,3136
1948,"['dog', 'car']","['dog', 'bite', 'mop']",1.0,1,788,1026,-238,56644
1949,"['dog', 'floppy', 'ear', 'walk', 'camera', 'wood']","['child', 'reflection', 'turn', 'camera', 'smile']",1.2000000476837158,1,789,1128,-339,114921
1950,"['brown', 'dog', 'splash', 'water', 'shake', 'water']","['white', 'dog', 'stand', 'river', 'shake', 'dry']",2.400000095367432,2,2402,2236,166,27556
1951,"['black', 'white', 'dog', 'run', 'beach']","['black', 'brown', 'dog', 'run', 'snow']",1.7999999523162842,3,3420,1699,1721,2961841
1952,"['middle', 'eastern', 'people', 'sit', 'blue', 'truck']","['group', 'people', 'ride', 'truck']",3.400000095367432,2,2440,3657,-1217,1481089
1953,"['person', 'ski', 'pole', 'skin', 'snowy', 'hill']","['person', 'skin', 'snowy', 'hill']",4.199999809265137,4,4513,4727,-214,45796
1954,"['woman', 'eat', 'fish', 'restaurant']","['woman', 'eat', 'large', 'fish', 'restaurant']",4.599999904632568,4,4508,5195,-687,471969
1955,"['child', 'dog', 'play', 'water']","['child', 'red', 'blue', 'float', 'look', 'water']",2.200000047683716,2,2463,2126,337,113569
1956,"['skateboarder', 'trick', 'stone', 'wall']","['skateboarder', 'ride', 'slope']",2.200000047683716,1,802,2138,-1336,1784896
1957,"['people', 'stand', 'escalator', 'move']","['people', 'ride', 'escalator']",4.599999904632568,2,2521,5176,-2655,7049025
1958,"['lady', 'run', 'dog', 'agility', 'course']","['trainer', 'run', 'dog', 'training', 'course', 'green', 'pipe']",4.199999809265137,3,3424,4714,-1290,1664100
1959,"['white', 'brown', 'dog', 'shake', 'ear']","['brown', 'dog', 'run', 'sand']",1.399999976158142,2,2519,1311,1208,1459264
1960,"['child', 'raise', 'hand', 'clapping']","['child', 'play', 'soccer', 'sand']",0.2000000029802322,1,800,391,409,167281
1961,"['man', 'blow', 'large', 'bubble']","['man', 'walk', 'large', 'black', 'horse']",0.0,2,2518,54,2464,6071296
1962,"['people', 'sit', 'dock', 'near', 'water']","['people', 'sit', 'end', 'dock', 'middle', 'water']",3.799999952316284,4,4494,4120,374,139876
1963,"['jockey', 'goal', 'keeper', 'lay', 'ice', 'net']","['hockey', 'player', 'lay', 'ice', 'goal']",4.599999904632568,3,3426,5179,-1753,3073009
1964,"['sky', 'wear', 'blue', 'snow', 'part', 'fly', 'air', 'near', 'jump']","['sky', 'stand', 'hand', 'snow', 'movie', 'camera']",1.399999976158142,2,2514,1309,1205,1452025
1965,"['brown', 'dog', 'run', 'grassy', 'pathway']","['brown', 'dog', 'run', 'grassy', 'stretch', 'divide', 'string']",3.400000095367432,4,4492,3565,927,859329
1966,"['girl', 'wear', 'blue', 'stripe', 'shirt', 'rollerblades']","['man', 'wear', 'black', 'white', 'shirt', 'jump', 'dog']",0.0,2,2512,51,2461,6056521
1967,"['tattooed', 'man', 'black', 'play', 'white', 'guitar', 'singing']","['woman', 'black', 'white', 'coat', 'earmuff']",0.0,2,2510,270,2240,5017600
1968,"['dog', 'run', 'beach']","['boy', 'girl', 'run', 'beach']",1.399999976158142,2,2509,1304,1205,1452025
1969,"['young', 'man', 'woman', 'sit', 'bench', 'outside', 'kiss']","['man', 'woman', 'sit', 'bench', 'kiss']",4.599999904632568,5,4604,5182,-578,334084
1970,"['brown', 'dog', 'jump', 'catch', 'green', 'strap', 'mouth']","['grey', 'dog', 'jump', 'bite', 'green', 'leash']",3.200000047683716,3,3431,3134,297,88209
1971,"['black', 'dog', 'run', 'grass']","['black', 'brown', 'dog', 'run', 'grass']",3.200000047683716,4,4448,3136,1312,1721344
1972,"['woman', 'sit', 'sidewalk', 'cell', 'phone', 'ear']","['woman', 'ride', 'bicycle']",0.5,1,792,608,184,33856
1973,"['dog', 'play', 'grassy', 'field']","['kiss', 'play', 'field']",1.2000000476837158,2,2506,1125,1381,1907161
1974,"['young', 'boy', 'play', 'red', 'ball', 'pit']","['laugh', 'boy', 'lie', 'pit', 'blue', 'ball']",3.0,3,3458,2799,659,434281
1975,"['suffer', 'wave']","['suffer', 'ride', 'wave']",4.400000095367432,2,2505,5108,-2603,6775609
1976,"['skateboarder', 'get', 'camp']","['skateboarder', 'ride', 'pipe', 'wall', 'slater', 'park']",2.400000095367432,1,791,2229,-1438,2067844
1977,"['man', 'running', 'contest']","['dog', 'race']",1.0,0,218,1086,-868,753424
1978,"['kiss', 'walk', 'path', 'wood']","['child', 'walk', 'path', 'wood']",5.0,3,3484,5507,-2023,4092529
1979,"['brown', 'white', 'dog', 'run', 'grass']","['black', 'dog', 'run', 'grass']",3.400000095367432,3,3485,3572,-87,7569
1980,"['dog', 'run', 'grass']","['dog', 'run', 'grass']",4.400000095367432,3,3488,5107,-1619,2621161
1981,"['dog', 'see', 'red', 'fire', 'tyrant']","['dog', 'print', 'red', 'fire', 'tyrant']",5.0,4,4531,5506,-975,950625
1982,"['rugby', 'player', 'dark', 'gear', 'carry', 'light', 'colored', 'rugby', 'ball', 'arm', 'outstretche']","['brown', 'dog', 'splash', 'water', 'carry', 'ball', 'mouth']",0.4000000059604645,2,2542,505,2037,4149369
1983,"['people', 'walk', 'water']","['girl', 'walk', 'tree', 'brick', 'building']",1.2000000476837158,1,771,1132,-361,130321
1984,"['dog', 'splash', 'water']","['dog', 'splash', 'murky', 'water']",4.0,3,3490,4382,-892,795664
1985,"['group', 'people', 'walk', 'sidewalk', 'big', 'city']","['group', 'people', 'ride', 'truck']",1.0,2,2541,1087,1454,2114116
1986,"['dog', 'air', 'grass']","['dog', 'lay', 'bed', 'blue', 'sheet']",1.0,1,752,1066,-314,98596
1987,"['black', 'dog', 'run', 'water']","['man', 'football', 'uniform', 'run', 'football', 'game']",0.0,1,750,48,702,492804
1988,"['girl', 'stand', 'subway', 'wait']","['girl', 'stand', 'dimly', 'light', 'area']",2.0,2,2540,1863,677,458329
1989,"['man', 'sit', 'little', 'girl', 'park']","['man', 'play', 'shaggy', 'little', 'dog']",0.6000000238418579,2,2537,689,1848,3415104
1990,"['large', 'dog', 'run', 'green', 'item', 'mouth']","['dog', 'carry', 'green', 'squeaky', 'toy', 'mouth']",4.400000095367432,3,3506,5105,-1599,2556801
1991,"['group', 'people', 'boat', 'race', 'shore']","['classroom', 'student', 'watch', 'presentation']",0.0,0,220,47,173,29929
1992,"['person', 'ride', 'skateboard', 'air', 'camp']","['baker', 'ride', 'track', 'element', 'locate', 'wooded', 'area']",0.6000000238418579,1,746,682,64,4096
1993,"['boy', 'skateboard', 'metal', 'handrail', 'night']","['brown', 'dog', 'run', 'sand', 'hold', 'stick']",0.0,0,221,46,175,30625
1994,"['person', 'squeeze', 'opening', 'rock', 'face']","['medium', 'sized', 'brown', 'dog', 'run', 'open', 'white', 'wooded', 'area']",0.0,0,222,45,177,31329
1995,"['dog', 'run', 'camera', 'ball', 'mouth']","['black', 'white', 'dog', 'swim', 'brown', 'object', 'mouth']",2.0,2,2535,1870,665,442225
1996,"['young', 'girl', 'run', 'beach']","['little', 'girl', 'run', 'shore', 'beach']",4.199999809265137,3,3498,4793,-1295,1677025
1997,"['baseball', 'player', 'throw', 'ball']","['basketball', 'player', 'hold', 'ball']",1.600000023841858,2,2531,1545,986,972196
1998,"['man', 'swinge', 'rope', 'water']","['man', 'maroon', 'bathing', 'suit', 'swing', 'rope', 'lake']",3.0,2,2529,2767,-238,56644
1999,"['young', 'girl', 'dress', 'minnie', 'mouse', 'outfit', 'old', 'woman', 'walk', 'sidewalk']","['man', 'wear', 'white', 'suit', 'hold', 'newspaper', 'walk', 'street']",1.0,1,742,973,-231,53361
2000,"['testimonial', 'real', 'health', 'expert']","['testimonial', 'real', 'health', 'expert']",3.0,4,4582,2769,1813,3286969
2001,"['captain', 'go']","['captain', 'come']",0.800000011920929,1,741,869,-128,16384
2002,"['problem', 'simple']","['problem', 'simple']",3.799999952316284,2,2527,4125,-1598,2553604
2003,"['negative', 'reconnaissance', 'requirement']","['pacific', 'requirement']",1.0,1,739,917,-178,31684
2004,"['drop', 'ask', 'question', 's', 'marx']","['move', 'ask', 'question', 's', 'beef']",0.4000000059604645,3,3504,494,3010,9060100
2005,"['figure', 'ask', 'prove', 'negative']","['ask', 'prove', 'negative']",4.599999904632568,3,3505,5187,-1682,2829124
2006,"['medical', 'use']","['medical', 'use']",5.0,2,2502,5530,-3028,9168784
2007,"['price', 'need', 'go', 'inflation']","['price', 'asset', 'go']",2.0,2,2501,1814,687,471969
2008,"['war', 'middle', 'east']","['war', 'middle', 'east']",5.0,3,3483,5531,-2048,4194304
2009,"['originally', 'post', 'vienna', 'authoritarian']","['originally', 'post', 'zat']",0.6000000238418579,2,2478,688,1790,3204100
2010,"['imagine', 'place', 'white', 'black']","['imagine', 'place', 'man', 'woman']",1.0,2,2477,968,1509,2277081
2011,"['chance', 'fair', 'trial']","['chance', 'fair', 'trial']",5.0,3,3481,5559,-2078,4318084
2012,"['nirvana', 'different', 'oblivion']","['nirvana', 'oblivion']",3.5999999046325684,2,2475,3878,-1403,1968409
2013,"['britain', 'think', 'differently', 'americans']","['originally', 'post', 'zat', 'britain', 'think', 'differently', 'americans']",4.0,4,4568,4400,168,28224
2014,"['answer', 'yes', 'probably', 'straight']","['answer', 'yes', 'probably', 'straight']",3.0999999046325684,4,4535,3075,1460,2131600
2015,"['earth', 'combine', 'produce', 'food', 'billion', 'people']","['produce', 'billion']",2.200000047683716,2,2472,2077,395,156025
2016,"['btw', 'appropriate', 'ferment', 'time']","['appropriate', 'ferment', 'time', 'eh']",3.200000047683716,3,3459,3203,256,65536
2017,"['key', 'blue', 'eyes', 'thing', 'london']","['smooth', 'key', 'blue', 'eyes', 'thing', 'london']",4.400000095367432,5,4642,5074,-432,186624
2018,"['news', 'broadcast', 'see', 'white']","['impact', 'white']",2.200000047683716,1,766,2080,-1314,1726596
2019,"['accord', 'girlfriend', 'zimmerman']","['accord', 'zimmerman']",2.400000095367432,2,2467,2258,209,43681
2020,"['parent', 'tell', 'bad']","['teacher', 'tell', 'bad']",2.799999952316284,2,2466,2727,-261,68121
2021,"['slang', 'term', 'nswp']","['originally', 'post', 'veins', 'eye', 'slang', 'term', 'nswp']",4.599999904632568,3,3461,5194,-1733,3003289
2022,"['oppose', 'death', 'penalty']","['support', 'death', 'penalty']",1.0,2,2483,969,1514,2292196
2023,[],['aware'],2.200000047683716,0,227,2084,-1857,3448449
2024,"['produce', 'eat', 'wear', 'live']","['think', 'thing', 'eat', 'wear', 'live']",2.200000047683716,3,3466,2085,1381,1907161
2025,"['dickshot', 'watt', 'holiday', 'own']","['watt', 'holiday', 'own']",3.799999952316284,3,3468,4127,-659,434281
2026,"['people', 'exploit', 'law']","['people', 'bent', 'law']",2.799999952316284,2,2498,2705,-207,42849
2027,"['funny', 'think', 'thing', 'path']","['think', 'know', 'path']",2.200000047683716,2,2496,2087,409,167281
2028,"['year', 'keener', 'keener', 'right', 'use', 'lecture']","['year', 'keener', 'keener', 'right', 'wiggie']",2.5999999046325684,3,3472,2485,987,974169
2029,"['prefix', 'suffer', 'hate', 'news']","['stop', 'refixe', 'suffer', 'hate', 'news']",3.0,3,3474,2885,589,346921
2030,"['wood', 'ask', 'tiresome']","['wood', 'ask', 'tiresome', 'question']",4.800000190734863,3,3476,5462,-1986,3944196
2031,"['make', 'sense']","['make', 'sense']",1.399999976158142,2,2489,1293,1196,1430416
2032,"['expensive', 'home']","['expensive', 'car']",1.2000000476837158,1,757,1146,-389,151321
2033,"['martin', 'say', 'follow']","['zimmerman', 'reply']",0.800000011920929,0,228,838,-610,372100
2034,"['satellite', 'intensity', 'estimate', 'tafb', 'sab']","['subjective', 'dvorak', 'intensity', 'estimate', 'tafb', 'sab', 'increased']",2.0,4,4561,1824,2737,7491169
2035,"['fairy', 'exist', 'fine']","['water', 'exist', 'fine']",1.2000000476837158,2,2487,1135,1352,1827904
2036,"['anna', 'know', 'find', 'curious']","['find', 'curious']",2.799999952316284,2,2486,2661,-175,30625
2037,"['compare', 'home', 'sexuality', 'developmental', 'disorder']","['compare', 'home', 'phobia', 'developmental', 'disorder']",2.5999999046325684,4,4547,2479,2068,4276624
2038,"['ask', 'conservative', 'number', 'sew', 'right']","['ask', 'progressive', 'number', 'sew', 'left']",2.5999999046325684,3,3479,2487,992,984064
2039,"['mention', 'pfa', 'post']","['mention', 'restrain', 'order']",0.800000011920929,1,536,885,-349,121801
2040,"['gambling', 'rise', 'king', 'sole', 'vessel', 'fill', 'wonder']","['eye', 'tiger', 'vessel', 'fill', 'wonder']",2.400000095367432,3,3205,2257,948,898704
2041,"['year', 'prior']","['warm', 'c', 'year', 'prior']",3.0,2,2143,2882,-739,546121
2042,['love'],['holy'],1.0,0,337,957,-620,384400
2043,"['vast', 'property', 'protect', 'got']","['great', 'wealth', 'protect', 'got']",3.200000047683716,2,1558,3174,-1616,2611456
2044,"['fundamental', 'difference']","['fundamental', 'difference']",4.599999904632568,2,1557,5196,-3639,13242321
2045,"['exactly', 'germany', 'punish', 'stupidity']","['exactly', 'punish']",1.399999976158142,2,1556,1403,153,23409
2046,"['z', 'stalk', 'shoot']","['claim', 'zimmerman', 'talk', 'shoot']",3.0,1,755,2878,-2123,4507129
2047,"['outraged', 'disappointed']","['god', 'bless', 'outraged', 'disappointed']",5.0,2,1555,5556,-4001,16008001
2048,"['get', 'place']","['money', 'come', 'place']",0.800000011920929,1,758,876,-118,13924
2049,"['freedom', 'speech', 'consequence']","['freedom', 'speech', 'consequence', 'free']",2.1111111640930176,3,3477,1968,1509,2277081
2050,"['parent', 'tell', 'bad']","['teacher', 'tell', 'bad']",2.799999952316284,2,1552,2673,-1121,1256641
2051,"['kill', 'person', 'save']","['kill', 'person', 'save', 'idea']",2.0,3,3475,1831,1644,2702736
2052,"['impose', 'moral']","['impose', 'law']",1.100000023841858,1,759,1105,-346,119716
2053,"['depend', 'define', 'extreme']","['depend', 'define', 'extreme']",5.0,3,3473,5553,-2080,4326400
2054,"['mexico', 'presence', 'california']","['mexico', 'zero', 'claim', 'california']",1.2000000476837158,2,1550,1116,434,188356
2055,"['yes', 'read', 'bible', 'learn', 'christianity']","['personally', 'read', 'bible', 'learn', 'christianity']",3.0,4,4529,2918,1611,2595321
2056,"['oh', 'ha', 'ha', 'ha', 'ha', 'ha']","['ha', 'ha', 'ha', 'ha', 'ha']",4.5,1,760,5141,-4381,19193161
2057,"['yell', 'refuse', 'answer', 'question']","['refuse', 'answer', 'question']",3.400000095367432,3,3470,3583,-113,12769
2058,"['regulation', 'little']","['intervention', 'free', 'market', 'little']",3.799999952316284,1,762,4130,-3368,11343424
2059,"['human', 'element', 'sign', 'dance', 'german', 'end', 'year', 'guess']","['sign', 'dance', 'german', 'end', 'year', 'guess']",4.0,6,5214,4350,864,746496
2060,"['took', 'thomas', 'leave', 'canon']","['addition', 'jesus', 'word', 'leave', 'canon']",2.5999999046325684,2,1549,2473,-924,853776
2061,"['mean', 'believe', 'word', 'mainstream', 'medium']","['mean', 'believe', 'word', 'springhallconvert']",1.7999999523162842,3,3467,1641,1826,3334276
2062,"['mean', 'explore']",['mean'],2.400000095367432,1,769,2252,-1483,2199289
2063,"['israel', 'accept']","['israel', 'anybody', 'think']",3.400000095367432,1,763,3602,-2839,8059921
2064,"['vessel', 'fill', 'wonder']","['want', 'lock', 'toll', 'miss', 'vessel', 'fill', 'wonder']",3.400000095367432,3,3465,3598,-133,17689
2065,"['slutstamp', 'dear', 'friend', 'ohio', 'send']","['dear', 'friend', 'ohio', 'send']",3.5999999046325684,4,4519,3861,658,432964
2066,"['titanic', 'story', 'hold', 'scrutiny', 'evidence']","['new', 'study', 'show', 'titanic', 'story', 'stand', 'scrutiny', 'mio']",1.600000023841858,3,3464,1540,1924,3701776
2067,"['goose', 'ad', 'sense']","['make', 'money', 'goose', 'ad', 'sense']",3.200000047683716,3,3463,3188,275,75625
2068,"['know', 'video', 'gas', 'chamber']","['line', 'video', 'clip', 'gas', 'chamber']",4.599999904632568,3,3462,5254,-1792,3211264
2069,"['arm', 'maybe', 'record']","['farmer', 'certainly', 'record']",4.400000095367432,1,764,5035,-4271,18241441
2070,"['right', 'scatterbrained', 'treat', 'drug']","['opinionated', 'stubborn', 'treat', 'drug']",2.200000047683716,2,1545,1994,-449,201601
2071,"['definition', 'life']","['definition', 'nature']",1.2000000476837158,1,765,1126,-361,130321
2072,"['lot', 'thing']","['simple', 'mistake']",2.200000047683716,0,226,1995,-1769,3129361
2073,"['extortion', 'bribery', 'money', 'involve', 'ask', 'money', 'vote']","['extortion', 'bribery', 'money', 'involve', 'class', 'e', 'felony']",3.799999952316284,4,4527,4132,395,156025
2074,"['tender', 'revise', 'version']","['tender', 'revised', 'version']",4.0,2,1543,4358,-2815,7924225
2075,"['tell', 'feel']","['wait', 'go']",2.200000047683716,0,225,1998,-1773,3143529
2076,"['atlantic', 'requirement']","['pacific', 'requirement']",0.800000011920929,1,768,884,-116,13456
2077,"['remain', 'missile', 'pentagon']","['witness', 'missile', 'pentagon']",2.5999999046325684,2,1559,2463,-904,817216
2078,"['lane', 'want', 'ask', 'helpful', 'party', 'guest', 'pay']","['believe', 'ask', 'ask', 'helpful', 'party', 'guest', 'money']",2.200000047683716,4,4572,2000,2572,6615184
2079,"['woman', 'want', 'birth', 'control']","['woman', 'want', 'abortion']",1.600000023841858,2,1560,1544,16,256
2080,"['legal', 'grow']","['yes', 'legal', 'grow']",2.5999999046325684,2,1561,2491,-930,864900
2081,"['press', 'english']","['dress', 'send', 'tone']",1.7999999523162842,0,224,1754,-1530,2340900
2082,"['opinion', 'series']","['opinion', 'briefly', 'interim']",2.799999952316284,1,761,2692,-1931,3728761
2083,"['vessel', 'fill', 'wonder']","['chuck', 'close', 'vessel', 'fill', 'wonder']",3.5999999046325684,3,3482,3863,-381,145161
2084,['supporter'],"['eminently', 'supporter']",2.0,1,753,1829,-1076,1157776
2085,"['okay', 'ultimate', 'sovereignty']","['ultimate', 'sovereignty']",2.200000047683716,2,1579,2003,-424,179776
2086,['answer'],['answer'],4.800000190734863,1,743,5347,-4604,21196816
2087,"['paris', 'increase', 'longevity', 'handful', 'permit', 'year']","['paris', 'lower', 'minimum', 'age', 'buy', 'forearm']",2.200000047683716,1,737,2004,-1267,1605289
2088,['help'],[],3.5999999046325684,0,223,3865,-3642,13264164
2089,"['healthy', 'person', 'need', 'gambling']","['healthy', 'person', 'need', 'sex']",1.399999976158142,3,3503,1422,2081,4330561
2090,"['say', 'person', 'legal', 'sense']","['person', 'wtf']",2.0,1,740,1826,-1086,1179396
2091,"['drama', 'call', 'regulation', 'reform']","['drama', 'call', 'cap', 'balance']",1.7999999523162842,2,1578,1771,-193,37249
2092,"['leprechaun', 'exist', 'fine']","['slave', 'exist', 'fine']",3.0,2,1577,2913,-1336,1784896
2093,"['seine', 'door', 'light', 'start', 'night', 'hand']","['start', 'night', 'hand']",2.0,3,3501,1823,1678,2815684
2094,"['ran', 'signed', 'npt', 'iaea']","['aorta', 'love', 'factor', 'ran', 'signed', 'npt', 'iaea']",4.199999809265137,4,4585,4776,-191,36481
2095,"['organs', 'exist', 'fine']","['water', 'exist', 'fine']",2.0,2,1576,1820,-244,59536
2096,"['west', 'way', 'money', 'rid', 'lobby']","['west', 'way', 'turn', 'head', 'money']",3.0,3,3500,2858,642,412164
2097,"['year', 'keener', 'keener', 'right', 'usually', 'pretty', 'decent', 'care']","['year', 'keener', 'keener', 'right', 'crack']",3.400000095367432,3,3499,3568,-69,4761
2098,"['dutch', 'hear', 'dutch']","['hear', 'dutch']",3.5999999046325684,2,1575,3877,-2302,5299204
2099,"['commodity', 'expanded', 'value', 'form']","['elementary', 'commodity', 'capital', 'value', 'form']",3.5999999046325684,3,3497,3868,-371,137641
2100,['christian'],['christian'],1.399999976158142,1,744,1400,-656,430336
2101,"['simple', 'fact', 'today']","['repeat', 'simple', 'fact', 'today']",4.0,3,3496,4483,-987,974169
2102,"['moral', 'absolutely']","['moral', 'honesty']",2.0,1,748,1842,-1094,1196836
2103,"['oh', 'good', 'person']","['bad', 'person']",1.7999999523162842,1,749,1749,-1000,1000000
2104,"['think', 'story', 'like', 'stupid']","['wolf', 'think', 'story', 'like', 'stupid']",3.5999999046325684,4,4587,3869,718,515524
2105,"['cyclone', 'formation', 'expect', 'hours']","['tropical', 'cyclone', 'formation', 'expect']",3.400000095367432,3,3493,3454,39,1521
2106,"['understand', 'string', 'word', 'mean']","['understand', 'word', 'lead', 'implie']",1.2000000476837158,2,1569,1115,454,206116
2107,"['freedom', 'religion']","['freedom', 'speech']",1.2000000476837158,1,770,1122,-352,123904
2108,"['originally', 'post', 'solinvictus', 'message', 'scripture', 'fondness']","['originally', 'post', 'solinvictus', 'oh']",2.400000095367432,3,3492,2264,1228,1507984
2109,"['long', 'obliteration', 'kid', 'return', 'school']","['long', 'obliteration', 'long', 'bother', 'kid']",3.0,3,3491,2835,656,430336
2110,"['man', 'woman', 'different', 'yes']","['man', 'woman', 'different', 'yes']",3.400000095367432,4,4589,3519,1070,1144900
2111,"['double', 'jeopardy', 'actually', 'enforce', 'jury', 'nullification']","['far', 'reality', 'go', 'use', 'jury', 'nullification']",2.200000047683716,2,1566,1977,-411,168921
2112,"['facilitator', 'smart', 'child']","['facilitator', 'dumb', 'child']",1.0,2,1565,955,610,372100
2113,"['religious', 'fiction', 'redundant', 'repetetive']","['redundant', 'repetetive']",3.200000047683716,2,1564,3107,-1543,2380849
2114,"['originally', 'post', 'anabelle', 'wrong']","['originally', 'post', 'vienna']",0.0,2,1563,235,1328,1763584
2115,"['franklin', 'rise', 'veil', 'diamond', 'vessel', 'fill', 'wonder']","['single', 'lock', 'hobby', 'helm', 'vessel', 'fill', 'wonder']",1.600000023841858,3,3487,1552,1935,3744225
2116,"['people', 'complete', 'confidence', 'people', 'run', 'institution']","['people', 'confidence', 'people', 'run', 'institution']",1.600000023841858,4,4435,1533,2902,8421604
2117,"['loose', 'change', 'start', 'work', 'fiction']","['finish', 'work', 'fiction']",2.200000047683716,2,1541,1978,-437,190969
2118,"['life', 'able', 'bear']","['alive', 'miscarriage']",3.0,0,219,2830,-2611,6817321
2119,"['verbal', 'absolutely', 'amazing']","['lie', 'absolutely', 'amazing']",2.400000095367432,2,1518,2315,-797,635209
2120,"['let', 'assume', 'white', 'black']","['imagine', 'place', 'white', 'black']",3.777777671813965,2,1516,4061,-2545,6477025
2121,"['freedom', 'speech', 'consequence']","['freedom', 'speech', 'consequence', 'free']",2.1111111640930176,3,3457,1969,1488,2214144
2122,"['fairy', 'exist', 'fine']","['leprechaun', 'exist', 'fine']",1.0,2,1515,946,569,323761
2123,"['state', 'true']",['true'],3.200000047683716,1,793,3120,-2327,5414929
2124,['talk'],"['bad', 'talk']",2.799999952316284,1,794,2675,-1881,3538161
2125,"['duke', 'mean', 'want', 'use', 'duke']","['duke', 'mean', 'want', 'use', 'duke']",1.399999976158142,4,4412,1388,3024,9144576
2126,"['niece', 'marry', 'black', 'man']","['great', 'niece', 'half', 'black']",1.399999976158142,2,1513,1389,124,15376
2127,"['population', 'million']","['japanese', 'population', 'nearly', 'million']",1.0,2,1512,937,575,330625
2128,"['hot', 'sheriff', 'vessel', 'fill', 'wonder']","['vessel', 'fill', 'wonder']",3.400000095367432,3,3429,3489,-60,3600
2129,['hope'],"['hope', 'ok']",2.0,1,795,1859,-1064,1132096
2130,"['money', 'spend', 'adopt', 'velociraptor']","['money', 'spend', 'adopt', 'velociraptor']",4.199999809265137,4,4427,4748,-321,103041
2131,"['actually', 'believe', 'word', 'verbal', 'write']","['verbal', 'wear', 'actually', 'believe', 'word', 'verbal', 'write']",4.199999809265137,5,4602,4746,-144,20736
2132,['sell'],['sell'],1.600000023841858,1,796,1515,-719,516961
2133,"['know', 'hate']",['hate'],4.400000095367432,1,797,5067,-4270,18232900
2134,['weapon'],"['course', 'weapon']",4.599999904632568,1,798,5256,-4458,19873764
2135,"['stupid', 'true']","['amusing', 'think', 'true']",3.0,1,799,2823,-2024,4096576
2136,"['personal', 'responsibility']","['personal', 'responsibility']",4.400000095367432,2,1509,5066,-3557,12652249
2137,"['notice', 'nonsensical', 'thing', 'say']","['fair', 'notice', 'nonsensical', 'thing', 'say']",4.5714287757873535,4,4497,5150,-653,426409
2138,"['guess', 'pull', 'census', 'rear', 'end', 'hat']","['census', 'rear', 'end', 'hat']",2.5999999046325684,4,4501,2476,2025,4100625
2139,"['plant', 'rush']","['plant', 'rush']",4.400000095367432,2,1508,5064,-3556,12645136
2140,"['block', 'homeopath']","['simple', 'logic', 'block', 'homeopath']",4.800000190734863,2,1507,5367,-3860,14899600
2141,"['accuse', 'milligraming']","['accuse', 'doctrine', 'baseball']",0.4000000059604645,1,801,485,316,99856
2142,"['ballot', 'big', 'tarp', 'bloomberg', 'news']","['ballot', 'big', 'tarp', 'title', 'misleading']",3.799999952316284,3,3423,4137,-714,509796
2143,"['parent', 'tell', 'bad']","['officer', 'tell', 'bad']",2.0,2,1506,1851,-345,119025
2144,"['position', 'individual', 'risk', 'assume']","['position', 'way', 'currently']",1.0,1,803,933,-130,16900
2145,"['atlantic', 'requirement']","['pacific', 'requirement']",0.800000011920929,1,804,850,-46,2116
2146,"['head', 'meet', 'fro', 'abortion']","['meet', 'fro', 'abortion']",4.800000190734863,3,3422,5366,-1944,3779136
2147,"['problem', 'money']","['problem', 'man', 'way', 'state']",0.2000000029802322,1,805,428,377,142129
2148,"['dixon', 'word', 'garter', 'shut', 'oilfield']","['shut', 'oil', 'field']",2.0,1,790,1783,-993,986049
2149,"['want', 'president', 'care']","['want', 'president', 'charasmatic']",1.0,2,1502,967,535,286225
2150,['brand'],"['propose', 'model']",0.0,0,217,227,-10,100
2151,"['missile', 'evidence']","['missile', 'witness']",3.200000047683716,1,773,3121,-2348,5513104
2152,"['teacher', 'tell', 'bad']","['officer', 'tell', 'bad']",2.200000047683716,2,1538,2057,-519,269361
2153,"['gash', 'pregnancy', 'ticket']","['pregnancy', 'ticket']",4.199999809265137,2,1520,4789,-3269,10686361
2154,['omnipotence'],['malevolent'],1.399999976158142,0,215,1413,-1198,1435204
2155,"['tin', 'foil', 'hat', 'dog', 'face', 'size', 'u', 'wear']","['tin', 'foil', 'hat', 'sang', 'size', 'u', 'wear']",3.0,6,5176,2866,2310,5336100
2156,"['like', 'year', 'old', 'shoot', 'dead', 'marijuana', 'relate', 'crime']","['year', 'old', 'boy', 'shoot', 'dead', 'automatic', 'weapon', 'marijuana', 'dealer']",4.199999809265137,5,4615,4788,-173,29929
2157,"['leap', 'hit', 'get', 'penalty']","['stick', 'hit', 'guy', 'face', 'get', 'penalty']",2.5999999046325684,3,3416,2466,950,902500
2158,"['electrical', 'energy', 'come', 'battery']","['electrical', 'energy', 'ultimately', 'come', 'alternate']",2.400000095367432,3,3415,2319,1096,1201216
2159,"['know', 'passenger', 'testify', 'say']","['passenger', 'say', 'see', 'iceberg']",2.400000095367432,2,1536,2310,-774,599076
2160,"['imagine', 'place', 'man', 'woman']","['imagine', 'place', 'white', 'black']",1.600000023841858,2,1535,1529,6,36
2161,"['scenario', 'assume', 'growth', 'rate', 'accelerate']","['assume', 'methode', 'growth', 'rate', 'accelerate']",1.75,4,4471,1606,2865,8208225
2162,"['actually', 'show', 'cool', 'trend', 'recent', 'decline']","['cool', 'trend', 'recent', 'decline']",4.599999904632568,4,4476,5260,-784,614656
2163,"['vessel', 'fill', 'wonder']","['tendon', 'memory', 'cats', 'vessel', 'fill', 'wonder']",3.0,3,3412,2871,541,292681
2164,"['repeat', 'sovereign']",['sovereign'],4.5,1,777,5139,-4362,19027044
2165,"['touch', 'completely', 'untrustworthy']","['touch', 'untrustworthy']",4.25,2,1533,4943,-3410,11628100
2166,['dutch'],"['fact', 'dutch']",3.5999999046325684,1,778,3866,-3088,9535744
2167,"['talk', 'angel', 'common', 'pin', 'right']","['andrew', 'talk', 'angel', 'common', 'pin', 'right']",4.800000190734863,5,4682,5362,-680,462400
2168,"['claim', 'trayvon', 'character']","['plant', 'blow']",2.5999999046325684,0,214,2509,-2295,5267025
2169,"['money', 'abortion', 'service']","['spend', 'abortion', 'service']",2.5999999046325684,2,1530,2505,-975,950625
2170,"['transaction', 'place']","['transaction', 'place']",2.400000095367432,2,1529,2321,-792,627264
2171,"['egg', 'cell', 'post', 'fertilization']","['speak', 'cell']",2.400000095367432,1,787,2314,-1527,2331729
2172,"['face', 'welcome']",['welcome'],4.0,1,783,4467,-3684,13571856
2173,"['factchecke', 'know', 'make', 'fuss', 'bet']","['know', 'make', 'fuss', 'bet']",4.400000095367432,4,4472,5052,-580,336400
2174,['claim'],['claim'],2.400000095367432,1,784,2318,-1534,2353156
2175,"['thatcherite', 'librarian']","['offend', 'thatcherites', 'librarian']",2.400000095367432,1,785,2307,-1522,2316484
2176,"['problem', 'money']","['problem', 'money']",2.4666666984558105,2,1522,2325,-803,644809
2177,"['actually', 'believe', 'iceberg', 'water']","['believe', 'iceberg', 'near', 'titanic']",2.799999952316284,2,1521,2716,-1195,1428025
2178,"['gastro', 'trifle', 'bad', 'someday', 'trifles', 'game', 'freeze']","['someday', 'trifles', 'game', 'freeze']",3.0,4,4465,2850,1615,2608225
2179,"['clot', 'corp', 'prescription', 'drug']","['clot', 'inventor', 'writer', 'prescription', 'drug']",2.400000095367432,3,3450,2323,1127,1270129
2180,['charge'],"['yes', 'charge']",4.0,1,786,4433,-3647,13300609
2181,"['partial', 'psychopath']","['red', 'funds', 'partial', 'psychopath']",1.7999999523162842,2,1656,1719,-63,3969
2182,"['ignore', 'history', 'doom', 'repeat']","['strike', 'ignore', 'history', 'doom', 'repeat']",4.199999809265137,4,4474,4769,-295,87025
2183,"['war', 'employment']","['official', 'employment']",2.400000095367432,1,682,2312,-1630,2656900
2184,"['outran', 'plural', 'anecdote', 'datum', 'gentleman', 'need', 'chaperone']","['outran', 'plural', 'anecdote', 'datum']",3.5999999046325684,4,4489,3855,634,401956
2185,"['alright', 'get']","['alright', 'get']",4.0,2,1584,4427,-2843,8082649
2186,"['h', 'read', 'book', 'think', 'movie', 'move', 'quickly']","['read', 'book', 'see', 'movie', 'today']",3.0,3,3447,2928,519,269361
2187,"['kolocha', 'scene']","['kolocha', 'scene']",2.400000095367432,2,1643,2309,-666,443556
2188,"['andrew', 'tendon', 'johnson', 'john', 'penned', 'compatible']","['tendon', 'johnson', 'john', 'penned', 'compatible']",4.400000095367432,5,4772,5055,-283,80089
2189,"['need', 'mind']","['need', 'polish', 'logic', 'skill']",0.6000000238418579,1,684,654,30,900
2190,"['walk', 'home', 'go', 'sleep']","['walk', 'home', 'beat', 'wife']",1.399999976158142,2,1638,1414,224,50176
2191,"['admit', 'drpizza', 'forget', 'shiny', 'little', 'bed', 'letter']","['forget', 'shiny', 'little', 'bed', 'letter']",3.799999952316284,5,4792,4209,583,339889
2192,"['argument', 'albert', 'einstein', 'college']","['omg', 'einstein', 'college']",4.199999809265137,2,1637,4778,-3141,9865881
2193,"['capital', 'gain', 'rate', 'percent']","['income', 'tax', 'rate', 'percent']",2.400000095367432,2,1636,2322,-686,470596
2194,"['singing', 'unacceptable']","['drunk', 'unacceptable']",1.0,1,686,893,-207,42849
2195,"['funny', 'year']","['funny', 'carry', 'mud', 'german']",3.400000095367432,1,687,3668,-2981,8886361
2196,"['universe', 'explanation', 'existence', 'explanation', 'god']","['universe', 'explanation', 'existence']",2.400000095367432,3,3445,2316,1129,1274641
2197,"['return', 'fighting']","['return', 'fighting']",5.0,2,1634,5549,-3915,15327225
2198,"['stop', 'joke', 'marriage']","['fight', 'marriage']",1.2000000476837158,1,689,1127,-438,191844
2199,"['news', 'news']","['catholics', 'catholics']",2.200000047683716,0,232,2038,-1806,3261636
2200,"['great', 'lady']","['nice', 'lady']",4.0,1,690,4421,-3731,13920361
2201,"['wealthy', 'successful']","['hate', 'people', 'successful']",0.800000011920929,1,691,849,-158,24964
2202,['irritated'],"['irritated', 'henry']",1.75,1,692,1619,-927,859329
2203,"['common', 'sense', 'deductive', 'reasoning', 'thing']","['limit', 'common', 'sense', 'deductive', 'reasoning', 'thing']",2.5,5,4822,2351,2471,6105841
2204,"['slim', 'office', 'right']","['christian', 'office', 'right']",0.800000011920929,2,1627,865,762,580644
2205,"['say', 'workforce']","['inn', 'money', 'workforce']",3.400000095367432,1,693,3460,-2767,7656289
2206,"['dreamtech', 'ejaculate', 'far', 'know']","['ejaculate', 'far', 'know']",3.0,3,3438,2864,574,329476
2207,"['get', 'soft']","['say', 'get', 'soft']",1.2000000476837158,2,1645,1142,503,253009
2208,"['believe', 'get', 'expect']","['time', 'time', 'get', 'expect']",3.799999952316284,2,1646,4211,-2565,6579225
2209,"['despicable', 'man', 'stop', 'try', 'find', 'excuse', 'man']","['man', 'stop', 'try', 'find', 'excuse', 'man']",4.400000095367432,5,4795,5034,-239,57121
2210,"['different', 'different', 'country']","['short', 'form', 'yes', 'probably', 'different', 'different', 'country']",3.5999999046325684,2,1647,3837,-2190,4796100
2211,"['new', 'study', 'support', 'claim']","['physical', 'evidence', 'support', 'claim']",2.200000047683716,2,1665,2052,-387,149769
2212,"['say', 'level']","['say', 'level']",4.599999904632568,2,1664,5267,-3603,12981609
2213,"['moral', 'exist', 'technically', 'morally', 'wrong']","['ask', 'god', 'exist', 'morally', 'wrong']",2.200000047683716,3,3434,2051,1383,1912689
2214,"['think', 'dutch']",['dutch'],4.0,1,694,4416,-3722,13853284
2215,"['poland', 'johnny', 'vessel', 'fill', 'wonder']","['eye', 'tiger', 'vessel', 'fill', 'wonder']",3.200000047683716,3,3494,3325,169,28561
2216,"['met', 'let', 'play', 'court']","['stop', 'thing', 'play', 'court']",3.799999952316284,2,1663,4212,-2549,6497401
2217,"['gang', 'isn', 'crime']","['vomit', 'crime', 'gang', 'crime']",1.7999999523162842,2,1662,1761,-99,9801
2218,"['offer', 'ran', 'deal']","['chuck', 'offer', 'ran', 'deal']",4.199999809265137,3,3507,4733,-1226,1503076
2219,"['yes', 'different']","['opinion', 'different']",1.2000000476837158,1,688,1133,-445,198025
2220,"['impose', 'moral']","['impose', 'law']",1.100000023841858,1,680,1104,-424,179776
2221,"['sexuality', 'like']","['word', 'hobby', 'sexuality', 'like']",3.799999952316284,2,1658,4215,-2557,6538249
2222,"['pure', 'communism', 'cow']","['libertarian', 'anarcho', 'capitalism', 'cow']",2.400000095367432,1,666,2317,-1651,2725801
2223,"['scientist', 'pedestal']","['people', 'like', 'scientist', 'pedestal']",3.400000095367432,2,1654,3492,-1838,3378244
2224,"['try', 'hide']","['ask', 'try', 'hide']",3.5999999046325684,2,1653,3841,-2188,4787344
2225,"['partially', 'responsible', 'death']","['sort', 'accessory', 'think']",3.0,0,248,2843,-2595,6734025
2226,"['like', 'pay', 'health', 'care']","['like', 'wear', 'seatbelt']",0.0,1,669,215,454,206116
2227,['sovereign'],"['repeat', 'sovereign']",4.400000095367432,1,671,5110,-4439,19704721
2228,"['drama', 'less', 'evil']",['evil'],2.0,1,678,1788,-1110,1232100
2229,"['rose', 'vessel', 'fill', 'wonder']","['vessel', 'fill', 'wonder']",3.200000047683716,3,3578,3307,271,73441
2230,"['point', 'unarmed', 'child', 'murder']","['point', 'unarmed', 'child', 'murder', 'black']",3.400000095367432,4,4414,3510,904,817216
2231,"['zimmerman', 'reply']","['martin', 'say', 'follow']",0.8999999761581421,0,247,890,-643,413449
2232,"['religion', 'problem']","['religion', 'problem']",1.600000023841858,2,1648,1588,60,3600
2233,"['angry', 'scar']","['hyper', 'active', 'scar']",3.200000047683716,1,674,3233,-2559,6548481
2234,"['want', 'buy', 'billion', 'xyz', 'common', 'stock', 'care']","['want', 'buy', 'house', 'suv', 'care']",1.399999976158142,3,3575,1412,2163,4678569
2235,"['billion', 'world', 'mexico', 'current', 'prosperity', 'level']","['world', 'current', 'prosperity', 'level', 'northwest', 'africa']",1.5333333015441897,4,4410,1452,2958,8749764
2236,"['answer', 'yes', 'probably', 'straight']","['answer', 'yes', 'probably', 'straight']",3.0999999046325684,4,4408,3074,1334,1779556
2237,"['fantasize', 'have', 'power']","['fantasise', 'bend', 'people', 'demand']",4.199999809265137,0,245,4719,-4474,20016676
2238,"['parent', 'tell', 'bad']","['sheriff', 'tell', 'bad']",2.799999952316284,2,1624,2676,-1052,1106704
2239,"['atlas', 'shrug', 'cellar', 'performer', 'term', 'glitter', 'idiocy']","['cellar', 'performer', 'term', 'glitter', 'idiocy']",3.5999999046325684,5,4806,3843,963,927369
2240,"['martin', 'know', 'case']","['martin', 'know', 'intention', 'base', 'action']",2.400000095367432,2,1603,2177,-574,329476
2241,"['regulation', 'government']","['met', 'government']",2.400000095367432,1,676,2174,-1498,2244004
2242,"['common', 'sense', 'deductive', 'reasoning', 'thing']","['limit', 'common', 'sense', 'deductive', 'reasoning', 'thing']",2.5,5,4809,2341,2468,6091024
2243,"['yes', 'assume', 'packing', 'recyclable', 'argument']","['assume', 'argument']",2.799999952316284,2,1600,2666,-1066,1136356
2244,"['jury', 'nullification', 'mean', 'law', 'unconstitutional']","['jury', 'nullification', 'mean', 'law', 'constitutional']",3.5999999046325684,4,4452,3853,599,358801
2245,"['bunch', 'cell']","['bunch', 'cell']",2.200000047683716,2,1599,2033,-434,188356
2246,"['kann', 'work', 'path']","['kann', 'work', 'free', 'ring']",1.600000023841858,2,1598,1591,7,49
2247,"['sorry', 'hear', 'belly']","['sorry', 'belly']",4.0,2,1596,4437,-2841,8071281
2248,"['like', 'favor', 'bee']","['like', 'favor', 'drink']",3.0,2,1593,2836,-1243,1545049
2249,"['hope', 'ok']","['hope', 'ok']",1.600000023841858,2,1592,1592,0,0
2250,"['woman', 'want', 'birth', 'control']","['woman', 'want', 'abortion']",1.600000023841858,2,1591,1577,14,196
2251,"['s', 'wish', 'kill', 'news']","['kill', 'news']",4.599999904632568,2,1589,5270,-3681,13549761
2252,"['friend', 'pitt']","['good', 'friend', 'pitt']",4.0,2,1587,4458,-2871,8242641
2253,"['mean', 'option']","['doesn', 'mean', 'bad', 'option']",1.600000023841858,2,1586,1576,10,100
2254,"['think', 'need', 'reread', 'write']","['need', 'reread', 'write']",5.0,3,3567,5542,-1975,3900625
2255,"['let', 'assume', 'white', 'black']","['imagine', 'place', 'white', 'black']",3.777777671813965,2,1585,4060,-2475,6125625
2256,"['tom', 'dust', 'say', 'noise']","['kiss', 'dust', 'say']",1.7999999523162842,2,1602,1723,-121,14641
2257,"['good', 'butte', 'ex', 'fiance', 'use', 'navy', 'doctor']","['ex', 'fiance', 'use', 'navy', 'doctor']",3.5999999046325684,5,4736,3844,892,795664
2258,"['old', 'file', 'page', 'letter']","['judges', 'order', 'page', 'letter', 'file']",2.799999952316284,3,3564,2698,866,749956
2259,"['andrew', 'dusting', 'agree']","['andrew', 'thank', 'dusting']",2.200000047683716,2,1605,2022,-417,173889
2260,"['eclipse', 'old', 'record', 'set']","['break', 'daily', 'record', 'set']",4.800000190734863,2,1622,5401,-3779,14280841
2261,"['zimmerman', 'reply']","['martin', 'say', 'follow']",0.8999999761581421,0,239,889,-650,422500
2262,"['know', 'legitimate', 'hear', 'kind', 'suicidal']","['know', 'legitimate', 'yeah']",1.600000023841858,2,1621,1557,64,4096
2263,"['council', 'tax', 'council', 'tax', 'freeze', 'people']","['council', 'tax', 'freeze', 'people']",4.800000190734863,4,4440,5405,-965,931225
2264,"['stick', 'get', 'stale']","['misogyny', 'get', 'mess']",0.4000000059604645,1,721,498,223,49729
2265,['work'],"['ah', 'work']",1.600000023841858,1,722,1561,-839,703921
2266,"['breathe', 'breathe', 'love']","['buwhahahaha', 'breathe', 'breathe', 'love']",4.400000095367432,2,1617,5082,-3465,12006225
2267,"['wait', 'consistent', 'close']","['wait', 'contraction', 'strong', 'close']",3.799999952316284,2,1616,4218,-2602,6770404
2268,"['drama', 'extreme', 'let']","['drama', 'extreme', 'letting']",4.800000190734863,2,1615,5406,-3791,14371681
2269,"['isa', 'want']",['want'],2.5,1,723,2361,-1638,2683044
2270,"['jury', 'nullification', 'constitutionality', 'law']","['jury', 'nullification', 'mean', 'law', 'constitutional']",2.5999999046325684,3,3607,2511,1096,1201216
2271,"['conviction', 'talk']",['conviction'],4.400000095367432,1,725,5090,-4365,19053225
2272,"['actually', 'read', 'guess', 'find']","['furthermore', 'find', 'actually', 'read', 'guess', 'find']",4.599999904632568,4,4590,5276,-686,470596
2273,"['government', 'determine', 'married']","['government', 'doesn', 'declare', 'married', 'marry']",3.5999999046325684,2,1611,3845,-2234,4990756
2274,"['democracy', 'threat', 'liberty']","['democracy', 'liberty']",1.7999999523162842,2,1610,1743,-133,17689
2275,"['fro', 'wear', 'thread', 'plan', 'make']","['thread', 'plan', 'make']",4.0,3,3605,4443,-838,702244
2276,"['exactly', 'system', 'work', 'right']","['system', 'work']",4.0,2,1609,4442,-2833,8025889
2277,"['oh', 'assert', 'marriage', 'fundamental', 'human', 'right']","['particularly', 'state', 'marriage', 'fundamental', 'human', 'right']",4.0,4,4580,4629,-49,2401
2278,"['russians', 'damascus']","['russians', 'damascus']",4.199999809265137,2,1607,4795,-3188,10163344
2279,"['yes', 'solution']","['solution', 'work']",1.7999999523162842,1,727,1747,-1020,1040400
2280,"['yeah', 'think', 'controversial']","['think', 'say', 'controversial']",3.799999952316284,2,1606,4223,-2617,6848689
2281,"['operation', 'chaos', 'merely', 'people', 'vote']","['chaos', 'merely', 'people', 'vote']",4.0,4,4577,4446,131,17161
2282,"['originally', 'post', 'doubtful']","['originally', 'post']",1.2000000476837158,2,1499,1112,387,149769
2283,"['classical', 'vessel', 'fill', 'wonder']","['theme', 'song', 'cheer', 'vessel', 'fill', 'wonder']",3.0,3,3599,2926,673,452929
2284,"['repeat', 'sovereign']",['sovereign'],4.5,1,728,5123,-4395,19316025
2285,"['moral', 'absolutely']","['moral', 'honesty']",2.0,1,729,1848,-1119,1252161
2286,"['have', 'conversation', 'cornell', 'west', 'dear', 'brother']","['have', 'conversation', 'cornell', 'west', 'hell']",3.0,4,4574,2919,1655,2739025
2287,"['war', 'middle', 'east']","['war', 'middle', 'east']",4.599999904632568,3,3598,5251,-1653,2732409
2288,"['intention', 'apprehend']","['didn', 'plan', 'apprehend']",2.400000095367432,1,730,2222,-1492,2226064
2289,"['vessel', 'fill', 'wonder']","['little', 'love', 'heart', 'vessel', 'fill', 'wonder']",3.5999999046325684,3,3597,3849,-252,63504
2290,"['bunch', 'cell']","['bunch', 'cell']",2.400000095367432,2,1388,2223,-835,697225
2291,"['girl', 'fouche']","['girl', 'fouche']",1.399999976158142,2,1375,1378,-3,9
2292,"['jury', 'nullification', 'mean', 'law', 'constitutional']","['jury', 'nullification', 'mean', 'law', 'unconstitutional']",2.0,4,4593,1854,2739,7502121
2293,['definitely'],"['vote', 'voted', 'definitely']",4.0,1,731,4454,-3723,13860729
2294,"['one', 'manufacturer', 'product', 'convince', 'consumer', 'safe']","['manufacturer', 'convince', 'government', 'safe']",3.400000095367432,3,3593,3595,-2,4
2295,"['think', 'miss', 'point', 'entrepreneur']","['think', 'miss', 'point', 'swain', 'quote']",0.800000011920929,3,3592,859,2733,7469289
2296,"['cyclops', 'exist', 'fine']","['collin', 'exist', 'fine']",1.600000023841858,2,1420,1574,-154,23716
2297,"['mental', 'illness', 'teach']","['state', 'mental', 'illness', 'bigotry']",1.600000023841858,2,1421,1570,-149,22201
2298,"['tendon', 'christmas', 'vessel', 'fill', 'wonder']","['lie', 'fire', 'vessel', 'fill', 'wonder']",1.7999999523162842,3,3590,1732,1858,3452164
2299,"['rush', 'get', 'zero', 'credit', 'budget']","['drama', 'get', 'zero', 'credit', 'budget']",1.7999999523162842,4,4596,1728,2868,8225424
2300,"['sinful', 'people', 'heaven']","['sin', 'remove', 'entry', 'heaven']",1.7999999523162842,1,716,1727,-1011,1022121
2301,"['long', 'obliteration', 'kid', 'return', 'school']","['long', 'obliteration', 'long', 'bother', 'kid']",3.0,3,3587,2900,687,471969
2302,"['folly', 'holy', 'vessel', 'fill', 'wonder']","['vessel', 'fill', 'wonder']",3.799999952316284,3,3586,4228,-642,412164
2303,"['answer', 'chicago']","['response', 'california']",1.2000000476837158,0,236,1129,-893,797449
2304,"['entire', 'thing', 'make', 'sense']","['make', 'sense']",4.199999809265137,2,1394,4891,-3497,12229009
2305,"['supposedly', 'operate', 'homicidal', 'gas', 'chamber']","['refresh', 'memory', 'supposedly', 'operate', 'homicidal', 'gas', 'chamber']",4.800000190734863,5,4695,5387,-692,478864
2306,"['explanation', 'existence', 'universe', 'god']","['universe', 'explanation', 'existence', 'explanation', 'god']",3.5999999046325684,4,4599,3852,747,558009
2307,"['genetic', 'predisposition', 'cancer', 'resistance', 'superior', 'genetic']","['genetic', 'predisposition', 'alzheimer', 'inferior', 'genetic']",1.399999976158142,2,1389,1415,-26,676
2308,"['notice', 'nonsensical', 'thing', 'say']","['fair', 'notice', 'nonsensical', 'thing', 'say']",4.5714287757873535,4,4536,5151,-615,378225
2309,"['use', 'force', 'defense']","['use', 'force', 'aggressor']",1.2000000476837158,2,1391,1130,261,68121
2310,"['datum', 'available', 'show']","['historical', 'record', 'show']",3.5999999046325684,1,706,3854,-3148,9909904
2311,"['boy', 'world', 'vessel', 'fill', 'wonder']","['theme', 'song', 'cheer', 'vessel', 'fill', 'wonder']",3.0,3,3530,2877,653,426409
2312,"['think', 'dutch']","['fact', 'dutch']",2.5999999046325684,1,700,2493,-1793,3214849
2313,"['ve', 'watch', 'kiss', 'play']","['like', 'watch', 'kiss', 'play']",2.200000047683716,3,3528,2014,1514,2292196
2314,"['david', 'think', 'antrum', 'likely', 'gingrich']","['think', 'antrum', 'likely', 'gingrich']",4.800000190734863,4,4530,5377,-847,717409
2315,['look'],"['look', 'like']",2.799999952316284,1,701,2681,-1980,3920400
2316,['drive'],"['drive', 'fucking', 'bolt']",2.5999999046325684,1,702,2523,-1821,3316041
2317,"['religion', 'problem']","['religion', 'problem']",1.399999976158142,2,1399,1410,-11,121
2318,"['think', 'well', 'american', 'business', 'interest', 'overall']","['well', 'american', 'society']",1.600000023841858,2,1402,1513,-111,12321
2319,"['constitutional', 'issue']","['constitutional', 'issue']",4.400000095367432,2,1403,5116,-3713,13786369
2320,"['fools', 'buy', 'cover', 'hook']","['lot', 'fools', 'buy', 'cover', 'hook']",4.199999809265137,4,4528,4876,-348,121104
2321,"['press', 'number']","['dress', 'number', 'english']",1.600000023841858,1,705,1530,-825,680625
2322,['conviction'],"['conviction', 'talk']",4.400000095367432,1,707,5103,-4396,19324816
2323,"['originally', 'post', 'spikdboy', 'wistful', 'thinking', 'realistic']","['originally', 'post', 'objective', 'wistful', 'thinking', 'realistic']",3.799999952316284,5,4750,4230,520,270400
2324,"['trillion', 'time', 'say', 'rehabilitation', 'work']","['point', 'quote', 'say', 'rehabilitation', 'work']",3.400000095367432,3,3521,3610,-89,7921
2325,"['charlie', 'angel', 'censured', 'forage']",['forage'],3.0,1,714,2884,-2170,4708900
2326,"['red', 'october', 'stand']","['red', 'box', 'stand']",2.0,2,1413,1840,-427,182329
2327,"['legal', 'brief', 'write']","['legal', 'reasoning', 'work']",3.200000047683716,1,710,3278,-2568,6594624
2328,"['factor', 'account', 'recent', 'warming']","['know', 'factor', 'account', 'warming']",3.0,3,3518,2887,631,398161
2329,"['tone', 'notify', 'captain', 'word']","['notify', 'captain', 'word']",3.400000095367432,3,3517,3601,-84,7056
2330,"['primary', 'focus', 'systematic', 'dialectics', 'son', 'chronic', 'chronic']","['beta', 'system', 'attic', 'dialectic', 'diachronico', 'synchronic', 'dialectic']",2.200000047683716,0,230,2131,-1901,3613801
2331,['drive'],"['drive', 'fucking', 'bolt']",2.5999999046325684,1,712,2475,-1763,3108169
2332,"['happen', 'gop', 'control', 'state']","['michigan', 'gop', 'control', 'state']",0.800000011920929,3,3514,836,2678,7171684
2333,"['basin', 'freeze']",['frozen'],4.199999809265137,0,188,4884,-4696,22052416
2334,"['isa', 'rank', 'observe', 'perceive']","['impostor', 'rank', 'observe', 'perceive']",4.199999809265137,3,3513,4890,-1377,1896129
2335,"['government', 'decide', 'pregnancy', 'need', 'carry', 'term', 'fine']","['government', 'spy', 'citizen', 'fine']",1.2000000476837158,2,1370,1143,227,51529
2336,"['little', 'love', 'heart', 'vessel', 'fill', 'wonder']","['tendon', 'christmas', 'vessel', 'fill', 'wonder']",2.799999952316284,3,3511,2706,805,648025
2337,"['high', 'cent', 'high']","['power', 'cent', 'low']",1.0,1,734,1047,-313,97969
2338,['sell'],['sell'],1.600000023841858,1,808,1461,-653,426409
2339,"['god', 'definitely', 'exist']","['god', 'probably', 'exist']",2.5999999046325684,2,1381,2462,-1081,1168561
2340,"['breathe', 'breathe', 'love']","['buwhahahaha', 'breathe', 'breathe', 'love']",4.400000095367432,2,1384,5043,-3659,13388281
2341,"['excellent', 'indicator', 'climate', 'change']","['think', 'agree', 'nature', 'change']",2.0,1,902,1830,-928,861184
2342,"['great', 'thing', 'live', 'space']","['bad', 'thing', 'space']",1.7999999523162842,2,1386,1644,-258,66564
2343,"['oh', 'ha', 'ha', 'ha', 'ha', 'ha']","['ha', 'ha', 'ha', 'ha', 'ha']",4.5,1,904,5124,-4220,17808400
2344,"['understand', 'freedom', 'speech', 'prohibit']","['freedom', 'speech', 'prohibit', 'today']",3.799999952316284,3,3534,4232,-698,487204
2345,"['question', 'need', 'ask']","['question', 'need', 'answer']",3.200000047683716,2,1459,3234,-1775,3150625
2346,"['purport', 'value', 'life', 'heavily']","['purport', 'value', 'human', 'life', 'highly']",2.799999952316284,3,3555,2695,860,739600
2347,"['infestation', 'post']","['mosquito', 'post']",1.7999999523162842,1,905,1645,-740,547600
2348,"['want', 'president', 'care']","['want', 'president', 'compassionate']",4.599999904632568,2,1475,5228,-3753,14085009
2349,['compelling'],['compelling'],2.400000095367432,1,906,2198,-1292,1669264
2350,"['trillion', 'time', 'say', 'rehabilitation', 'work']","['point', 'quote', 'say', 'rehabilitation', 'work']",3.400000095367432,3,3554,3555,-1,1
2351,"['classical', 'vessel', 'fill', 'wonder']","['time', 'reason', 'hobbies', 'vessel', 'fill', 'wonder']",2.400000095367432,3,3553,2196,1357,1841449
2352,"['nerve', 'agree', 'come', 'essentially', 'freewill']","['agree', 'come', 'essentially', 'freewill']",4.0,4,4563,4419,144,20736
2353,"['fro', 'life', 'people', 'want', 'woman', 'able', 'choose', 'abortion']","['fro', 'choice', 'people', 'try', 'force', 'abortion']",1.0,3,3552,1034,2518,6340324
2354,"['answer', 'question']","['stop', 'avoid', 'question']",3.400000095367432,1,908,3554,-2646,7001316
2355,"['haiti', 'shithole']","['haiti', 'shithole']",4.199999809265137,2,1471,4893,-3422,11710084
2356,"['absolutely', 'believe', 'iceberg', 'water']","['believe', 'iceberg', 'near', 'titanic']",1.2000000476837158,2,1497,1117,380,144400
2357,"['face', 'franchise', 'bad', 'years', 'fan']","['bad', 'years', 'fan']",4.400000095367432,3,3549,5069,-1520,2310400
2358,"['agree', 'completely', 'hope', 'second', 'term', 'office']","['hope', 'second', 'term', 'office']",4.0,4,4559,4422,137,18769
2359,['assist'],"['horace', 'goal']",0.4000000059604645,0,180,468,-288,82944
2360,"['possible', 'home', 'affect', 'school']","['sure', 'possible', 'home', 'affect', 'school']",3.200000047683716,4,4558,3224,1334,1779556
2361,"['people', 'awaken']","['people', 'awaken']",4.199999809265137,2,1463,4877,-3414,11655396
2362,"['mmm', 'california', 'cargo', 'ship', 'not', 'care', 'article', 'say']","['california', 'cargo', 'ship']",4.0,3,3557,4425,-868,753424
2363,"['mmm', 'pretty', 'clearly', 'state', 'statute', 'resume', 'constitutional']","['decide', 'statute', 'resume', 'constitutional']",2.5999999046325684,3,3546,2467,1079,1164241
2364,"['florida', 'ignorance']",['ignorance'],3.400000095367432,1,911,3550,-2639,6964321
2365,"['go', 'shout', 'justice', 'trayvon']","['people', 'shout', 'justice', 'trayvon', 'hypocrite']",1.600000023841858,3,3543,1467,2076,4309776
2366,"['know', 'right', 'wrong']","['know', 'story', 'right']",2.200000047683716,2,1479,2076,-597,356409
2367,"['ha', 'ha', 'ha', 'ha', 'ha']","['oh', 'ha', 'ha', 'ha', 'ha', 'ha']",5.0,1,914,5535,-4621,21353641
2368,"['agent', 'complete', 'fool', 'say']","['natalie', 'complete', 'fool', 'insult', 'fan', 'base']",0.6000000238418579,2,1493,621,872,760384
2369,"['rush', 'fault']","['drama', 'rush', 'fault']",1.2000000476837158,2,1492,1118,374,139876
2370,"['stop', 'refixe', 'suffer', 'hate', 'news']","['prefix', 'suffer', 'hate', 'news']",2.400000095367432,3,3538,2219,1319,1739761
2371,"['miss', 'point', 'say', 'black', 'people', 'go', 'riot']","['black', 'go', 'riot']",2.400000095367432,3,3537,2218,1319,1739761
2372,"['met', 'declare']",[],2.0,0,178,1875,-1697,2879809
2373,"['proverb', 'john', 'baptist', 'nazarite', 'birth']","['john', 'baptist', 'nazarite', 'birth']",4.599999904632568,4,4567,5229,-662,438244
2374,"['james', 'say', 'faith', 'work', 'dead']","['paul', 'preach', 'faith', 'work']",2.200000047683716,2,1490,2111,-621,385641
2375,"['billion', 'world', 'mexico', 'current', 'prosperity', 'level']","['world', 'current', 'prosperity', 'level', 'northwest', 'africa']",1.5333333015441897,4,4556,1453,3103,9628609
2376,"['video', 'seismic', 'datum', 'equal', 'duration', 'collapse']","['seismic', 'datum', 'equal', 'duration', 'collapse']",4.599999904632568,5,4729,5232,-503,253009
2377,"['originally', 'post', 'box', 'say', 'multiple', 'time']","['originally', 'post', 'box', 'cranial', 'relate']",2.200000047683716,3,3407,2109,1298,1684804
2378,"['like', 'dramas', 'view']","['like', 'position', 'hold']",2.5999999046325684,1,899,2465,-1566,2452356
2379,"['actually', 'believe', 'iceberg', 'water']","['absolutely', 'believe', 'iceberg', 'water']",3.0,3,3406,2773,633,400689
2380,"['simply', 'winning', 'drama', 'conservative']","['rich', 'come', 'conservative']",1.399999976158142,1,889,1396,-507,257049
2381,"['satan', 'represent', 'indulgence', 'instead', 'abstinence']","['satan', 'represent', 'vengeance', 'instead', 'turn', 'cheek']",1.600000023841858,3,3277,1459,1818,3305124
2382,"['long', 'tax', 'sale', 'pay']","['long', 'tax', 'pay']",3.799999952316284,3,3276,4236,-960,921600
2383,"['fix', 'slam', 'political']","['slam', 'political']",1.2000000476837158,2,1483,1141,342,116964
2384,"['march', 'date', 'uprising', 'china']","['originally', 'post', 'vitchilo', 'march', 'date', 'uprising', 'china']",4.0,4,4552,4431,121,14641
2385,['hope'],"['hope', 'okay']",5.0,1,884,5484,-4600,21160000
2386,"['understand', 'absurd', 'limit', 'question', 'resident']","['understand', 'non', 'resident', 'relevant', 'statistic']",3.200000047683716,2,1478,3248,-1770,3132900
2387,"['see', 'ufo', 'warsaw', 'past']","['respectfully', 'submit', 'steve', 'see', 'ufo', 'warsaw', 'past']",4.0,4,4551,4432,119,14161
2388,"['depend', 'action', 'long', 'tune', 'agenda', 'moment']","['depend', 'action', 'bonny', 'tune', 'agenda']",4.599999904632568,4,4550,5236,-686,470596
2389,"['agree', 'claim']","['admit', 'verify', 'claim']",3.799999952316284,1,886,4207,-3321,11029041
2390,"['zimmerman', 'say', 'suck', 'punch', 'car']","['friend', 'confront', 'car']",2.400000095367432,1,887,2210,-1323,1750329
2391,"['war', 'middle', 'east']","['war', 'middle', 'east']",4.599999904632568,3,3271,5238,-1967,3869089
2392,"['pro', 'life', 'opposition', 'legalize', 'abortion']","['fro', 'life', 'refer', 'opposition', 'abortion']",3.799999952316284,3,3270,4206,-936,876096
2393,"['capital', 'gain', 'rate', 'percent']","['income', 'rate', 'percent']",2.799999952316284,2,1438,2688,-1250,1562500
2394,"['time', 'reason', 'hobbies', 'vessel', 'fill', 'wonder']","['theme', 'song', 'cheer', 'vessel', 'fill', 'wonder']",2.799999952316284,3,3268,2693,575,330625
2395,"['willfully', 'ignorant']","['lol', 'ignorant']",4.0,1,888,4466,-3578,12802084
2396,"['vessel', 'fill', 'wonder']","['single', 'lock', 'hobby', 'helm', 'vessel', 'fill', 'wonder']",3.0,3,3266,2772,494,244036
2397,"['problem', 'money']","['problem', 'money']",2.4666666984558105,2,1434,2327,-893,797449
2398,"['badly', 'word', 'accept', 'taxpayer', 'money']","['word', 'accept', 'taxpayer', 'money', 'save', 'company']",2.799999952316284,4,4546,2696,1850,3422500
2399,"['muslims', 'thing']","['sinus', 'thing', 'bhagavad', 'white']",1.0,1,890,1055,-165,27225
2400,"['confusion', 'liar']","['confusion', 'liar']",3.799999952316284,2,1432,4205,-2773,7689529
2401,"['christians', 'extreme', 'simply', 'religion']","['muslims', 'extreme', 'terrorist']",1.600000023841858,1,897,1496,-599,358801
2402,"['believe', 'right', 'important']","['believe', 'slaughter', 'unborn', 'important']",1.2000000476837158,2,1431,1136,295,87025
2403,"['evolution', 'opinion', 'belief']","['atomic', 'theory', 'opinion', 'belief']",1.600000023841858,2,1429,1500,-71,5041
2404,"['claim', 'right', 'decide', 'woman', 'body']","['want', 'decide', 'woman', 'body']",2.799999952316284,3,3263,2702,561,314721
2405,"['world', 'paul']","['world', 'medium']",0.800000011920929,1,891,762,129,16641
2406,"['remain', 'missile', 'pentagon']","['remain', 'pentagon']",2.400000095367432,2,1426,2182,-756,571536
2407,"['point', 'quote', 'say', 'rehabilitation', 'work']","['trillion', 'time', 'say', 'rehabilitation', 'work']",3.400000095367432,3,3262,3681,-419,175561
2408,"['billion', 'world', 'mexico', 'current', 'prosperity', 'level']","['world', 'current', 'prosperity', 'level', 'northwest', 'africa']",1.5333333015441897,4,4260,1451,2809,7890481
2409,"['hair', 'pretty', 'thing', 'quote']","['hair', 'pretty', 'thing', 'wood']",3.799999952316284,3,3261,4176,-915,837225
2410,"['stop', 'joke', 'marriage']","['fight', 'marriage']",1.2000000476837158,1,893,1123,-230,52900
2411,"['think', 'poor', 'people', 'responsible', 'action']","['people', 'responsible', 'action']",1.600000023841858,3,3260,1501,1759,3094081
2412,"['transaction', 'place']","['transaction', 'place']",2.400000095367432,2,1441,2180,-739,546121
2413,"['baggage', 'attach']",['thing'],0.0,0,175,245,-70,4900
2414,"['vessel', 'fill', 'wonder']","['little', 'love', 'heart', 'vessel', 'fill', 'wonder']",3.5999999046325684,3,3259,3906,-647,418609
2415,"['problem', 'money']","['problem', 'money']",2.4666666984558105,2,1457,2326,-869,755161
2416,"['make', 'think', 'owl', 'participate']",['participate'],1.600000023841858,1,895,1477,-582,338724
2417,"['ll', 'look', 'forward', 'see', 'build']","['take', 'forward', 'see']",1.7999999523162842,2,1453,1704,-251,63001
2418,"['originally', 'post', 'jack']","['originally', 'post', 'izzy']",1.2000000476837158,2,1449,1148,301,90601
2419,"['thank', 'bandy', 'start', 'thread']","['bandy', 'thank', 'start', 'today']",4.800000190734863,3,3258,5389,-2131,4541161
2420,[],[],1.0,0,174,1061,-887,786769
2421,"['owe', 'dollar', 'problem']","['owe', 'trillion', 'dollar', 'problem']",2.200000047683716,3,3257,2121,1136,1290496
2422,"['evidence', 'provide', 'support', 'position', 'reject']","['position', 'unverifiable', 'reject']",4.800000190734863,2,1422,5355,-3933,15468489
2423,"['current', 'prosperity', 'level', 'mexico']","['world', 'current', 'prosperity', 'level', 'northwest', 'africa']",1.399999976158142,3,3279,1421,1858,3452164
2424,"['rush', 'get', 'zero', 'credit', 'budget']","['drama', 'get', 'zero', 'credit', 'budget']",1.7999999523162842,4,4257,1689,2568,6594624
2425,"['lol', 'test', 'drive', 'vehicle']","['test', 'forearm']",0.800000011920929,1,916,793,123,15129
2426,"['think', 'movie', 'good', 'find', 'confuse', 'way']","['think', 'good', 'find', 'confusing']",3.200000047683716,3,3281,3255,26,676
2427,"['god', 'exist', 'morally', 'wrong']","['ask', 'god', 'exist', 'morally', 'wrong']",5.0,4,4256,5492,-1236,1527696
2428,"['law', 'constitutional', 'conflict', 'constitution']","['unconstitutional', 'mean', 'violate', 'constitution']",3.5999999046325684,1,917,3907,-2990,8940100
2429,"['originally', 'post', 'muslin', 'girl', 'loop', 'sorry']","['originally', 'post', 'muslin', 'girl', 'complete', 'impossibility']",1.2000000476837158,4,4255,1134,3121,9740641
2430,['country'],['country'],1.399999976158142,1,918,1289,-371,137641
2431,"['originally', 'post', 'zat', 'suppose', 'water', 'middle', 'make', 'difference']","['originally', 'post', 'zat', 'long', 'term', 'yes']",1.0,3,3301,1067,2234,4990756
2432,"['throw', 'game']","['die', 'loss', 'throw', 'game']",4.199999809265137,2,1450,4899,-3449,11895601
2433,"['edit', 'wash', 'edit', 'properly', 'mask', 'profundity']","['edit', 'wash', 'edit', 'properly', 'mask', 'profundity', 'quote', 'post']",4.800000190734863,5,4730,5409,-679,461041
2434,"['jury', 'tell', 'jury', 'nullification']","['quote', 'provide', 'jury', 'nullification']",1.600000023841858,2,1452,1484,-32,1024
2435,"['run', 'victim', 'proof']","['paranoid', 'proof']",1.0,1,938,1076,-138,19044
2436,"['use', 'search', 'button']","['use', 'search', 'button']",4.199999809265137,3,3297,4897,-1600,2560000
2437,"['think', 'paul', 'shot']","['paul', 'shot']",3.5999999046325684,2,1456,3908,-2452,6012304
2438,"['time', 'reason', 'hobbies', 'vessel', 'fill', 'wonder']","['boy', 'world', 'vessel', 'fill', 'wonder']",3.200000047683716,3,3296,3262,34,1156
2439,"['notice', 'nonsensical', 'thing', 'say']","['fair', 'notice', 'nonsensical', 'thing', 'say']",4.5714287757873535,4,4252,5149,-897,804609
2440,"['miss', 'study']","['personal', 'bias']",1.0,0,170,1077,-907,822649
2441,"['specifically', 'baptist']","['specifically', 'gnostic']",1.2000000476837158,1,940,1109,-169,28561
2442,"['large', 'east', 'coast']","['part', 'west', 'coast']",0.800000011920929,1,942,833,109,11881
2443,"['talk', 'woman', 'hebrew', 'tribe']","['talk', 'woman', 'war', 'bounty']",1.399999976158142,2,1484,1385,99,9801
2444,"['night', 'japanese', 'force', 'attack', 'long', 'long']","['night', 'japanese', 'force', 'attack', 'philippine', 'islands']",2.5999999046325684,4,4261,2447,1814,3290596
2445,"['definition', 'life', 'force']","['definition', 'soul']",3.5999999046325684,1,946,3832,-2886,8328996
2446,"['direct', 'responsibility', 'constituent']","['eye', 'responsible', 'constituent']",2.5999999046325684,1,948,2424,-1476,2178576
2447,"['ideology', 'build', 'violent', 'expansion', 'yes', 'violent', 'expansion']","['ideology', 'build', 'violent', 'expansion', 'race', 'superiority']",4.0,4,4247,4509,-262,68644
2448,['enema'],['enema'],4.599999904632568,1,949,5244,-4295,18447025
2449,"['final', 'word', 'ignore', 'effect', 'normalizing']","['take', 'advantage', 'effect', 'enforce']",0.4000000059604645,1,951,519,432,186624
2450,"['problem', 'likely', 'mean', 'corrective', 'change', 'scuttle', 'fleet', 'start', 'fly']","['say', 'problem', 'need', 'correct', 'space', 'scuttle', 'fleet', 'clear', 'fly']",4.400000095367432,4,4246,5058,-812,659344
2451,"['sec', 'chairman', 'william', 'donaldson', 'say', 'build', 'confidence', 'cop', 'beat']","['think', 'building', 'confidence', 'cop', 'beat']",3.400000095367432,3,3289,3480,-191,36481
2452,"['myanmar', 'pro', 'democracy', 'leader', 'hung', 'return', 'home', 'late', 'friday', 'remain', 'detention', 'recover', 'surgery', 'cannon', 'hospital', 'personal', 'physician', 'say']","['myanmar', 'pro', 'democracy', 'leader', 'hung', 'keep', 'house', 'arrest', 'follow', 'release', 'hospital', 'undergo', 'surgery', 'personal', 'physician', 'say', 'friday']",4.599999904632568,11,5676,5245,431,185761
2453,"['warren', 'pp', 'spitzer', 'spokesman', 'decline', 'comment', 'late', 'thursday']","['john', 'seine', 'spokesman', 'commission', 'washington', 'decline', 'comment', 'spitzer', 'criticism']",1.399999976158142,4,4245,1411,2834,8031556
2454,"['afternoon', 'trading', 'europe', 'france', 'advanced', 'britain', 'ftse', 'gain', 'percent', 'germany', 'dax', 'index', 'rise', 'percent']","['europe', 'france', 'rise', 'percent', 'britain', 'ftse', 'decline', 'percent', 'germany', 'dax', 'index', 'gain', 'percent']",2.0,10,5572,1779,3793,14386849
2455,"['ten', 'john', 'merry', 'mob', 'graham', 'decline', 'invitation', 'speak']","['show', 'ten', 'john', 'merry', 'massachusetts', 'mob', 'graham', 'florida']",3.5999999046325684,5,4727,3910,817,667489
2456,"['age', 'say', 'possible', 'genet', 'y', 'chromosome', 'influence', 'gender', 'specific', 'difference', 'disease', 'susceptibility']","['add', 'genet', 'y', 'play', 'role', 'influence', 'gender', 'specific', 'difference', 'disease', 'susceptibility']",4.400000095367432,8,5380,5072,308,94864
2457,"['study', 'face', 'temperament', 'people', 'respond', 'novelty']","['defining', 'study', 'characteristic', 'temperament', 'people', 'react', 'novelty']",4.800000190734863,4,4244,5411,-1167,1361889
2458,"['butterfly', 'expose', 'early', 'light', 'cycle', 'pm', 'orientate', 'south', 'east']","['butterfly', 'house', 'early', 'light', 'cycle', 'fly', 'southeast']",4.599999904632568,4,4243,5247,-1004,1008016
2459,"['dunlap', 'win', 'swimsuit', 'competition', 'talent', 'portion', 'competition', 'singe']","['win', 'talent', 'portion', 'singe', 'win', 'evening', 'wear']",2.799999952316284,4,4242,2738,1504,2262016
2460,"['south', 'asia', 'follow', 'million', 'youth', 'infect', 'percent', 'female']","['million', 'infect', 'south', 'asia', 'female']",4.0,5,4726,4519,207,42849
2461,"['hour', 'later', 'israel', 'helicopter', 'fire', 'missile', 'car', 'papa', 'city', 'kill', 'james', 'official', 'people']","['hour', 'later', 'israel', 'attack', 'helicopter', 'raise', 'missile', 'car', 'papa', 'city', 'kill', 'seven', 'people', 'palestinian', 'source', 'say']",4.25,10,5567,4939,628,394384
2462,"['aaa', 'spokesman', 'merry', 'say', 'price', 'affect', 'plan', 'cheap', 'hotel', 'deal', 'mitigate', 'effect']","['aaa', 'spokesman', 'merry', 'say', 'price', 'affect', 'plan', 'cheap', 'hotel', 'deal']",5.0,10,5573,5489,84,7056
2463,"['counter', 'million', 'say', 'turner', 'war', 'break', 'contract', 'cut', 'key', 'editorial', 'decision']","['counter', 'million', 'say', 'break', 'contract', 'cut', 'key', 'editorial', 'decision', 'manipulate', 'magazine', 'financial', 'figure']",3.5,9,5524,3714,1810,3276100
2464,"['standard', 'edition', 'processor', 'name', 'user']","['standard', 'edition', 'single', 'processor', 'version', 'oracle', 'standard', 'edition', 'database']",2.5,3,3283,2357,926,857476
2465,"['microsoft', 'acquire', 'virtual', 'buy', 'asset', 'connectix', 'early', 'year']","['microsoft', 'acquire', 'virtual', 'developer', 'connectix', 'early', 'year']",4.400000095367432,6,5087,5068,19,361
2466,"['leon', 'williams', 'body', 'find', 'inside', 'floor', 'apartment', 'tompkinsville']","['dead', 'man', 'leon', 'williams', 'find', 'floor', 'apartment']",3.400000095367432,5,4725,3425,1300,1690000
2467,"['drill', 'september', 'terrorist', 'attack', 'new', 'work', 'washington']","['nation', 'large', 'scale', 'counterterrorism', 'exercise', 'kept', 'terrorist', 'attack']",4.0,2,1376,4479,-3103,9628609
2468,"['cruel', 'risen', 'confirm', 'operate', 'coach', 'give', 'detail', 'passenger', 'mixed', 'age']","['cruel', 'risen', 'confirm', 'operate', 'coach', 'decline', 'detail', 'passenger', 'mixed', 'age']",4.800000190734863,9,5541,5441,100,10000
2469,"['total', 'case', 'confirm', 'southern', 'city', 'mavra', 'organization', 'say']","['total', 'confirm', 'case', 'cholera', 'report', 'yesterday', 'world', 'health', 'organisation', 'southern', 'iraqi', 'city', 'mavra']",3.5999999046325684,6,5133,3912,1221,1490841
2470,"['expect', 'visit', 'semen', 'bahrain', 'tour', 'region']","['khatami', 'arrive', 'beirut', 'monday', 'visit', 'syria', 'semen', 'bahrain']",3.400000095367432,3,3255,3423,-168,28224
2471,"['general', 'eyes', 'tell', 'reporter', 'blush', 'look', 'like', 'rule', 'break']","['blush', 'look', 'like', 'rule', 'break', 'say', 'men', 'richard', 'eyes', 'chairman', 'joint', 'chiefs', 'staff']",3.5999999046325684,6,5121,3915,1206,1454436
2472,"['prove', 'millville', 'son', 'sacrifice', 'mayor', 'james', 'ruin', 'order', 'city', 'flag', 'fly', 'half', 'mast', 'day']","['millville', 'yesterday', 'mayor', 'james', 'ruin', 'order', 'city', 'flag', 'fly', 'half', 'staff', 'day']",3.400000095367432,10,5569,3433,2136,4562496
2473,"['tom', 'kraynak', 'manager', 'operation', 'resource', 'wanton', 'ohio', 'base', 'central', 'area', 'reliability', 'council', 'say', 'scenario', 'investigator', 'consider']","['tom', 'kraynak', 'manager', 'operation', 'resource', 'wanton', 'ohio', 'base', 'central', 'area', 'reliability', 'council', 'say', 'investigator', 'consider', 'scenario']",4.25,16,5741,4946,795,632025
2474,"['find', 'molecule', 'produce', 'ozone', 'break', 'cholestrol']","['sample', 'contain', 'molecule', 'produce', 'cholestrol', 'interact', 'ozone']",4.25,4,4238,4934,-696,484416
2475,"['store', 'gigabyte', 'information', 'equivalent', 'hour', 'music', 'cubic', 'centimetre']","['store', 'gigabyte', 'information', 'equivalent', 'high', 'quality', 'image', 'hour', 'music', 'cubic', 'centimetre']",3.845999956130981,8,5409,4332,1077,1159929
2476,"['early', 'month', 'rim', 'say', 'expect', 'report', 'second', 'quarter', 'earning', 'cent', 'cent', 'share']","['exclude', 'legal', 'fee', 'charge', 'expect', 'loss', 'cent', 'share']",1.2000000476837158,3,3225,1107,2118,4485924
2477,"['lewinsky', 'imbroglio', 'like', 'vicious', 'scandal', 'manufacture', 'political', 'opponent', 'accord', 'extract', 'release', 'yesterday']","['lewinsky', 'imbroglio', 'like', 'vicious', 'scandal', 'manufacture', 'political', 'opponent', 'mrs', 'clinton', 'write']",3.200000047683716,8,5420,3245,2175,4730625
2478,"['wire', 'transfer', 'company', 'account', 'total', 'billion', 'prospector', 'say']","['fire', 'transfer', 'account', 'open', 'deacon', 'total', 'billion', 'morgenthau', 'say']",3.799999952316284,5,4721,4182,539,290521
2479,"['stony', 'rook', 'university', 'launch', 'study', 'early', 'study', 'indicate', 'possible', 'connection', 'electromagnetic', 'field', 'cancer']","['state', 'university', 'stony', 'rook', 'launch', 'study', 'early', 'study', 'indicate', 'possible', 'connection']",3.200000047683716,9,5481,3244,2237,5004169
2480,"['early', 'defy', 'police', 'order', 'cry', 'allah', 'bar', 'god', 'greatest', 'astir', 'walk', 'seat', 'tightly', 'guard', 'courtroom']","['early', 'astir', 'supporter', 'defy', 'police', 'order', 'cry', 'allah', 'bar', 'god', 'great', 'walk', 'seat']",4.0,11,5666,4473,1193,1423249
2481,"['metropolitan', 'ambulance', 'spokesman', 'james', 'owe', 'say', 'people', 'take', 'hospital', 'treat', 'scene', 'yesterday', 'incident']","['spokesman', 'james', 'owe', 'say', 'child', 'age', 'take', 'hospital', 'neck', 'chest', 'injury', 'treat', 'scene']",3.3329999446868896,8,5397,3406,1991,3964081
2482,"['clear', 'joint', 'intelligence', 'committee', 'involve']","['report', 'clear', 'joint', 'intelligence', 'committee']",2.0,4,4248,1959,2289,5239521
2483,"['twentysomething', 'obese', 'roughly', 'pound', 'healthy', 'weight']","['percent', 'americans', 'obese', 'roughly', 'pound', 'healthy', 'weight']",2.5999999046325684,5,4737,2381,2356,5550736
2484,"['doubling', 'american', 'version', 'hit', 'british', 'comedy', 'valuable', 'thursday', 'time', 'slot']","['doubling', 'american', 'version', 'hit', 'british', 'comedy', 'couple', 'friends', 'thursdays']",3.0,6,5047,3068,1979,3916441
2485,"['body', 'find', 'week', 'later', 'green', 'river']","['dug', 'remain', 'shopman', 'kinds', 'hills', 'find', 'green', 'river']",2.5999999046325684,3,3219,2376,843,710649
2486,"['fighting', 'continue', 'midnight', 'western', 'rebel', 'commander', 'humane', 'coulibaly', 'tell', 'letters', 'satellite', 'phone', 'sunday']","['ransack', 'burn', 'village', 'completely', 'rebel', 'commander', 'humane', 'coulibaly', 'tell', 'letters', 'satellite', 'phone', 'bush']",2.799999952316284,8,5400,2679,2721,7403841
2487,"['reading', 'august', 'july', 'well', 'see', 'survey', 'begin', 'august']","['high', 'reading', 'index', 'create', 'august']",3.0,2,1373,3058,-1685,2839225
2488,"['special', 'forces', 'troop', 'train', 'colombian', 'soldier', 'military', 'basis', 'region', 'protect', 'pipeline', 'transport', 'crude', 'colombia', 'second', 'big', 'oil', 'field']","['special', 'forces', 'troop', 'train', 'colombian', 'soldier', 'military', 'basis', 'region', 'protect', 'pipeline']",3.200000047683716,11,5693,3219,2474,6120676
2489,"['need', 'certifiable', 'pay', 'budget', 'mid', 'july', 'school', 'will', 'not', 'open', 'september', 'strayhorn', 'say']","['texas', 'lawmaker', 'close', 'million', 'budget', 'gap', 'middle', 'july', 'school', 'will', 'not', 'open', 'september', 'comptroller', 'parole', 'newton', 'strayhorn', 'say', 'thursday']",2.5999999046325684,9,5517,2374,3143,9878449
2490,"['share', 'hartford', 'rise', 'new', 'work', 'stock', 'exchange', 'composite', 'trading']","['share', 'hartford', 'percent', 'midday', 'trading']",2.5,3,3218,2358,860,739600
2491,"['dvd', 'cca', 'appeal', 'state', 'supreme', 'court']","['dvd', 'cca', 'appeal', 'decision', 'supreme', 'court']",4.5,5,4754,5146,-392,153664
2492,"['country', 'music', 'station', 'kkcs', 'suspend', 'disc', 'jockey', 'play', 'song', 'pirie', 'thick', 'violation', 'ban', 'impose', 'group', 'member', 'criticize', 'president', 'george', 'rush']","['radio', 'station', 'suspend', 'disc', 'jockey', 'lock', 'studio', 'continuously', 'play', 'pirie', 'thick', 'song', 'violate', 'station', 'month', 'old', 'ban', 'group', 'music']",3.25,11,5655,3368,2287,5230369
2493,"['sovereign', 'share', 'lose', 'cent']","['sovereign', 'share', 'close', 'new', 'work', 'stock', 'exchange', 'cent', 'percent']",4.0,3,3217,4521,-1304,1700416
2494,"['aspen', 'technology', 'share', 'drop', 'cent', 'percent', 'close', 'nasdaq']","['afternoon', 'trading', 'aspen', 'share', 'cent', 'percent', 'share']",2.200000047683716,4,4263,2134,2129,4532641
2495,"['new', 'law', 'require', 'library', 'school', 'use', 'filter', 'lose', 'federal', 'financing']","['ruling', 'reinstate', 'law', 'tell', 'library', 'install', 'filter', 'surrender', 'federal', 'money']",2.799999952316284,4,4264,2680,1584,2509056
2496,"['addition', 'offer', 'united', 'states', 'israel', 'way', 'work', 'draft']","['prime', 'minister', 'position', 'establish', 'spring', 'offer', 'united', 'states', 'israel', 'way', 'work', 'draft']",3.5999999046325684,7,5246,3925,1321,1745041
2497,"['yes', 'warily', 'monroe', 'definitely', 'story', 'title', 'arthur', 'miller', 'lie', 'kazan', 'blacklist']","['note', 'subheading', 'terrible', 'payable', 'american', 'masters', 'series', 'arthur', 'miller', 'lie', 'kazan', 'blacklist']",2.5999999046325684,5,4752,2420,2332,5438224
2498,"['gilroy', 'police', 'fbi', 'agent', 'describe', 'hear', 'cooperative', 'say', 'saturday', 'reveal', 'happen', 'child']","['saturday', 'official', 'california', 'describe', 'hearing', 'cooperative', 'say', 'reveal', 'happen', 'child']",3.799999952316284,7,5248,4183,1065,1134225
2499,"['scribner', 'body', 'find', 'float', 'city', 'mortgage', 'live', 'wife', 'houseboat']","['kayaker', 'find', 'scribner', 'body', 'float', 'near', 'doctor', 'houseboat', 'mortgage', 'eat', 'lunch', 'wife', 'ethel', 'leave', 'appointment']",3.200000047683716,7,5249,3226,2023,4092529
2500,"['protest', 'rush', 'stage', 'twice', 'cut', 'power', 'microphone', 'edge', 'draw', 'speech', 'early', 'close']","['protest', 'rush', 'stage', 'twice', 'cut', 'power', 'microphone', 'edge', 'cut', 'speech', 'short']",5.0,9,5507,5501,6,36
2501,"['pass', 'find', 'man', 'hide', 'dirt', 'road', 'spanish', 'work', 'canyon', 'hand', 'tap', 'foot', 'free']","['pass', 'find', 'boy', 'hide', 'dirt', 'road', 'spanish', 'work', 'canyon', 'thursday', 'foot', 'free', 'hand', 'tap']",4.0,12,5703,4478,1225,1500625
2502,"['doctor', 'boy', 'die', 'brain', 'damage', 'possible', 'survive']","['doctor', 'say', 'boy', 'die', 'survive', 'brain', 'damage', 'possible']",5.0,7,5250,5487,-237,56169
2503,"['miss', 'll', 'garden', 'sort', 'north', 'texas', 'vehicle', 'sweep', 'turnpike']","['victim', 'recover', 'tuesday', 'morning', 'll', 'garden', 'sort', 'north', 'texas']",2.200000047683716,5,4747,2069,2678,7171684
2504,"['british', 'base', 'glaxosmithkline', 'say', 'early', 'year', 'cut', 'supply', 'canadian', 'drugstore', 'ship', 'united', 'states']","['glaxosmithkline', 'drugmaker', 'say', 'cut', 'supply', 'canadian', 'store', 'ship', 'drug']",4.199999809265137,6,5074,4824,250,62500
2505,"['festival', 'kick', 'yesterday', 'day', 'competition', 'commission', 'deliver', 'final', 'verdict', 'government', 'propose', 'billion', 'merger']","['competition', 'commission', 'deliver', 'verdict', 'yesterday', 'propose', 'merger', 'big', 'itv', 'player', 'carlton', 'canada']",2.818000078201294,7,5261,2751,2510,6300100
2506,"['say', 'persist', 'eventually', 'allow', 'fix', 'bike', 'sit', 'seat', 'car']","['say', 'eventually', 'allow', 'fix', 'bike', 'sit', 'car', 'chat']",3.875,7,5242,4336,906,820836
2507,"['daniel', 'say', 'know', 'rush', 'tonight', 'person', 'presidential', 'fund', 'raise']","['daniel', 'say', 'know', 'rush', 'tonight', 'person', 'reception', 'raise', 'fund', 'presidential', 'election', 'bid']",4.400000095367432,9,5498,5070,428,183184
2508,"['judge', 'panel', 'circuit', 'court', 'appeals', 'rule', 'late', 'friday', 'small', 'size', 'limited', 'use', 'secular', 'purpose', 'image', 'legitimate']","['judge', 'panel', 'th', 'circuit', 'court', 'appeals', 'louis', 'overturn', 'ruling', 'issue', 'year', 'support', 'ordinance']",2.799999952316284,5,4745,2707,2038,4153444
2509,"['family', 'frog', 'know', 'identify', 'describe']","['family', 'frog', 'know', 'name']",3.799999952316284,3,3211,4184,-973,946729
2510,"['official', 'grandees', 'say', 'extremely', 'heartrende', 'time', 'camp']","['extremely', 'heartrende', 'time', 'entire', 'grandees', 'university', 'community']",4.400000095367432,4,4284,5046,-762,580644
2511,"['value', 'total', 'million', 'include', 'convertible', 'security', 'accord', 'morel']","['include', 'convertible', 'security', 'total', 'estimate', 'value', 'deal', 'million', 'accord', 'morel']",5.0,8,5390,5681,-291,84681
2512,"['start', 'super', 'bowl', 'diam', 'lose', 'washington']","['play', 'season', 'diam', 'include', 'dolphin', 'loss', 'washington', 'super', 'bowl']",3.0,4,4283,2952,1331,1771561
2513,"['enterprise', 'sinus', 'services', 'expect', 'available', 'end', 'year']","['beta', 'version', 'enterprise', 'sinus', 'services', 'expect', 'available', 'certain', 'proliant', 'serve', 'july']",2.6670000553131104,5,4744,2531,2213,4897369
2514,"['exclude', 'time', 'item', 'company', 'enjoy', 'profit', 'cent', 'share']","['exclude', 'time', 'item', 'expect', 'profit', 'cent', 'cent', 'share']",2.3329999446868896,6,5017,2169,2848,8111104
2515,"['question', 'motive', 'deskbound', 'president', 'assume', 'garb', 'warrior', 'purpose', 'speech']","['word', 'speak', 'senate', 'floor', 'say', 'question', 'motive', 'deskbound', 'president', 'assume', 'garb', 'warrior', 'purpose', 'speech']",3.0,9,5504,2953,2551,6507601
2516,"['broad', 'standard', 'door', 'index', 'fall', 'point', 'percent']","['technology', 'lace', 'nasdaq', 'composite', 'index', 'add', 'point', 'percent']",1.3329999446868896,3,3207,1264,1943,3775249
2517,"['instead', 'ticket', 'jersey', 'jam', 'go', 'sale', 'night', 'ticketmaster']","['ricket', 'available', 'ticketmaster', 'go', 'sale', 'yesterday']",3.799999952316284,3,3228,4185,-957,915849
2518,"['early', 'monday', 'grant', 'thornton', 'repeat', 'previous', 'statement', 'victim', 'fraudulent', 'action']","['grant', 'thornton', 'claim', 'victim', 'fraud']",3.400000095367432,3,3230,3490,-260,67600
2519,"['peter', 'man', 'pal', 'marian', 'berkeley', 'school', 'information', 'management', 'systems', 'information', 'production', 'increase', 'percent', 'year']","['task', 'appeal', 'master', 'megabyte', 'peter', 'man', 'pal', 'marian', 'professor', 'university', 'california', 'berkeley', 'school', 'information', 'management', 'systems']",2.0,9,5505,1902,3603,12981609
2520,"['judgment', 'percent', 'information', 'classify', 'uncensored', 'american', 'people', 'know']","['judgment', 'percent', 'information', 'classify', 'uncensored', 'american', 'people', 'know', 'shelby', 'say', 'nbc', 'feet', 'dress']",3.400000095367432,8,5388,3501,1887,3560769
2521,"['research', 'find', 'cavity', 'scar', 'tissue', 'tumour']","['tumour', 'detect', 'cavity', 'scar', 'tissue', 'find', 'place']",4.0,5,4743,4488,255,65025
2522,"['washington', 'say', 'need', 'prevent', 'complaint', 'file', 'place']","['insist', 'want', 'prevent', 'complaint', 'file', 'place', 'preferably', 'repeat', 'entire', 'law']",2.799999952316284,4,4282,2737,1545,2387025
2523,"['hour', 'surgery', 'year', 'anticipation', 'boy', 'separate', 'sunday', 'children', 'medical', 'enter', 'dallas']","['year', 'old', 'egyptian', 'twin', 'boy', 'bear', 'head', 'conjoin', 'separate', 'hour', 'surgery', 'children', 'medical', 'centre', 'dallas']",3.200000047683716,8,5386,3239,2147,4609609
2524,"['line', 'say', 'convene', 'relevant', 'party', 'body', 'day', 'discuss', 'new', 'election', 'hold', 'temporary', 'leader', 'appoint']","['mitzna', 'party', 'secretary', 'pair', 'lines', 'agree', 'convene', 'party', 'organization', 'day', 'discuss', 'new', 'primary', 'hold', 'temporary', 'leader', 'appoint']",3.5999999046325684,9,5511,3917,1594,2540836
2525,"['neuro', 'soar', 'sign', 'trading', 'slip', 'slightly', 'trading', 'open', 'europe']","['neuro', 'soar', 'sign', 'trading', 'slip', 'late', 'european', 'trading', 'late', 'monday']",3.5999999046325684,5,4741,3918,823,677329
2526,"['bias', 'tell', 'summit', 'end', 'armed', 'intefadeh', 'renounce', 'terrorist', 'israelis', 'allude', 'discarding', 'militant']","['wednesday', 'summit', 'bias', 'pledge', 'end', 'armed', 'intefadeh', 'renounce', 'terrorist', 'israelis', 'allude', 'discarding', 'militant']",4.199999809265137,11,5669,4828,841,707281
2527,"['god', 'ribbons', 'academy', 'spokesman', 'say', 'academy', 'shock', 'sadden']","['naval', 'academy', 'spokesman', 'god', 'ribbons', 'say', 'today', 'announcement', 'come', 'surprise']",3.25,5,4719,3360,1359,1846881
2528,"['share', 'lendingtree', 'rise', 'percent', 'hit', 'early']","['lendingtree', 'share', 'rise', 'percent', 'double', 'month']",2.75,4,4280,2567,1713,2934369
2529,"['week', 'lawyer', 'ask', 'earner', 'grant', 'clemency', 'condition', 'lead', 'new', 'sentencing', 'hearing']","['week', 'lawyer', 'ask', 'sov', 'dark', 'earner', 'grant', 'clemency', 'governor', 'decline', 'intervene']",2.5,6,5025,2334,2691,7241481
2530,"['think', 'release', 'year', 'ago', 'say', 'brian', 'rohrbough', 'son', 'daniel', 'kill', 'columbine']","['brian', 'rohrbough', 'son', 'daniel', 'kill', 'columbine', 'say', 'tape', 'raise', 'disturbing', 'issue']",1.75,7,5238,1618,3620,13104400
2531,"['cia', 'director', 'george', 'genet', 'say', 'man', 'define', 'education', 'courage']","['define', 'education', 'courage', 'say', 'cia', 'director', 'george', 'genet']",4.25,8,5403,4932,471,221841
2532,"['software', 'license', 'revenue', 'measure', 'financial', 'analysis', 'watch', 'closely', 'decrease', 'percent', 'million']","['license', 'sale', 'key', 'measure', 'demand', 'fall', 'percent', 'million']",5.0,4,4278,5682,-1404,1971216
2533,"['watson', 'arrest', 'charge', 'july', 'reportedly', 'tell', 'authority', 'shoot', 'dennehy', 'dennehy', 'try', 'shoot']","['watson', 'arrest', 'july', 'tell', 'fbi', 'agent', 'shoot', 'dennehy', 'dennehy', 'try', 'shoot', 'accord', 'arrest', 'warrant', 'affidavit']",4.25,7,5265,4930,335,112225
2534,"['prosecutor', 'contend', 'burst', 'plot', 'murder', 'assume', 'black', 'identity']","['prosecutor', 'maintain', 'burst', 'murder', 'black', 'try', 'assume', 'black', 'identity']",4.75,6,5030,5335,-305,93025
2535,"['objection', 'cite', 'peoplesoft', 'board', 'reject', 'oracle', 'offer']","['peoplesoft', 'board', 'recommend', 'stockholder', 'reject', 'offer']",2.75,4,4276,2565,1711,2927521
2536,"['black', 'democratic', 'leader', 'attempt', 'arrange', 'meeting', 'dnc', 'chairman', 'merry', 'mcauliffe', 'discuss', 'layoff']","['black', 'democratic', 'leader', 'try', 'arrange', 'meeting', 'democratic', 'national', 'committee', 'chairman', 'merry', 'mcauliffe', 'discuss', 'layoff', 'minority', 'suffer', 'party', 'headquarters']",3.25,10,5631,3349,2282,5207524
2537,"['dark', 'day', 'industry', 'giovanni', 'bisignani', 'director', 'general', 'geneva', 'base', 'organization', 'say', 'statement']","['dark', 'day', 'industry', 'geneva', 'base', 'international', 'air', 'transport', 'association', 'director', 'general', 'giovanni', 'bisignani', 'say']",3.5,10,5633,3743,1890,3572100
2538,"['seven', 'nation', 'initiative', 'britain', 'germany', 'italy', 'netherlands', 'poland', 'portugal', 'pain']","['nation', 'involve', 'psi', 'include', 'germany', 'italy', 'netherlands', 'poland', 'portugal', 'pain', 'britain']",3.5999999046325684,8,5419,3919,1500,2250000
2539,"['average', 'american', 'make', 'trip', 'day', 'percent', 'shopping', 'errand']","['early', 'half', 'percent', 'shopping', 'run', 'errand']",3.3329999446868896,3,3243,3419,-176,30976
2540,"['strategic', 'win', 'overture', 'give', 'night', 'bidder', 'option', 'sign', 'google', 'service']","['strategic', 'win', 'overture', 'give', 'night', 'bidder', 'google', 'advertising', 'service']",4.0,8,5418,4410,1008,1016064
2541,"['week', 'lead', 'execution', 'florida', 'official', 'receive', 'anonymous', 'threaten', 'letter']","['florida', 'official', 'connect', 'case', 'receive', 'threaten', 'letter', 'accompany', 'rifle', 'bullet']",3.5,5,4716,3734,982,964324
2542,"['boy', 'confirm', 'woman', 'age', 'tuesday', 'say', 'leave', 'vacation', 'family']","['boy', 'confirm', 'woman', 'age', 'tuesday', 'say', 'vacation', 'family', 'expect', 'return', 'week']",3.400000095367432,8,5417,3434,1983,3932289
2543,"['boston', 'catholic', 'archdiocese', 'boston', 'offer', 'million', 'settle', 'clergy', 'sex', 'abuse', 'lawsuit', 'accord', 'document', 'obtain', 'associated', 'dress']","['american', 'woman', 'catholic', 'archdiocese', 'boston', 'offer', 'million', 'settle', 'sex', 'abuse', 'lawsuit', 'involve', 'priest']",3.5999999046325684,9,5561,3920,1641,2692881
2544,"['hour', 'recording', 'include', 'conversation', 'police', 'firefighter', 'emergency', 'worker', 'medium', 'inquiry']","['conversation', 'police', 'firefighter', 'emergency', 'worker', 'medium', 'inquiry']",3.5999999046325684,7,5300,3921,1379,1901641
2545,"['year', 'bond', 'jump', 'take', 'yield', 'percent', 'percent']","['year', 'bond', 'dip', 'yield', 'percent', 'percent']",2.0,4,4275,1886,2389,5707321
2546,"['candidate', 'win', 'national', 'labor', 'endorsement', 'far', 'pick', 'union', 'tuesday', 'united', 'steelworkers', 'america', 'endorse']","['candidate', 'win', 'national', 'labor', 'endorsement', 'far', 'pick', 'tuesday']",3.5999999046325684,8,5416,3922,1494,2232036
2547,"['oracle', 'share', 'fall', 'cent', 'percent']","['oracle', 'share', 'rise', 'news', 'cent', 'nasdaq']",1.600000023841858,3,3239,1578,1661,2758921
2548,"['north', 'american', 'future', 'point', 'sub', 'par', 'start', 'trading', 'tuesday', 'investor', 'ready', 'taste', 'quarterly', 'earning']","['north', 'american', 'stock', 'market', 'get', 'slow', 'start', 'tuesday', 'investor', 'ready', 'taste', 'quarterly', 'earning']",4.599999904632568,9,5554,5248,306,93636
2549,"['market', 'broad', 'gauge', 'post', 'big', 'gain', 'having', 'climb', 'high', 'consecutive', 'week']","['broad', 'market', 'retreat', 'having', 'climb', 'high', 'consecutive', 'week']",3.5999999046325684,7,5302,3923,1379,1901641
2550,"['jury', 'celebrate', 'father', 'father', 'win', 'major', 'golf', 'championship']","['father', 'dad', 'major', 'champion']",3.0,2,1368,2939,-1571,2468041
2551,"['pass', 'emerson', 'medical', 'educational', 'research', 'foundation', 'limited', 'partnership', 'india']","['say', 'patient', 'allegedly', 'assign', 'india', 'emerson', 'medical', 'educational', 'research', 'foundation', 'limited', 'partnership']",2.400000095367432,8,5414,2191,3223,10387729
2552,"['sia', 'say', 'dram', 'market', 'expect', 'grow', 'percent', 'billion', 'percent', 'billion']","['american', 'market', 'decline', 'percent', 'billion', 'grow', 'percent', 'billion']",1.2000000476837158,4,4274,1137,3137,9840769
2553,"['morrill', 'wife', 'lie', 'sob', 'hug', 'bondeson', 'sister', 'law', 'service']","['service', 'morrill', 'widow', 'lie', 'sob', 'hug', 'bondeson', 'sister', 'law', 'people', 'console']",3.400000095367432,8,5411,3440,1971,3884841
2554,"['grassley', 'caucus', 'reject', 'disparity', 'drug', 'benefit']","['grassley', 'caucus', 'say', 'reject', 'approach', 'plan']",3.0,3,3234,2944,290,84100
2555,"['year', 'ago', 'quarter', 'steelmaker', 'record', 'profit', 'million', 'cent', 'share', 'sale', 'billion']","['second', 'quarter', 'year', 'steel', 'report', 'profit', 'million', 'cent', 'share']",3.400000095367432,6,5034,3542,1492,2226064
2556,"['nasdaq', 'weekly', 'gain', 'percent', 'close', 'friday']","['teach', 'lace', 'nasdaq', 'composite', 'rally', 'point', 'percent']",1.7999999523162842,2,1367,1647,-280,78400
2557,"['brazen', 'intimidation', 'people', 'reservation', 'say', 'republican', 'attend', 'want', 'name']","['brazen', 'attempt', 'intimidation', 'say', 'republican', 'legislator', 'attend', 'meeting']",3.5,5,4694,3695,999,998001
2558,"['charge', 'announce', 'statement', 'say', 'legal', 'proceeding', 'expect', 'monday']","['fbi', 'statement', 'say', 'legal', 'proceeding', 'expect', 'monday', 'federal', 'court', 'baltimore']",2.75,6,5040,2539,2501,6255001
2559,"['dead', 'woman', 'wear', 'ring', 'cartier', 'watch']","['blood', 'haired', 'woman', 'wear', 'cartier', 'watch', 'wrist', 'source', 'say']",2.5999999046325684,4,4270,2406,1864,3474496
2560,"['teach', 'heavy', 'nasdaq', 'stock', 'markets', 'composite', 'index', 'add', 'point', 'cent']","['nasdaq', 'composite', 'index', 'technology', 'stock', 'lately', 'point']",2.200000047683716,5,4693,2127,2566,6584356
2561,"['fbi', 'keep', 'tabe', 'al', 'bayoumi', 'receive', 'information', 'maude', 'agent', 'document', 'say']","['bureau', 'keep', 'tabe', 'al', 'bayoumi', 'despite', 'receive', 'prior', 'information', 'secret', 'maude', 'agent', 'report', 'say']",4.75,9,5546,5321,225,50625
2562,"['go', 'happen', 'say', 'santangelo', 'president', 'teamster', 'joint', 'council', 'll']","['affect', 'company', 'big', 'time', 'say', 'santangelo', 'president', 'teamster', 'joint', 'council', 'll']",1.5,7,5289,1426,3863,14922769
2563,"['release', 'million', 'bail', 'immediately', 'return', 'begin', 'fill', 'video']","['post', 'million', 'bail', 'jackson', 'fly', 'begin', 'work', 'video']",3.75,4,4267,4018,249,62001
2564,"['partner', 'analysis', 'say', 'business', 'feel', 'confident', 'upgrade', 'corporate']","['company', 'feel', 'confident', 'replace', 'old', 'analyst', 'firm', 'say']",3.5,3,3393,3699,-306,93636
2565,"['tuesday', 'health', 'care', 'worker', 'quarante']","['addition', 'people', 'quarante', 'thousand', 'health', 'care', 'worker', 'working', 'quarante']",1.5,4,4266,1428,2838,8054244
2566,"['brian', 'brabazon', 'say', 'son', 'upset', 'turn', 'befriend', 'hunter']","['son', 'upset', 'mon', 'say', 'turn', 'befriend', 'hunter']",3.200000047683716,6,5115,3317,1798,3232804
2567,"['teach', 'heavy', 'nasdaq', 'stock', 'markets', 'composite', 'index', 'add', 'point']","['nasdaq', 'composite', 'index', 'technology', 'stock', 'lately', 'point']",2.200000047683716,5,4691,2066,2625,6890625
2568,"['technology', 'lace', 'nasdaq', 'composite', 'index', 'dip', 'point']","['technology', 'lace', 'nasdaq', 'composite', 'index', 'add', 'point', 'percent']",2.400000095367432,6,5120,2204,2916,8503056
2569,"['tell', 'jury', 'tubes', 'cold', 'calculate', 'killer']","['district', 'attorney', 'lupus', 'remind', 'rumor', 'tubes', 'cold', 'calculate', 'killer']",3.0,4,4265,2997,1268,1607824
2570,"['likewise', 'year', 'bond', 'slide', 'yield', 'percent', 'percent']","['year', 'bond', 'jump', 'take', 'yield', 'percent', 'percent']",1.7999999523162842,4,4235,1637,2598,6749604
2571,"['seventh', 'victim', 'woman', 'die', 'tuesday', 'night', 'burn', 'unit', 'child', 'hospital', 'medical', 'enter', 'akron']","['seventh', 'person', 'year', 'old', 'woman', 'critical', 'condition', 'burn', 'unit', 'akron', 'children', 'hospital']",2.400000095367432,6,5125,2203,2922,8538084
2572,"['man', 'immediately', 'fly', 'nearby', 'botswana', 'charter', 'air', 'kalaw', 'flight', 'kalaw', 'intelligence', 'official', 'say', 'condition', 'anonymity']","['man', 'fly', 'nearby', 'botswana', 'air', 'kalaw', 'flight', 'official', 'say']",3.532999992370605,9,5559,3745,1814,3290596
2573,"['exchange', 'north', 'require', 'end', 'nuclear', 'weapon', 'program']","['return', 'expect', 'north', 'nuclear', 'weapon']",4.75,3,3375,5331,-1956,3825936
2574,"['condemn', 'denounce', 'governing', 'council', 'head', 'united', 'states', 'moqtada', 'al', 'say']","['condemn', 'governing', 'council', 'head', 'united', 'states', 'say', 'fiery', 'sermon', 'sofa', 'mosque', 'near', 'ajar']",3.3329999446868896,7,5273,3404,1869,3493161
2575,"['sendmail', 'say', 'system', 'set', 'permit', 'business', 'usage']","['product', 'instruct', 'permit', 'business', 'use', 'accord', 'sendmail']",5.0,3,3374,5691,-2317,5368489
2576,"['exploit', 'work', 'snatch', 'windows', 'machine', 'service']","['counterpaned', 'defense', 'contend', 'exploit', 'work', 'effectively', 'windows', 'system', 'run', 'service']",3.0,4,4206,3004,1202,1444804
2577,"['curve', 'benchmark', 'year', 'note', 'shed', 'price', 'take', 'yield', 'percent', 'percent']","['early', 'wednesday', 'benchmark', 'year', 'lose', 'price', 'drive', 'yield', 'percent', 'percent', 'late', 'tuesday']",3.0,5,4688,2977,1711,2927521
2578,"['lech', 'stock', 'hurt', 'sour', 'forecast', 'run', 'microsystems', 'view', 'bad', 'oman', 'come', 'quarterly', 'earning', 'season']","['sour', 'forecast', 'run', 'microsystems', 'pressure', 'street', 'quarterly', 'earning', 'season']",3.0,7,5277,2970,2307,5322249
2579,"['share', 'joke', 'cent', 'afternoon', 'trading', 'wednesday', 'new', 'work', 'stock', 'exchange']","['share', 'joke', 'cent', 'close', 'new', 'work', 'stock', 'exchange']",1.8459999561309808,7,5282,1773,3509,12313081
2580,"['rest', 'young', 'deny', 'wrongdoing', 'plan', 'fight', 'allegation']","['rest', 'young', 'deny', 'sec', 'claim', 'call', 'recommendation', 'irresponsible']",3.0,3,3370,2974,396,156816
2581,"['military', 'action', 'large', 'scale', 'bribery', 'solve', 'north', 'organ', 'problem', 'wolfowitz', 'say']","['wolfowitz', 'admit', 'saturday', 'military', 'action', 'large', 'scale', 'bribery', 'solve', 'issue']",3.0,7,5284,2976,2308,5326864
2582,"['driver', 'eugene', 'rogers', 'help', 'remove', 'child', 'bus', 'good', 'say']","['accident', 'scene', 'driver', 'cover', 'blood', 'help', 'remove', 'child', 'good', 'say']",3.200000047683716,6,5132,3320,1812,3283344
2583,"['broad', 'standard', 'door', 'index', 'point', 'percent']","['teach', 'lace', 'nasdaq', 'composite', 'index', 'gain', 'point', 'percent']",1.0,3,3369,915,2454,6022116
2584,"['share', 'guidant', 'plummet', 'trading', 'new', 'work', 'stock', 'exchange', 'news', 'halt', 'impose', 'midday']","['share', 'guidant', 'percent', 'afternoon', 'trading', 'new', 'work', 'stock', 'exchange']",2.6470000743865967,7,5285,2527,2758,7606564
2585,"['week', 'october', 'go', 'sale', 'monday', 'nearly', 'year', 'washington', 'supper', 'shooting', 'start']","['loose', 'book', 'go', 'sale', 'monday', 'nearly', 'year', 'supper', 'shooting', 'start', 'washington', 'area']",3.25,9,5549,3345,2204,4857616
2586,"['base', 'separate', 'survey', 'household', 'unemployment', 'rate', 'fall', 'august', 'percent', 'percent']","['labor', 'department', 'analysis', 'dismount', 'slight', 'improvement', 'national', 'unemployment', 'rate', 'fall', 'august', 'percent', 'percent']",3.75,5,4687,4017,670,448900
2587,"['rate', 'skin', 'cancer', 'triple', 'norway', 'sweden', 'accord', 'study']","['study', 'find', 'skin', 'cancer', 'nearly', 'triple', 'norway', 'sweden']",4.75,6,5134,5323,-189,35721
2588,"['judge', 'refuse', 'postpone', 'trial', 'date', 'kept']","['bus', 'deny', 'defense', 'motion', 'postpone', 'kept', 'trial', 'date']",3.928999900817871,4,4406,4339,67,4489
2589,"['opposition', 'party', 'welcome', 'cabinet', 'decision', 'anti', 'retroviral', 'treatment', 'say', 'health', 'minister', 'santo', 'tshabalala', 'msimang', 'fit', 'preside', 'roylott', 'plan']","['health', 'minister', 'santo', 'tshabalala', 'msimang', 'fit', 'preside', 'anti', 'retroviral', 'treatment', 'roylott', 'plan', 'accord', 'opposition', 'party']",3.400000095367432,14,5736,3478,2258,5098564
2590,"['chief', 'merchandising', 'officer', 'overseer', 'buying', 'development', 'merchandise', 'decide', 'merchandising', 'direction', 'company', 'basically', 'stand']","['decide', 'merchandising', 'direction', 'company', 'basically', 'stand']",3.200000047683716,6,5106,3322,1784,3182656
2591,"['christopher', 'spokesman', 'archdiocese', 'comment', 'friday']","['christopher', 'spokesman', 'archdiocese', 'immediately', 'return', 'call', 'seek', 'comment']",3.799999952316284,4,4203,4186,17,289
2592,"['relative', 'australian', 'victim', 'attack', 'court', 'witness', 'proceeding', 'balinese', 'attend', 'trial']","['relative', 'australian', 'victim', 'attack', 'sit', 'row', 'court', 'balinese', 'attend', 'trial']",4.599999904632568,8,5372,5246,126,15876
2593,"['july', 'team', 'singaporean', 'police', 'officer', 'send', 'baghdad']","['july', 'singaporean', 'police', 'officer', 'send', 'baghdad', 'help', 'train', 'iraqi', 'police', 'force', 'return', 'home', 'month']",3.200000047683716,6,5079,3318,1761,3101121
2594,"['neuro', 'percent', 'dollar', 'rise', 'month', 'high', 'early', 'session']","['early', 'trading', 'neuro', 'percent', 'rise', 'month', 'high']",2.200000047683716,6,5080,1990,3090,9548100
2595,"['previously', 'report', 'profit', 'million', 'cent', 'share', 'period']","['previously', 'report', 'small', 'profit', 'million', 'break', 'share', 'basis', 'period']",4.400000095367432,6,5081,5039,42,1764
2596,"['coalition', 'campaign', 'group', 'include', 'militant', 'national', 'student', 'body', 'back', 'protest', 'nlc', 'call', 'defiance', 'court', 'order', 'bank']","['coalition', 'campaign', 'group', 'include', 'militant', 'national', 'student', 'body', 'back', 'action', 'mobilize', 'protest']",3.3329999446868896,10,5636,3402,2234,4990756
2597,"['company', 'highlight', 'addition', 'support', 'enterprise', 'application', 'environment', 'eae', 'new', 'mainframe']","['company', 'add', 'support', 'enterprise', 'application', 'environment', 'development', 'tool', 'rapp', 'say']",4.0,5,4685,4352,333,110889
2598,"['draft', 'service', 'rack', 'record', 'accident', 'death']","['conquered', 'safety', 'record', 'include', 'accident', 'result', 'death']",1.3329999446868896,3,3363,1261,2102,4418404
2599,"['harvey', 'outfielder', 'dunedin', 'high', 'school', 'florida', 'select', 'sixth', 'pick', 'chicago', 'tubs']","['harvey', 'high', 'school', 'outfielder', 'florida', 'choose', 'sixth', 'tubs']",4.199999809265137,7,5280,4801,479,229441
2600,"['lover', 'speak', 'news', 'conference', 'include', 'relative', 'victim']","['family', 'member', 'victim', 'invite', 'news', 'conference']",3.200000047683716,3,3361,3304,57,3249
2601,"['man', 'charge', 'june', 'plead', 'guilty']","['defendant', 'plead', 'guilty', 'weapon', 'charge', 'count']",3.200000047683716,3,3360,3282,78,6084
2602,"['federal', 'local', 'government', 'remained', 'largely', 'shut', 'aftermath', 'hurricane', 'isabel', 'school', 'region', 'transportation', 'network', 'slow']","['aftermath', 'hurricane', 'isabel', 'federal', 'local', 'government', 'remained', 'shut', 'school', 'business']",3.25,9,5522,3347,2175,4730625
2603,"['give', 'surprisingly', 'impassione', 'speech', 'united', 'steelworkers', 'america', 'announce', 'endorsement', 'yesterday']","['tuesday', 'pick', 'endorsement', 'united', 'steelworkers', 'america']",2.25,4,4202,2161,2041,4165681
2604,"['million', 'phone', 'number', 'register', 'list', 'effect', 'act']","['ftc', 'sign', 'million', 'phone', 'number', 'list', 'effect', 'october']",3.5,5,4684,3693,991,982081
2605,"['second', 'hit']","['water', 'second']",2.200000047683716,1,935,1982,-1047,1096209
2606,"['dora', 'naacp', 'state', 'president', 'say', 'state', 'try', 'prove', 'conclusion', 'suicide', 'consider', 'possibility', 'murder']","['dora', 'naacp', 'state', 'president', 'say', 'state', 'refuse', 'consider', 'possibility', 'murder']",3.400000095367432,8,5381,3670,1711,2927521
2607,"['activist', 'fear', 'gathering', 'attempt', 'corporate', 'farming', 'push', 'big', 'engineer', 'crop', 'starve', 'country']","['instead', 'fear', 'conference', 'attempt', 'corporate', 'farming', 'bitch', 'interest', 'push', 'new', 'market']",3.0,5,4683,2938,1745,3045025
2608,"['contract', 'expire', 'wednesday', 'instead', 'sunday', 'say', 'organize', 'director', 'united', 'good', 'commercial', 'workers', 'local']","['outrage', 'membership', 'say', 'organize', 'director', 'united', 'good', 'commercial', 'workers', 'local']",2.5,8,5363,2355,3008,9048064
2609,"['technology', 'lace', 'nasdaq', 'composite', 'index', 'rise', 'point', 'percent', 'lose', 'percent', 'tuesday']","['blue', 'chip', 'bones', 'industrial', 'average', 'jump', 'point', 'percent', 'sink', 'percent', 'day', 'early']",1.75,2,1395,1603,-208,43264
2610,"['customer', 'power', 'area', 'oklahoma', 'electric', 'say']","['oge', 'energy', 'customer', 'power', 'company', 'say', 'web', 'site']",2.75,3,3381,2557,824,678976
2611,"['glance', 'american', 'husband', 'year', 'old', 'roger', 'lawrence', 'trunk', 'face', 'murder', 'indictment', 'issue', 'february', 'philippine', 'government', 'say', 'lead', 'suspect']","['glance', 'husband', 'year', 'old', 'roger', 'lawrence', 'trunk', 'gray', 'face', 'murder', 'indictment', 'issue', 'philippine', 'government', 'february']",4.25,14,5737,4929,808,652864
2612,"['prince', 'replace', 'afford', 'bandy', 'remain', 'citigroup', 'chairman']","['prince', 'head', 'citigroup', 'global', 'corporate', 'investment', 'bank', 'replace', 'afford', 'ceo']",3.0,4,4199,2934,1265,1600225
2613,"['operating', 'revenue', 'billion', 'increase', 'year', 'result', 'billion']","['operating', 'revenue', 'rise', 'billion', 'billion', 'year']",5.0,4,4198,5701,-1503,2259009
2614,"['spot', 'gold', 'quote', 'ounce', 'gmt', 'having', 'march', 'level', 'see', 'february']","['spot', 'gold', 'quote', 'ounce', 'gmt', 'having', 'dart', 'high', 'level', 'see', 'february']",3.25,9,5525,3350,2175,4730625
2615,"['canada', 'booming', 'dollar', 'focus', 'try', 'stay', 'cent', 'mark']","['canada', 'surge', 'dollar', 'focus', 'struggle', 'fail', 'stay', 'cent', 'mark']",4.0,6,5088,4344,744,553536
2616,"['justice', 'rule', 'police', 'supervisor', 'repeatedly', 'question', 'martinet', 'violate', 'fifth', 'amendment', 'right']","['justice', 'rule', 'police', 'supervisor', 'repeatedly', 'question', 'martinet', 'scream', 'pain', 'violate', 'fifth', 'amendment', 'right']",3.75,11,5697,4014,1683,2832489
2617,"['blue', 'chip', 'bones', 'industrial', 'average', 'cease', 'point', 'percent', 'score', 'consecutive', 'session']","['bones', 'industrial', 'average', 'rise', 'point', 'percent']",2.0,5,4699,1934,2765,7645225
2618,"['center', 'president', 'joseph', 'torsella', 'strike', 'head', 'able', 'walk', 'ambulance']","['national', 'constitution', 'enter', 'president', 'joseph', 'torsella', 'hit', 'head', 'knock', 'knee']",3.3329999446868896,4,4196,3408,788,620944
2619,"['report', 'range', 'large', 'company', 'base', 'employment', 'marketing', 'procurement', 'community', 'investment', 'charitable', 'donation']","['millard', 'respond', 'survey', 'range', 'large', 'company', 'employment', 'marketing', 'procurement', 'community', 'investment', 'charitable', 'donation']",3.0,10,5629,2958,2671,7134241
2620,"['know', 'person', 'talk', 'end', 'time', 'follow', 'rule', 'parish', 'say']","['know', 'person', 'talk', 'end', 'parish', 'say']",3.400000095367432,6,5097,3574,1523,2319529
2621,"['suffer', 'attorney', 'murder', 'charge', 'authority', 'say']","['suffer', 'lawyer', 'murder', 'charge', 'authority', 'say']",5.0,5,4714,5692,-978,956484
2622,"['pass', 'effect', 'law', 'illegal', 'bar', 'restaurant', 'patron', 'light']","['pass', 'effect', 'smoking', 'law', 'prevent', 'bar', 'restaurant', 'patron', 'light', 'exempt', 'private', 'club', 'regulation']",3.400000095367432,7,5271,3578,1693,2866249
2623,"['trial', 'suspect', 'year', 'ali', 'nightclub', 'coming', 'kill', 'people', 'open', 'indonesia', 'today', 'sky', 'news', 'report']","['key', 'suspect', 'october', 'nightclub', 'coming', 'kill', 'people', 'ali', 'go', 'trial', 'monday', 'amid', 'tight', 'security']",3.75,7,5270,4013,1257,1580049
2624,"['french', 'retire', 'increase', 'fifth', 'population']","['retire', 'account', 'population', 'fifth', 'today']",4.0,3,3398,4368,-970,940900
2625,"['iraqi', 'police', 'open', 'fire', 'downtown', 'baghdad', 'today', 'demonstrator', 'storm', 'police', 'station', 'demand', 'give', 'job', 'claim', 'pay', 'bribe']","['iraqi', 'police', 'open', 'fire', 'downtown', 'baghdad', 'wednesday', 'demonstrator', 'demand', 'job', 'storm', 'police', 'station', 'throw', 'stone', 'officer', 'police', 'say']",3.25,11,5684,3357,2327,5414929
2626,"['bones', 'industrial', 'average', 'add', 'point', 'percent', 'hit', 'high', 'level', 'month']","['bones', 'industrial', 'average', 'rise', 'point', 'percent']",2.25,5,4712,2144,2568,6594624
2627,"['quarter', 'year', 'eds', 'declare', 'profit', 'million', 'cent', 'share']","['eds', 'report', 'quarter', 'loss', 'million', 'cent', 'share']",1.5,5,4711,1434,3277,10738729
2628,"['microsoft', 'fall', 'percent', 'open', 'thursday', 'close']","['share', 'microsoft', 'slip', 'percent', 'hour', 'trade', 'nasdaq', 'close']",3.0,3,3397,3057,340,115600
2629,"['extraordinarily', 'fast', 'say', 'watt', 'seller', 'analyst', 'cibc', 'world', 'markets']","['actually', 'go', 'record', 'sale', 'decade', 'year', 'say', 'watt', 'seller', 'analyst', 'cibc', 'world', 'markets']",2.25,7,5267,2149,3118,9721924
2630,"['rebel', 'government', 'force', 'accuse', 'pillaging', 'village', 'siberia', 'countryside', 'despite', 'peace', 'agreement']","['rebel', 'government', 'force', 'include', 'loyal', 'taylor', 'accuse', 'pillaging', 'village', 'siberia', 'countryside', 'despite', 'peace', 'deal']",4.0,10,5623,4391,1232,1517824
2631,"['microsoft', 'award', 'patent', 'feature', 'instant', 'essay', 'alert', 'user', 'person', 'communicate', 'put', 'message']","['microsoft', 'award', 'patent', 'popular', 'instant', 'essay', 'feature', 'show', 'user', 'person', 'end', 'conversation', 'tie', 'message']",4.75,9,5533,5320,213,45369
2632,"['arrest', 'reveal', 'new', 'detail', 'month', 'investigation', 'selenski', 'count', 'live', 'road', 'home']","['kerkowski', 'bassett', 'body', 'unearth', 'selenski', 'count', 'live', 'road', 'home', 'june']",1.5,5,4710,1450,3260,10627600
2633,"['intend', 'appeal', 'vigorously', 'expect', 'vindicate', 'ultimately']","['think', 'bad', 'law', 'expect', 'vindicate', 'ultimately']",3.066999912261963,3,3392,3073,319,101761
2634,"['kansas', 'law', 'illegal', 'child', 'age', 'sexual', 'relation']","['opinion', 'line', 'note', 'illegal', 'child', 'young', 'sexual', 'relation']",2.75,4,4194,2538,1656,2742336
2635,"['transaction', 'expand', 'callebaut', 'sale', 'revenue', 'consumer', 'product', 'business', 'percent', 'percent']","['transaction', 'expand', 'callebaut', 'sale', 'revenue', 'consumer', 'product', 'business', 'percent', 'total', 'sale']",3.5,9,5536,3696,1840,3385600
2636,"['indonesia', 'army', 'accuse', 'human', 'right', 'abuse', 'gam', 'battle', 'independence', 'charge', 'generally', 'deny', 'accuse', 'separatist', 'commit', 'right', 'violation']","['indonesia', 'army', 'accuse', 'human', 'right', 'abuse', 'early', 'battle', 'gam', 'charge', 'generally', 'deny']",3.25,11,5680,3353,2327,5414929
2637,"['ran', 'economy', 'ravage', 'year', 'sanction', 'ex', 'president', 'madam', 'russen', 'occupation', 'wait', 'war', 'end', 'april']","['ran', 'economy', 'shatter', 'president', 'madam', 'russen', 'war', 'end', 'april']",3.75,8,5412,4012,1400,1960000
2638,"['point', 'word', 'refugee', 'english', 'turkish', 'dictionary']","['man', 'banish', 'english', 'turkish', 'dictionary', 'point', 'word', 'refugee']",3.799999952316284,6,5129,4188,941,885481
2639,"['bulk', 'fund', 'billion', 'military', 'operation', 'ran', 'afghanistan']","['bulk', 'bill', 'billion', 'go', 'military', 'operation', 'primarily', 'ran', 'afghanistan']",4.0,6,5033,4396,637,405769
2640,"['colored', 'hoy', 'colorado', 'springs', 'solo', 'help', 'legislation', 'pende', 'congress']","['colored', 'hoy', 'colorado', 'springs', 'type', 'person', 'help', 'legislation', 'pende', 'congress']",4.800000190734863,8,5446,5450,-4,16
2641,"['advance', 'issue', 'outnumber', 'decline', 'new', 'work', 'stock', 'exchange']","['decline', 'issue', 'outnumber', 'advance', 'slightly', 'new', 'work', 'stock', 'exchange']",2.200000047683716,8,5468,2016,3452,11916304
2642,"['beauty', 'contest', 'hold', 'italy', 'week', 'fix', 'perfect', 'pin']","['new', 'beauty', 'contest', 'kick', 'italy', 'week', 'fix', 'perfect', 'pin', 'chance', 'steal', 'sultry', 'sophia', 'sex', 'symbol', 'status']",3.25,7,5309,3355,1954,3818116
2643,"['analysis', 'consensus', 'estimate', 'thomson', 'loss', 'share', 'exclude', 'time', 'item']","['estimate', 'analysis', 'survey', 'thomson', 'loss', 'share']",2.5,5,4709,2344,2365,5593225
2644,"['board', 'expect', 'decide', 'december', 'meeting', 'offer', 'airplane', 'sale', 'airline']","['widely', 'expect', 'hair', 'formal', 'approval', 'offer', 'plane', 'sale', 'airline']",2.25,4,4205,2155,2050,4202500
2645,"['rush', 'say', 'resistance', 'force', 'hostile', 'presence', 'feel', 'like', 'condition', 'attack']","['feel', 'like', 'condition', 'attack']",2.75,4,4193,2551,1642,2696164
2646,"['defense', 'lawyer', 'say', 'change', 'venue', 'need', 'massive', 'arterial', 'publicity', 'paint', 'jury', 'pool', 'client']","['defense', 'lawyer', 'request', 'change', 'venue', 'reason', 'argue', 'massive', 'arterial', 'publicity', 'paint', 'jury', 'pool', 'client']",4.75,11,5679,5328,351,123201
2647,"['wound', 'lendingtree', 'exchange', 'consist', 'bank', 'lender', 'broker']","['lendingtree', 'match', 'borrower', 'internet', 'mortgage', 'broker', 'bank', 'lender']",3.5,4,4191,3700,491,241081
2648,"['taxpayer', 'surprise', 'tax', 'cut', 'week', 'july']","['australia', 'million', 'income', 'taxpayer', 'receive', 'surprise', 'tax', 'cut', 'week', 'treasurer', 'peter', 'costello', 'night']",3.25,5,4707,3356,1351,1825201
2649,"['gyorgy', 'leisler', 'head', 'local', 'disaster', 'unit', 'say', 'coach', 'carry', 'passenger']","['head', 'local', 'disaster', 'unit', 'gyorgy', 'leisler', 'say', 'coach', 'driver', 'fail', 'heed', 'red', 'stop', 'light']",3.0,8,5470,3042,2428,5895184
2650,"['suction', 'year', 'private', 'college', 'average', 'year', 'percent']","['current', 'academic', 'year', 'suction', 'public', 'college', 'average', 'year']",1.5,4,4190,1436,2754,7584516
2651,"['statewide', 'unemployment', 'rate', 'fall', 'percent', 'revise', 'percent', 'august']","['unemployment', 'rate', 'joaquin', 'county', 'dip', 'month', 'percent', 'nearly', 'percentage', 'point', 'august']",2.0,4,4189,1862,2327,5414929
2652,"['security', 'light', 'instal', 'police', 'sweep', 'ground', 'booby', 'trap']","['security', 'light', 'instal', 'barn', 'near', 'gate']",3.0,3,3330,2860,470,220900
2653,"['troop', 'shrink', 'mount', 'maid', 'attack', 'foe', 'location', 'pinpoint']","['american', 'troop', 'shrink', 'mount', 'maid', 'location', 'foe', 'pinpoint']",4.75,7,5306,5322,-16,256
2654,"['moore', 'immediate', 'comment', 'tuesday']","['moore', 'immediate', 'response', 'tuesday']",4.777999877929688,3,3328,5343,-2015,4060225
2655,"['judge', 'order', 'child', 'place', 'state', 'custody', 'dug']","['dug', 'juvenile', 'court', 'judge', 'robert', 'states', 'order', 'parker', 'place', 'protective', 'custody']",3.200000047683716,5,4704,3301,1403,1968409
2656,"['white', 'house', 'spokesman', 'ri', 'fleischer', 'say', 'yesterday', 'step', 'iranians', 'claim', 'take', 'term', 'capture', 'al', 'insufficient']","['step', 'iranians', 'claim', 'take', 'term', 'capture', 'al', 'said', 'insufficient']",3.200000047683716,8,5460,3300,2160,4665600
2657,"['result', 'release', 'tuesday', 'meeting', 'seattle', 'american', 'thoracic', 'society', 'publish', 'thursday', 'new', 'england', 'journal', 'medicine']","['study', 'result', 'release', 'meeting', 'seattle', 'american', 'thoracic', 'society', 'publish', 'tomorrow', 'issue', 'new', 'england', 'journal', 'medicine']",4.363999843597412,12,5702,4958,744,553536
2658,"['dissent', 'join', 'chief', 'justice', 'william', 'rehnquist', 'justice', 'lawrence', 'thomas']","['chief', 'justice', 'william', 'rehnquist', 'justices', 'antonio', 'scala', 'lawrence', 'thomas', 'dissent']",3.799999952316284,7,5305,4204,1101,1212201
2659,"['united', 'pay', 'city', 'million', 'penalty', 'meet', 'round', 'employment', 'target']","['united', 'pay', 'million', 'penalty', 'fail', 'meet', 'employment', 'target']",4.400000095367432,7,5303,5075,228,51984
2660,"['shelled', 'office', 'report', 'friday', 'signature', 'report']","['shelled', 'office', 'release', 'signature', 'count', 'late', 'friday', 'say', 'county', 'report', 'count', 'signature', 'far']",4.5,5,4703,5129,-426,181476
2661,"['rush', 'want', 'aircraft', 'land', 'way', 'pilot', 'see', 'aircraft', 'landing', 'white', 'house', 'press', 'secretary', 'ri', 'fleischer', 'say', 'yesterday']","['tuesday', 'word', 'speech', 'fleischer', 'say', 'rush', 'want', 'aircraft', 'land', 'way', 'pilot', 'see', 'aircraft', 'landing']",4.0,10,5637,4370,1267,1605289
2662,"['stand', 'reporter', 'photographer', 'yard', 'prison', 'gate', 'rent', 'newbury', 'president', 'auckland', 'county', 'patrolmen', 'benevolent', 'association']","['thing', 'brave', 'fume', 'rent', 'newbury', 'president', 'auckland', 'county', 'patrolmen', 'benevolent', 'association']",1.5,8,5467,1449,4018,16144324
2663,"['brutally', 'beat', 'wonder', 'porchia', 'deceased', 'case']","['wonder', 'porchia', 'deceased', 'case', 'tax', 'add']",3.0,4,4185,3030,1155,1334025
2664,"['glove', 'say', 'unifi', 'official', 'mob']","['knife', 'official', 'mob', 'say', 'glove']",5.0,4,4183,5694,-1511,2283121
2665,"['rate', 'whitney', 'say', 'cent', 'engine', 'equipment', 'outsource', 'europe', 'final', 'assembly', 'germany']","['rate', 'whitney', 'say', 'win', 'contract', 'cent', 'engine', 'equipment', 'outsource', 'european', 'supplier', 'final', 'assembly', 'germany']",3.5999999046325684,10,5620,3914,1706,2910436
2666,"['staff', 'writer', 'selwyn', 'crawford', 'pollen', 'chain', 'elson', 'brian', 'anderson', 'contribute', 'report']","['staff', 'writer', 'brandon', 'formby', 'pollen', 'chain', 'elson', 'contribute', 'report']",2.799999952316284,7,5296,2578,2718,7387524
2667,"['commerce', 'commission', 'significant', 'hardly', 'deal']","['new', 'zealand', 'commerce', 'commission', 'give', 'westpac', 'indication', 'approve', 'deal']",1.7999999523162842,3,3321,1762,1559,2430481
2668,"['prosecutor', 'file', 'motion', 'inform', 'intend', 'seek', 'death', 'penalty']","['add', 'prospector', 'seek', 'death', 'penalty']",3.400000095367432,3,3320,3589,-269,72361
2669,"['american', 'masters', 'arthur', 'miller', 'lie', 'kazan', 'blacklist', 'red']","['note', 'subheading', 'terrible', 'payable', 'american', 'masters', 'series', 'arthur', 'miller', 'lie', 'kazan', 'blacklist']",3.0,7,5295,3018,2277,5184729
2670,"['package', 'include', 'increase', 'city', 'sale', 'income', 'taxis']","['object', 'sale', 'personal', 'income', 'tax', 'increase', 'package']",2.0,4,4192,1924,2268,5143824
2671,"['song', 'offer', 'cent', 'album']","['company', 'offer', 'song', 'cent', 'album']",3.3329999446868896,4,4207,3416,791,625681
2672,"['certainly', 'know', 'suggest', 'say', 'seriously', 'add']","['know', 'know', 'suggest', 'say', 'seriously', 'say']",4.25,4,4220,4911,-691,477481
2673,"['follette', 'share', 'rise', 'percent', 'afternoon', 'new', 'work', 'stock', 'exchange', 'trading']","['share', 'follette', 'close', 'cent', 'trading', 'wednesday', 'new', 'work', 'stock', 'exchange']",2.0,7,5264,1923,3341,11162281
2674,"['share', 'diego', 'base', 'box', 'close', 'cent', 'percent', 'new', 'work', 'stock', 'exchange']","['share', 'camp', 'base', 'outback', 'steakhouse', 'close', 'percent', 'new', 'work', 'stock', 'exchange']",1.600000023841858,8,5426,1542,3884,15085456
2675,"['bones', 'industrial', 'climb', 'point', 'mark', 'time', 'december']","['bones', 'industrial', 'briefly', 'surpass', 'mark', 'time', 'december']",3.5999999046325684,5,4756,3903,853,727609
2676,"['government', 'choose', 'company', 'develop', 'plan', 'protect', 'commercial', 'aircraft', 'shoulder', 'fire', 'missile', 'attack', 'holland', 'security', 'official', 'announce', 'tuesday']","['department', 'copeland', 'security', 'announce', 'tuesday', 'select', 'company', 'continue', 'research', 'way', 'thwart', 'shoulder', 'fire', 'missile', 'attack', 'commercial', 'aircraft']",4.75,10,5594,5329,265,70225
2677,"['family', 'party', 'blame', 'liberation', 'tigers', 'family', 'delay', 'ltte', 'killing']","['government', 'want', 'revive', 'talk', 'liberation', 'tigers', 'family', 'delay', 'ltte', 'discuss', 'interim', 'structure']",1.75,5,4811,1612,3199,10233601
2678,"['prisons', 'bandy', 'mitchell', 'glasgow', 'glasgow', 'bear', 'william', 'sampson', 'face', 'death', 'penalty']","['bandy', 'mitchell', 'kirkintilloch', 'glasgow', 'william', 'sampson', 'british', 'citizen', 'bear', 'glasgow', 'face', 'head', 'public']",3.25,7,5290,3352,1938,3755844
2679,"['urge', 'patience', 'americans', 'eager', 'service', 'intend', 'block', 'percent', 'telemarketing', 'call']","['free', 'service', 'originally', 'intend', 'block', 'percent', 'telemarketer', 'call']",3.0,5,4757,3052,1705,2907025
2680,"['jordan', 'green', 'relate', 'private', 'lawyer', 'say', 'comment']","['attorney', 'jordan', 'green', 'decline', 'comment']",3.5999999046325684,3,3315,3882,-567,321489
2681,"['valley', 'new', 'partner', 'child', 'say', 'absolutely', 'delighted']","['statement', 'issue', 'solicitor', 'valley', 'say', 'absolutely', 'delighted', 'outcome', 'proceeding']",3.400000095367432,4,4208,3606,602,362404
2682,"['loss', 'occur', 'overnight', 'pillow', 'canyon', 'area', 'santa', 'natalia', 'mountains', 'threaten', 'week', 'old', 'fire', 'blacken', 'acre']","['loss', 'occur', 'overnight', 'pillow', 'canyon', 'area', 'santa', 'natalia', 'mountains', 'threaten', 'recurrent', 'aspen', 'fire']",3.25,11,5682,3351,2331,5433561
2683,"['want', 'stand', 'let', 'credit', 'card', 'lunching', 'place', 'declare', 'major', 'wens', 'd', 'brooklyn']","['want', 'stand', 'credit', 'card', 'lunching', 'place', 'say']",3.5,6,5043,3697,1346,1811716
2684,"['commercial', 'use', 'keener', 'month', 'customer']","['commercial', 'release', 'keener', 'major', 'sinus', 'distributor', 'remain', 'month', 'away']",3.78600001335144,3,3314,4062,-748,559504
2685,"['broad', 'standard', 'door', 'index', 'advance', 'point', 'percent']","['nasdaq', 'composite', 'index', 'point', 'percent']",0.800000011920929,3,3313,810,2503,6265009
2686,"['official', 'initially', 'say', 'worker', 'arrest', 'store', 'state']","['official', 'later', 'revise', 'number', 'say', 'arrest', 'store']",2.400000095367432,4,4232,2213,2019,4076361
2687,"['deal', 'make', 'sense', 'company', 'say', 'prepared', 'statement']","['brian', 'ceo', 'natsemi', 'claim', 'deal', 'sense', 'company']",3.200000047683716,3,3311,3294,17,289
2688,"['seven', 'senator', 'include', 'republicans', 'sign', 'letter']","['sign', 'letter', 'senator', 'include', 'republicans']",4.922999858856201,5,4808,5483,-675,455625
2689,"['human', 'case', 'west', 'mile', 'virus', 'report', 'yes', 'county', 'health', 'department', 'wednesday']","['week', 'human', 'west', 'mile', 'case', 'county', 'report', 'health', 'department']",2.5999999046325684,8,5441,2450,2991,8946081
2690,"['daniel', 'group', 'enter', 'united', 'states', 'walk', 'bridge', 'link', 'matamoros', 'brownsville']","['daniel', 'group', 'enter', 'way', 'thousand', 'people', 'day', 'walk', 'bridge', 'matamoros', 'brownsville']",4.0,7,5263,4384,879,772641
2691,"['nasd', 'regulation', 'young', 'file', 'response', 'request', 'hearing', 'nasd', 'panel']","['analyst', 'let', 'merrily', 'request', 'hearing', 'nasd', 'panel']",3.0,4,4231,3010,1221,1490841
2692,"['president', 'begin', 'speech', 'acknowledge', 'terrorist', 'attack', 'maude', 'arabia', 'kill', 'people', 'include', 'seven', 'americans']","['rush', 'lash', 'terrorist', 'coming', 'maude', 'arabia', 'kill', 'people', 'include', 'number', 'americans']",3.200000047683716,7,5259,3292,1967,3869089
2693,"['proud', 'citizen', 'state', 'sov', 'john', 'baldacci', 'say', 'vote', 'referendum', 'count']","['proud', 'citizen', 'state', 'say', 'sov', 'john', 'baldacci', 'causing', 'foe']",3.200000047683716,7,5231,3291,1940,3763600
2694,"['major', 'candidate', 'schwarzenegger', 'dine', 'battle', 'independent', 'crossover', 'voter']","['schwarzenegger', 'pick', 'independent', 'crossover', 'voter', 'bustamante']",3.400000095367432,4,4230,3558,672,451584
2695,"['replace', 'dittemore', 'announce', 'resignation', 'april']","['dittemore', 'announce', 'plan', 'resign', 'april']",2.5999999046325684,3,3308,2515,793,628849
2696,"['selenski', 'previously', 'spend', 'seven', 'year', 'prison', 'bank', 'robbery', 'conviction']","['selenski', 'serve', 'seven', 'year', 'prison', 'bank', 'robbery']",4.571000099182129,6,5066,5148,-82,6724
2697,"['maddox', 'crack', 'rib', 'fall', 'day', 'ago', 'assisted', 'living', 'home', 'recover', 'intestinal', 'surgery', 'virginia', 'varies', 'say']","['maddox', 'battle', 'cancer', 'crack', 'rib', 'early', 'month', 'fall', 'assisted', 'living', 'home', 'recover', 'surgery']",3.400000095367432,9,5545,3552,1993,3972049
2698,"['graham', 'presidential', 'candidate', 'criticize', 'republicans', 'politicize', 'report']","['graham', 'co', 'haired', 'inquiry', 'presidential', 'candidate']",2.25,3,3354,2142,1212,1468944
2699,"['linksys', 'overtake', 'disco', 'systems', 'lead', 'tireless', 'equipment', 'vendor', 'account', 'percent', 'revenue']","['wolfe', 'say', 'linksys', 'overtake', 'disco', 'systems', 'year', 'lead', 'supplier', 'wlan', 'equipment']",3.5,6,5059,3694,1365,1863225
2700,"['school', 'fail', 'meet', 'state', 'goal', 'year', 'row', 'offer', 'tutoring', 'addition', 'transfer']","['school', 'meet', 'testing', 'goal', 'year', 'row', 'offer', 'transfer']",2.75,7,5236,2547,2689,7230721
2701,"['hamper', 'medicine', 'lucrative', 'arrest', 'live', 'million', 'dollar', 'home']","['hamper', 'medicine', 'apparently', 'lucrative', 'investigator', 'say', 'suspect', 'live', 'million', 'dollar', 'home']",4.75,7,5232,5333,-101,10201
2702,"['say', 'faith', 'system', 'licks', 'try']","['say', 'yesterday', 'licks', 'fairly', 'treat', 'say', 'faith', 'justice', 'system']",4.5,4,4229,5138,-909,826281
2703,"['smuggler', 'van', 'chase', 'picked', 'suv', 'carry', 'smuggler', 'illegal', 'immigrant', 'say', 'final', 'county', 'sheriff', 'roger', 'vanderpool']","['people', 'van', 'open', 'fire', 'picked', 'suv', 'believe', 'transport', 'illegal', 'immigrant', 'say', 'final', 'county', 'sheriff', 'roger', 'vanderpool']",3.1670000553131104,11,5675,3077,2598,6749604
2704,"['trial', 'fear', 'witness', 'continue', 'start']","['trial', 'early', 'expect', 'hear', 'witness', 'friday']",4.5,2,1404,5136,-3732,13927824
2705,"['computer', 'reportedly', 'locate', 'canada', 'south']","['scatter', 'united', 'states', 'canada', 'south']",4.75,2,1406,5336,-3930,15444900
2706,"['vulnerability', 'affect', 'windows', 'terminal', 'services', 'edition', 'windows', 'server']","['microsoft', 'issue', 'patch', 'vulnerability', 'affect', 'windows', 'windows', 'terminal', 'services', 'edition', 'windows', 'windows', 'windows', 'server']",2.75,7,5233,2559,2674,7150276
2707,"['additional', 'contribution', 'bring', 'total', 'food', 'aid', 'north', 'year', 'tone']","['donation', 'ton', 'bring', 'total', 'contribution', 'year']",3.200000047683716,4,4227,3288,939,881721
2708,"['european', 'union', 'banner', 'import', 'genetically', 'modify', 'food', 'united', 'states', 'demand', 'end', 'ban']","['union', 'banner', 'import', 'genetically', 'modify', 'food', 'consumer', 'fear', 'health', 'risk']",2.5999999046325684,6,5104,2507,2597,6744409
2709,"['project', 'vanderpool', 'available', 'year']","['product', 'fear', 'vanderpool', 'release', 'year', 'say']",4.400000095367432,2,1365,5115,-3750,14062500
2710,"['annika', 'sorenstam', 'get', 'opportunity', 'test', 'objective', 'week', 'mcdonald', 'lpga', 'championship']","['appetite', 'devour', 'annika', 'sorenstam', 'move', 'entree', 'week', 'mcdonald', 'lpga', 'championship']",3.0,6,5136,2933,2203,4853209
2711,"['broad', 'standard', 'door', 'index', 'gain', 'point', 'percent']","['technology', 'lace', 'nasdaq', 'composite', 'index', 'rise', 'point', 'percent']",0.944000005722046,3,3346,891,2455,6027025
2712,"['disco', 'sign', 'similar', 'deal', 'sbc', 'communications', 'print']","['disco', 'similar', 'relationship', 'bellsouth', 'competitor', 'sbc', 'communications', 'print', 'communications']",4.0,5,4805,4389,416,173056
2713,"['harris', 'klebold', 'kill', 'student', 'teacher', 'take', 'life', 'april']","['harris', 'klebold', 'kill', 'student', 'teacher', 'school']",3.799999952316284,5,4803,4194,609,370881
2714,"['condemn', 'governing', 'council', 'head', 'united', 'states', 'muqtada', 'al', 'say', 'sermon', 'mosque']","['condemn', 'denounce', 'governing', 'council', 'head', 'united', 'states', 'moqtada', 'al', 'say']",4.199999809265137,8,5452,4862,590,348100
2715,"['statement', 'distribute', 'friday', 'chechen', 'non', 'governmental', 'organization', 'say', 'boycott', 'vote']","['statement', 'distribute', 'today', 'chechen', 'non', 'governmental', 'organization', 'say', 'boycott', 'vote', 'warn', 'voter', 'expect', 'fraud']",4.199999809265137,9,5515,4865,650,422500
2716,"['state', 'population', 'accord', 'census']","['state', 'population', 'grow', 'percent']",2.5999999046325684,2,1385,2388,-1003,1006009
2717,"['july', 'hulbert', 'file', 'single', 'count', 'felony', 'sexual', 'assault', 'bryant']","['bryant', 'charge', 'felony', 'sexual', 'assault']",3.055999994277954,4,4222,3071,1151,1324801
2718,"['paul', 'chairman', 'chief', 'executive', 'wiseman', 'ceo', 'combine', 'company']","['wiseman', 'chairman', 'chief', 'executive', 'paul', 'chief', 'executive', 'combine', 'company']",4.75,7,5312,5339,-27,729
2719,"['instead', 'media', 'decide', 'webster', 'case', 'charge', 'rape', 'sooty', 'indecent', 'assault', 'provide', 'alcohol', 'minor', 'proceed', 'court', 'martial']","['douglas', 'webster', 'charge', 'rape', 'sooty', 'indecent', 'assault', 'provide', 'alcohol', 'minor']",3.25,9,5487,3348,2139,4575321
2720,"['similar', 'discovery', 'houston', 'aircraft', 'dallas', 'base', 'southwest', 'say', 'statement']","['airline', 'say', 'similar', 'discovery', 'plane', 'houston']",3.400000095367432,4,4233,3635,598,357604
2721,"['rosenthal', 'decline', 'comment', 'garrett', 'situation', 'tuesday', 'say', 'statement', 'big', 'contract', 'negotiation']","['creator', 'executive', 'producer', 'phil', 'rosenthal', 'equip', 'statement', 'big', 'contract', 'negotiation']",3.75,5,4802,4001,801,641601
2722,"['power', 'state', 'worker', 'head', 'job', 'friday', 'morning']","['pataki', 'say', 'power', 'restore', 'state', 'worker', 'job', 'friday', 'morning']",2.5999999046325684,6,5065,2383,2682,7193124
2723,"['nasdaq', 'fall', 'month', 'snap', 'seven', 'month', 'winning', 'streak']","['nasdaq', 'roughly', 'percent', 'month', 'track', 'snap', 'month', 'streak', 'gain']",2.400000095367432,4,4221,2193,2028,4112784
2724,"['report', 'find', 'act', 'tuck', 'inside', 'old', 'ring', 'binder', 'relate', 'investigation']","['report', 'find', 'week', 'tuck', 'inside', 'training', 'manual', 'belong', 'licks']",3.200000047683716,4,4219,3281,938,879844
2725,"['saturday', 'international', 'committee', 'red', 'cross', 'say', 'temporarily', 'close', 'office', 'baghdad', 'mavra']","['international', 'committee', 'red', 'cross', 'fearful', 'safety', 'staff', 'operate', 'ran', 'announce', 'temporarily', 'shut', 'office', 'baghdad', 'mavra']",3.400000095367432,8,5449,3641,1808,3268864
2726,"['ireland', 'palestine', 'solidarity', 'campaign', 'o', 'muireagáin', 'member', 'welcome', 'release']","['ireland', 'palestine', 'solidarity', 'campaign', 'member', 'say', 'search', 'school', 'exchange', 'project']",2.400000095367432,5,4801,2194,2607,6796449
2727,"['lover', 'say', 'killer', 'peculiar', 'slipknot', 'ligature', 'strangle', 'victim']","['lover', 'say', 'killer', 'peculiar', 'slipknot', 'include', 'cordial', 'cable', 'extension', 'cord', 'strangle', 'victim']",3.400000095367432,7,5254,3545,1709,2920681
2728,"['say', 'lane', 'toe', 'lawyer', 'ask', 'horizon', 'withhold', 'plan', 'challenge', 'subpoena']","['lane', 'toe', 'decide', 'fight', 'subpoena', 'ask', 'horizon', 'withhold']",3.5999999046325684,6,5072,3886,1186,1406596
2729,"['september', 'year', 'old', 'singapore', 'researcher', 'contract', 'sars', 'work', 'laboratory']","['case', 'august', 'year', 'old', 'laboratory', 'worker', 'singapore', 'develop', 'sars']",3.400000095367432,5,4800,3455,1345,1809025
2730,"['number', 'suggest', 'contraction', 'manufacturing', 'sector', 'number', 'indicate', 'expansion']","['reading', 'suggest', 'growth', 'sector', 'number', 'level', 'indicate', 'contraction']",4.817999839782715,5,4799,5479,-680,462400
2731,"['lawsuit', 'file', 'attempt', 'block', 'removal', 'men', 'commandments', 'monument', 'building']","['supporter', 'ask', 'federal', 'court', 'monday', 'block', 'removal', 'men', 'commandments', 'monument', 'alabama', 'judicial', 'building']",3.200000047683716,6,5018,3277,1741,3031081
2732,"['fritz', 'earn', 'million', 'salary', 'bonus', 'compensation', 'dinner', 'earn', 'million']","['johnston', 'million', 'salary', 'bonus', 'president', 'time', 'adviser', 'earn', 'million']",1.399999976158142,4,4217,1299,2918,8514724
2733,"['truck', 'spot', 'campbell', 'greek', 'area', 'fit', 'description', 'morris', 'say']","['black', 'pick', 'truck', 'see', 'campbell', 'greek', 'area', 'morris', 'say']",3.0,6,5022,2978,2044,4177936
2734,"['chairman', 'michael', 'lowell', 'fcc', 'colleague', 'wednesday', 'hearing']","['fcc', 'chief', 'michael', 'lowell', 'preside', 'hear', 'monday']",3.200000047683716,3,3337,3303,34,1156
2735,"['bones', 'industrial', 'average', 'cent', 'nasdaq', 'composite', 'index', 'cent', 'high']","['street', 'bones', 'industrial', 'average', 'rise', 'cent', 'nasdaq', 'composite', 'add', 'cent']",1.7999999523162842,6,5026,1722,3304,10916416
2736,"['tehran', 'clear', 'sign', 'additional', 'protocol', 'introduce', 'inspection', 'ban', 'import', 'civilian', 'western', 'nuclear', 'technology', 'lift']","['tehran', 'clear', 'sign', 'protocol', 'ban', 'import', 'peaceful', 'western', 'nuclear', 'technology', 'lift']",3.799999952316284,10,5592,4196,1396,1948816
2737,"['congress', 'twice', 'pass', 'similar', 'restriction', 'president', 'clinton', 'veto']","['congress', 'twice', 'pass', 'similar', 'bill', 'president', 'clinton', 'veto', 'time']",4.599999904632568,7,5251,5243,8,64
2738,"['talk', 'high', 'standard', 'low', 'standard']","['talk', 'positive', 'number', 'negative']",2.799999952316284,1,925,2580,-1655,2739025
2739,"['program', 'official', 'work', 'foreign', 'port', 'authority', 'identify', 'target', 'search', 'high', 'risk', 'cargo']","['program', 'official', 'work', 'foreign', 'port', 'authority', 'seek', 'high', 'risk', 'cargo', 'reach', 'united', 'states']",4.25,9,5509,4919,590,348100
2740,"['field', 'tell', 'interview', 'think', 'old', 'outlive', 'year']","['year', 'death', 'neilsen', 'tell', 'interview', 'think', 'rock', 'face', 'outlive', 'year']",3.0,5,4797,2983,1814,3290596
2741,"['apt', 'mcdonald', 'remained', 'hospitalize', 'critical', 'condition', 'thursday']","['year', 'old', 'sister', 'allison', 'severely', 'burn', 'remained', 'hospitalize', 'critical', 'condition']",0.75,4,4216,744,3472,12054784
2742,"['wednesday', 'total', 'national', 'guard', 'reserve', 'member', 'call', 'active', 'duty', 'worldwide', 'stand']","['yesterday', 'total', 'number', 'national', 'guard', 'reserve', 'troop', 'call', 'duty', 'worldwide', 'stand']",4.0,8,5435,4395,1040,1081600
2743,"['period', 'nearly', 'decade', 'telemarketing', 'associates', 'raise', 'million']","['telemarketing', 'associates', 'hire', 'vietnow', 'raise', 'million']",3.5999999046325684,4,4215,3887,328,107584
2744,"['body', 'invercargill', 'man', 'warren', 'campbell', 'climb', 'companion', 'jonathan', 'smith', 'recover', 'late', 'yesterday', 'morning']","['warren', 'david', 'campbell', 'climb', 'companion', 'jonathan', 'smith', 'return', 'expect', 'tuesday', 'climb', 'mckenzie', 'district']",2.200000047683716,6,5039,2007,3032,9193024
2745,"['geoghan', 'live', 'protective', 'custody', 'unit', 'transfer', 'prison', 'april']","['protective', 'custody', 'transfer', 'souza', 'baranowski', 'april', 'official', 'say']",2.799999952316284,4,4212,2581,1631,2660161
2746,"['democratic', 'platform', 'support', 'inclusion', 'gay', 'lesion', 'family', 'life', 'nation']","['democrat', 'platform', 'explicitly', 'support', 'gay', 'marriage', 'back', 'inclusion', 'gay', 'lesion', 'family', 'life', 'nation']",3.200000047683716,8,5430,3326,2104,4426816
2747,"['share', 'fall', 'cent', 'percent', 'hour', 'trading']","['stock', 'rise', 'cent', 'percent', 'close', 'regular', 'session', 'nasdaq', 'trading']",1.25,3,3609,1257,2352,5531904
2748,"['hundred', 'reporter', 'photographer', 'swamp', 'courthouse', 'ground', 'hearing', 'carry', 'live', 'national', 'cable', 'network']","['hundred', 'reporter', 'photographer', 'swamp', 'town', 'short', 'hearing', 'involve', 'time', 'star', 'carry', 'live', 'national', 'cable', 'network']",3.0,10,5591,2975,2616,6843456
2749,"['amd', 'chip', 'sale', 'jump', 'percent', 'year', 'year', 'million']","['second', 'quarter', 'sale', 'grow', 'percent', 'million', 'million']",2.200000047683716,3,3762,2067,1695,2873025
2750,"['myelia', 'haney', 'wilson', 'agitated', 'come', 'help', 'prepare', 'turner', 'monumental', 'church', 'come', 'anniversary', 'celebration', 'worshiper', 'say']","['congregant', 'turner', 'monumental', 'ame', 'church', 'say', 'myelia', 'haney', 'wilson', 'agitated', 'come', 'church', 'firewood', 'neighborhood', 'city', 'east']",3.5999999046325684,9,5494,3889,1605,2576025
2751,"['ice', 'diamonds', 'pack', 'card', 'depict', 'iraqi', 'fugitive', 'issue', 'troop']","['ace', 'diamond', 'deck', 'card', 'show', 'picture', 'want', 'iraqi', 'leader']",4.0,2,1364,4366,-3002,9012004
2752,"['miodrag', 'zivkovic', 'liberal', 'alliance', 'montenegro', 'win', 'percent', 'vote', 'independent', 'organ', 'hajdukovic', 'get', 'percent']","['pro', 'independence', 'radical', 'miodrag', 'zivkovic', 'liberal', 'alliance', 'come', 'second', 'percent', 'vote']",3.0,6,5076,2971,2105,4431025
2753,"['far', 'georgia', 'return', 'money', 'wire']","['georgia', 'receive', 'money', 'help', 'fbi']",3.75,2,1374,4004,-2630,6916900
2754,"['island', 'nation', 'report', 'new', 'case', 'day', 'record', 'new', 'case', 'make', 'taiwan', 'epidemic', 'fattest', 'grow', 'world']","['taiwan', 'report', 'new', 'case', 'day', 'record', 'new', 'case', 'make', 'epidemic', 'world', 'fattest', 'grow']",5.0,11,5674,5696,-22,484
2755,"['tub', 'outfielder', 'army', 'rosa', 'suspend', 'game', 'major', 'league', 'baseball', 'friday', 'cork', 'bat']","['army', 'rosa', 'suspend', 'game', 'major', 'league', 'baseball', 'friday', 'cork', 'bat', 'immediately', 'appeal', 'decision']",3.200000047683716,10,5590,3328,2262,5116644
2756,"['half', 'woman', 'give', 'daily', 'dose', 'drug', 'half', 'take', 'place']","['half', 'woman', 'receive', 'daily', 'tablet', 'combination', 'oestrogen', 'plus', 'protest', 'rest', 'give', 'place']",3.200000047683716,5,4796,3329,1467,2152089
2757,"['police', 'remove', 'home', 'weigh', 'pound', 'combine']","['boy', 'weigh', 'pound', 'remove', 'home', 'act']",3.0,4,4211,2989,1222,1493284
2758,"['ibrahims', 'separation', 'operation', 'goodrich', 'david', 'staffenberg', 'plan', 'aguirres', 'week']","['instead', 'long', 'operation', 'separate', 'twin', 'goodrich', 'david', 'staffenberg', 'plan', 'week']",3.5999999046325684,6,5113,3893,1220,1488400
2759,"['company', 'expand', 'provide', 'service', 'buyer', 'include', 'payment', 'service']","['company', 'expand', 'basic', 'service', 'offer', 'payment', 'finance']",4.199999809265137,4,4209,4851,-642,412164
2760,"['blast', 'kill', 'people', 'injure']","['atlanta', 'olympic', 'james', 'attack', 'kill', 'woman', 'injure', 'people']",1.7999999523162842,3,3781,1740,2041,4165681
2761,"['president', 'rush', 'name', 'path', 'egg', 'student', 'moan', 'marketing', 'association', 'board', 'director']","['president', 'rush', 'name', 'student', 'moan', 'marketing', 'association', 'large', 'lender', 'student']",3.2309999465942383,7,5311,3331,1980,3920400
2762,"['boston', 'archdiocese', 'face', 'wave', 'scandal', 'anger', 'victim', 'advocate', 'parishioner', 'priest']","['wave', 'scandal', 'anger', 'victim', 'advocate', 'parishioner', 'priest', 'point', 'saw', 'long', 'run', 'archdiocese']",3.0,8,5457,3002,2455,6027025
2763,"['federal', 'magistrate', 'sort', 'lauderdale', 'order', 'hold', 'bail']","['zuccarini', 'order', 'hold', 'bail', 'wednesday', 'federal', 'judge', 'sort', 'lauderdale']",3.0,6,5124,3001,2123,4507129
2764,"['department', 'position', 'threaten', 'alienate', 'social', 'conservative', 'provide', 'strong', 'political', 'support', 'ashcroft', 'president', 'rush']","['department', 'stance', 'disappoint', 'abortion', 'opponent', 'threaten', 'alienated', 'social', 'conservative', 'provide', 'strong', 'political', 'support', 'ashcroft', 'president', 'rush']",3.75,11,5677,4009,1668,2782224
2765,"['south', 'africa', 'world', 'high', 'cartload', 'million', 'people', 'infect', 'hiv', 'aids']","['million', 'people', 'infect', 'hiv', 'aids', 'south', 'africa', 'world', 'high', 'aids', 'cartload']",5.0,10,5589,5697,-108,11664
2766,"['position', 'elias', 'report', 'toe', 'cocci', 'president', 'ceo', 'emc']","['executive', 'vice', 'president', 'new', 'venture', 'elias', 'report', 'toe', 'cocci', 'emc', 'president', 'chief', 'executive']",3.400000095367432,6,5107,3512,1595,2544025
2767,"['new', 'army', 'commander', 'vaska', 'humoured', 'brigade', 'commanding', 'officer', 'brigadier', 'ronde', 'nyakairima', 'promote', 'major', 'general']","['president', 'power', 'museveni', 'promote', 'brigadier', 'ronde', 'nyakairima', 'major', 'general', 'name', 'army', 'commander']",3.200000047683716,8,5378,3319,2059,4239481
2768,"['mailblock', 'found', 'year', 'webtv', 'acquire', 'microsoft', 'million']","['webtv', 'sell', 'microsoft', 'million', 'today', 'call', 'msn']",2.799999952316284,3,3732,2635,1097,1203409
2769,"['metropolitan', 'transportation', 'authority', 'give', 'week', 'restore', 'fare', 'old', 'computer', 'railroad', 'rate', 'work', 'declare']","['metropolitan', 'transportation', 'authority', 'plan', 'appeal', 'give', 'restore', 'old', 'subway', 'bus', 'fare', 'old', 'computer', 'railroad', 'rate']",2.799999952316284,10,5588,2584,3004,9024016
2770,"['today', 'try', 'convey', 'problem', 'russian', 'president', 'vladimir', 'ruin', 'president', 'george', 'w', 'rush']","['today', 'try', 'convey', 'problem', 'russian', 'president', 'vladimir', 'ruin', 'news', 'web', 'site', 'president', 'rush', 'news', 'web', 'site']",4.599999904632568,9,5499,5241,258,66564
2771,"['state', 'want', 'kill', 'wolf', 'approximately', 'square', 'mile', 'area', 'near', 'village', 'mcgrath']","['state', 'want', 'kill', 'wolf', 'approximately', 'square', 'mile', 'area', 'near', 'mcgrath', 'establish', 'loose', 'nursery', 'sort']",3.200000047683716,10,5587,3315,2272,5161984
2772,"['peterson', 'tell', 'police', 'fish', 'francisco', 'christmas', 've', 'return', 'house']","['peterson', 'tell', 'police', 'leave', 'wife', 'fish', 'francisco']",3.0,5,4810,2995,1815,3294225
2773,"['red', 'empire', 'state', 'survey', 'far', 'exceed', 'expectation', 'jump', 'june', 'record', 'high']","['price', 'pull', 'offshore', 'high', 'empire', 'state', 'survey', 'far', 'exceed', 'expectation', 'jump', 'june', 'record', 'high']",3.799999952316284,10,5621,4200,1421,2019241
2774,"['met', 'chief', 'snap', 'norman', 'mckinlay', 'say', 'evidence', 'body', 'body', 'area']","['detective', 'chief', 'inspector', 'norman', 'mckinlay', 'lead', 'investigation', 'say', 'evidence', 'body', 'body', 'area']",4.5,7,5351,5135,216,46656
2775,"['board', 'chancellor', 'robert', 'bennett', 'decline', 'comment', 'personnel', 'matter', 'tuesday', 'hills']","['hills', 'decline', 'comment', 'yesterday', 'say', 'discuss', 'personnel', 'matter']",3.0,5,4812,2992,1820,3312400
2776,"['general', 'geoffrey', 'say', 'donate', 'military', 'pension', 'charity', 'period', 'office', 'yarralumla']","['men', 'neffer', 'say', 'military', 'pension', 'charity', 'serve', 'yarralumla']",4.727000236511231,5,4813,5318,-505,255025
2777,"['camp', 'manager', 'piniella', 'bench', 'coach', 'john', 'mclaren', 'right', 'wielder', 'surrey', 'puff', 'eject', 'argue', 'puff', 'call', 'strike', 'end', 'ninth']","['camp', 'manager', 'piniella', 'bench', 'coach', 'john', 'mclaren', 'puff', 'eject', 'middle', 'ninth']",3.799999952316284,10,5586,4201,1385,1918225
2778,"['venture', 'own', 'oil', 'refinery', 'filling', 'station', 'russia', 'ukraine']","['tnk', 'oil', 'produce', 'unit', 'refinery', 'filling', 'station']",3.0,4,4290,2990,1300,1690000
2779,"['change', 'plan', 'refine', 'original', 'vision', 'libeskind', 'say']","['change', 'improvement', 'original', 'plan', 'libeskind', 'say']",4.599999904632568,5,4828,5240,-412,169744
2780,"['peter', 'deutsch', 'd', 'criticize', 'fda', 'effort', 'florida']","['peter', 'deutsch', 'd', 'say', 'want', 'congratulate', 'fda']",2.0,4,4291,1890,2401,5764801
2781,"['active', 'probable', 'case', 'gta', 'compare', 'case', 'june']","['locally', 'number', 'active', 'probable', 'case', 'decline']",1.5,3,3744,1442,2302,5299204
2782,"['sars', 'kill', 'people', 'china', 'mainland', 'infect']","['china', 'mainland', 'disease', 'kill', 'people', 'infect']",3.200000047683716,5,4827,3311,1516,2298256
2783,"['design', 'hinder', 'feature', 'search', 'colour', 'label', 'customized', 'organization', 'document', 'project', 'dynamic', 'browsing', 'network', 'sac', 'windows', 'unix', 'file', 'serve']","['support', 'coloured', 'label', 'well', 'organise', 'document', 'dynamic', 'browsing', 'network', 'sac', 'windows', 'file', 'serve']",3.0,9,5491,2947,2544,6471936
2784,"['lawyer', 'represent', 'porch', 'concepts', 'rich', 'garden', 'respond', 'repeat', 'phone', 'call']","['official', 'porch', 'jetblue', 'respond', 'repeat', 'phone', 'call', 'mercury', 'news', 'seek', 'comment']",2.75,5,4826,2537,2289,5239521
2785,"['voluntarily', 'castrate', 'operation', 'content', 'remove', 'ability', 'sexually', 'arouse']","['series', 'voluntarily', 'castrate', 'august', 'say', 'surgery', 'take', 'away', 'ability', 'sexually', 'arouse']",4.5,5,4825,5134,-309,95481
2786,"['tsx', 'composite', 'rise', 'point', 'week', 'tsx', 'venture', 'exchange', 'composite', 'gain', 'point']","['week', 'bones', 'industrial', 'average', 'rise', 'point', 'nasdaq', 'stock', 'market', 'gain', 'point']",1.0,4,4293,896,3397,11539609
2787,"['turn', 'suse', 'license', 'cava', 'standard', 'edition', 'formalise', 'exist', 'agreement', 'distribute', 'run', 'cava', 'virtual', 'machine', 'run', 'cava', 'application']","['nuremberg', 'germany', 'base', 'suse', 'license', 'run', 'cava', 'standard', 'edition', 'ship', 'run', 'cava', 'virtual', 'machine', 'sinus', 'software', 'line']",3.75,8,5447,4020,1427,2036329
2788,"['long', 'line', 'form', 'outside', 'gas', 'station', 'people', 'rush', 'money', 'cash', 'machine', 'sunday', 'israelis', 'prepare', 'weather', 'strike', 'threaten', 'paralyze', 'country']","['long', 'line', 'form', 'sunday', 'outside', 'gas', 'station', 'people', 'rush', 'money', 'cash', 'machine', 'israelis', 'brace', 'strike', 'effect']",4.5,14,5731,5133,598,357604
2789,"['teach', 'heavy', 'nasdaq', 'composite', 'index', 'fall', 'percent', 'follow', 'day', 'win']","['technology', 'lace', 'nasdaq', 'composite', 'index', 'cease', 'point', 'percent']",1.5,4,4374,1447,2927,8567329
2790,"['know', 'sars', 'say', 'james', 'young', 'ontario', 'commissioner', 'public', 'safety']","['hyper', 'vigilant', 'say', 'james', 'young', 'ontario', 'commissioner', 'public', 'safety']",2.0,7,5318,1884,3434,11792356
2791,"['tale', 'quarter', 'beat', 'expectation', 'rise', 'percent', 'year', 'year', 'billion', 'europe']","['tale', 'rise', 'cent', 'year', 'year', 'beat', 'expectation']",4.0,5,4824,4671,153,23409
2792,"['company', 'say', 'issue', 'revise', 'guidance', 'fiscal', 'year', 'month', 'release', 'result']","['company', 'say', 'renew', 'guidance', 'announce', 'second', 'quarter', 'result', 'mid', 'july']",3.200000047683716,4,4372,3308,1064,1132096
2793,"['decide', 'use', 'unbroken', 'dotted', 'white', 'line', 'experiment', 'worth', 'introduce', 'say', 'david', 'richardson', 'icc', 'cricket', 'manager']","['decide', 'use', 'unbroken', 'dotted', 'white', 'line', 'say', 'richardson', 'icc', 'cricket', 'manager']",4.0,11,5681,4668,1013,1026169
2794,"['shinseki', 'retire', 'wednesday', 'year', 'career', 'include', 'combat', 'vietnam', 'head', 'peacekeeping', 'effort', 'bosnia']","['shinseki', 'career', 'include', 'combat', 'vietnam', 'head', 'peacekeeping', 'effort', 'bosnia']",3.0,9,5555,2946,2609,6806881
2795,"['department', 'send', 'water', 'soil', 'sample', 'state', 'health', 'laboratory']","['late', 'sample', 'send', 'state', 'health', 'department', 'analysis']",3.25,5,4823,3344,1479,2187441
2796,"['clear', 'obligation', 'possible', 'protect', 'civilian', 'see']","['clear', 'responsibility', 'possible', 'minimize', 'civilian', 'harm']",3.400000095367432,3,3819,3446,373,139129
2797,"['loss', 'barber', 'poland', 'lawyer', 'say', 'tuesday', 'attend', 'meeting', 'ask', 'speak', 'issue']","['loss', 'barber', 'poland', 'legal', 'counsel', 'say', 'governor', 'comment', 'conde', 'deal']",2.0,4,4369,1895,2474,6120676
2798,"['previously', 'see', 'grinning', 'mechanic', 'east', 'cava', 'television']","['hughes', 'see', 'amrozi', 'face', 'television', 'infamous', 'image', 'grinning', 'mechanic', 'east', 'cava']",3.400000095367432,6,5103,3438,1665,2772225
2799,"['year', 'later', 'insurance', 'coverage', 'begin']","['agreement', 'dedicate', 'coverage', 'drug', 'benefit', 'begin']",2.799999952316284,2,1597,2634,-1037,1075369
2800,"['nasa', 'satellite', 'image', 'arctic', 'ice', 'shrink', 'rate', 'nearly', 'percent', 'decade']","['research', 'find', 'sea', 'ice', 'arctic', 'disappear', 'rate', 'percent', 'decade']",3.200000047683716,5,4821,3279,1542,2377764
2801,"['biotech', 'product', 'safe', 'conventional', 'product', 'testing', 'rally', 'say', 'add', 'country', 'adopt', 'biotechnology']","['biotech', 'product', 'safe', 'conventional', 'product', 'testing', 'say', 'robert', 'rally', 'monsanto', 'executive', 'vice', 'president']",3.200000047683716,7,5329,3274,2055,4223025
2802,"['nationally', 'board', 'terrify', 'teacher', 'master', 'degree', 'valley', 'make', 'salary', 'year']","['nationally', 'board', 'terrify', 'teacher', 'master', 'degree', 'valley', 'year', 'teaching', 'make']",4.75,9,5547,5326,221,48841
2803,"['vienna', 'iaea', 'say', 'elbaradei', 'accept', 'invitation', 'date', 'set']","['vienna', 'international', 'atomic', 'energy', 'agency', 'say', 'monday', 'elbaradei', 'accept', 'ran', 'invitation', 'say', 'date', 'set']",3.25,7,5330,3343,1987,3948169
2804,"['epidemic', 'begin', 'november', 'mainland', 'guangdong', 'province', 'people', 'republic', 'china', 'refuse', 'report', 'truthfully', 'spread', 'month']","['prc', 'epidemic', 'begin', 'guandong', 'province', 'november', 'communist', 'party', 'government', 'refuse', 'report', 'truthfully', 'spread', 'month']",4.25,9,5565,4921,644,414736
2805,"['truce', 'face', 'murder', 'charge', 'say']","['say', 'truce', 'charge', 'murder']",5.0,4,4367,5680,-1313,1723969
2806,"['compare', 'million', 'cent', 'share', 'year', 'ago', 'period']","['earning', 'affect', 'non', 'recur', 'million', 'tax', 'benefit', 'year', 'ago', 'period']",1.600000023841858,4,4366,1524,2842,8076964
2807,"['sick', 'markakis', 'left', 'handed', 'young', 'harris', 'junior', 'college', 'georgia', 'go', 'trifles', 'seventh', 'pick']","['baltimore', 'take', 'sick', 'markakis', 'left', 'handed', 'pitcher', 'outfielder', 'young', 'harris', 'junior', 'college', 'georgia']",3.799999952316284,9,5544,4239,1305,1703025
2808,"['remain', 'hopeful', 'city', 'agree', 'work', 'engage', 'good', 'faith', 'discussion', 'issue']","['hart', 'say', 'governor', 'remain', 'hopeful', 'city', 'continue', 'work', 'engage', 'good', 'faith', 'discussion']",3.5,8,5445,3727,1718,2951524
2809,"['woman', 'concerned', 'woman', 'turn', 'cosmetic', 'surgery', 'quest', 'bodily', 'perfection']","['woman', 'express', 'concern', 'society', 'people', 'turn', 'cosmetic', 'surgery', 'quest', 'bodily', 'perfection']",4.75,7,5334,5319,15,225
2810,"['ratification', 'report', 'friday', 'msnbc']","['report', 'cia', 'request', 'friday']",3.0,2,1667,2930,-1263,1595169
2811,"['photo', 'peter', 'hollingworth', 'june', 'issue', 'examine', 'herald', 'yesterday']","['photograph', 'hollingworth', 'june', 'issue', 'magazine', 'examine', 'age', 'yesterday']",3.0,5,4818,2937,1881,3538161
2812,"['continue', 'work', 'audit', 'time', 'tragic', 'event', 'provide', 'additional', 'security', 'request']","['time', 'particular', 'tragic', 'event', 'provide', 'security', 'request', 'jordan', 'say']",3.25,6,5093,3359,1734,3006756
2813,"['statement', 'release', 'dei', 'say', 'green', 'begin', 'drive', 'car', 'interim', 'basis', 'begin', 'week', 'winston', 'open', 'owe', 'motor', 'speedway']","['announce', 'green', 'replace', 'dark', 'pale', 'earnhardt', 'chevrolet', 'begin', 'winston', 'open', 'owe', 'motor', 'speedway', 'week']",3.25,8,5442,3367,2075,4305625
2814,"['costa', 'seminal', 'opponent', 'spaniard', 'juan', 'parlor', 'ferrero', 'beat', 'year', 'final']","['costa', 'play', 'juan', 'parlor', 'ferrero', 'reach', 'year', 'final']",3.75,6,5091,3997,1094,1196836
2815,"['doctor', 'sacculate', 'body', 'nitrogen', 'protect', 'cell', 'damage', 'improve', 'blood', 'flow']","['belief', 'base', 'speculation', 'nitrogen', 'prevent', 'cell', 'damage', 'improve', 'blood', 'flow']",4.25,6,5090,4924,166,27556
2816,"['technology', 'lace', 'nasdaq', 'composite', 'index', 'add', 'point', 'percent']","['broad', 'standard', 'door', 'index', 'creep', 'point', 'percent']",1.2000000476837158,3,3795,1106,2689,7230721
2817,"['americans', 'report', 'casualty', 'accord', 'apt', 'michael', 'alert', 'spokesman', 'regiment']","['casualty', 'americans', 'say', 'apt', 'michael', 'alert', 'regiment', 'spokesman']",5.0,7,5341,5679,-338,114244
2818,"['think', 'right', 'choose']","['think', 'peoplesoft', 'customer', 'deserve', 'right', 'choose', 'allison', 'say']",3.0,3,3798,2964,834,695556
2819,"['find', 'smoking', 'gun', 'investigation', 'board', 'member', 'scott', 'hubbard', 'say']","['find', 'smoking', 'gun', 'say', 'hubbard', 'director', 'nasa', 'research', 'enter', 'california']",3.5999999046325684,5,4817,3900,917,840889
2820,"['child', 'literally', 'neglect', 'death', 'armstrong', 'county', 'district', 'attorney', 'scott', 'andreassi', 'say']","['armstrong', 'county', 'district', 'attorney', 'scott', 'andreassi', 'say', 'family', 'photo', 'home', 'include', 'written']",1.7999999523162842,7,5338,1700,3638,13235044
2821,"['microsoft', 'say', 'friday', 'halt', 'development', 'future', 'farintosh', 'version', 'internet', 'explorer', 'brother', 'bite', 'competition', 'apple', 'computer', 'afar', 'brother']","['microsoft', 'stop', 'develop', 'version', 'internet', 'explorer', 'brother', 'software', 'farintosh', 'computer', 'say', 'apple', 'afar', 'apple', 'need']",4.0,10,5584,4638,946,894916
2822,"['shopman', 'immediately', 'arrest', 'expect', 'appear', 'arrangement', 'july']","['shopman', 'arrest', 'expect', 'appear', 'arrangement', 'thursday', 'prospector', 'say']",3.799999952316284,5,4815,4173,642,412164
2823,"['president', 'rush', 'raise', 'record', 'break', 'million', 'election', 'campaign', 'month', 'contribution', 'americans', 'president', 'campaign', 'chairman', 'say', 'tuesday']","['president', 'rush', 'raise', 'million', 'begin', 'election', 'campaign', 'million', 'leave', 'spend', 'campaign', 'say', 'tuesday']",2.400000095367432,8,5432,2206,3226,10407076
2824,"['authority', 'ohio', 'indiana', 'michigan', 'search', 'body']","['far', 'authority', 'search', 'area', 'pennsylvania', 'ohio', 'indiana', 'michigan']",2.799999952316284,5,4681,2623,2058,4235364
2825,"['say', 'european', 'government', 'block', 'new', 'big', 'crop', 'unfounded', 'scientific', 'fear']","['block', 'new', 'big', 'crop', 'unfounded', 'scientific', 'fear', 'rush', 'say']",3.200000047683716,8,5428,3238,2190,4796100
2826,"['question', 'france', 'infuriate', 'washington', 'lead', 'charge', 'authorization', 'war', 'vote', 'yes', 'abstain']","['france', 'infuriate', 'washington', 'lead', 'charge', 'approval', 'war', 'seek', 'change']",3.0,6,5082,2966,2116,4477456
2827,"['luzerne', 'county', 'district', 'attorney', 'david', 'lupus', 'tell', 'news', 'conference', 'monday', 'authority', 'continue', 'significant', 'progress', 'case']","['charge', 'file', 'death', 'luzerne', 'county', 'district', 'attorney', 'david', 'lupus', 'say', 'authority', 'continue', 'significant', 'progress', 'case']",3.400000095367432,11,5685,3504,2181,4756761
2828,"['conference', 'board', 'say', 'late', 'measure', 'business', 'confidence', 'hit', 'fall', 'quarter', 'survey']","['conference', 'board', 'say', 'measure', 'business', 'confidence', 'fall', 'quarter', 'improve', 'recent', 'second', 'quarter']",3.799999952316284,8,5454,4063,1391,1934881
2829,"['legal', 'representative', 'begin', 'meet', 'plaintiff', 'attorney', 'week', 'discuss', 'settlement']","['attorney', 'archdiocese', 'plaintiff', 'begin', 'meet', 'week', 'reach', 'court', 'settlement']",3.25,6,5077,3374,1703,2900209
2830,"['senior', 'pay', 'percent', 'drug', 'cost']","['dedicate', 'pay', 'percent', 'drug', 'cost']",1.5,4,4364,1429,2935,8614225
2831,"['flamboyant', 'entrepreneur', 'flag', 'plan', 'meeting', 'london', 'australian', 'tourism', 'minister', 'toe', 'jockey']","['air', 'richard', 'speak', 'meeting', 'london', 'australian', 'tourism', 'minister', 'toe', 'jockey']",2.799999952316284,7,5342,2622,2720,7398400
2832,"['government', 'bond', 'sell', 'sharply', 'greenspan', 'tell', 'congress', 'tuesday', 'economy', 'embrace', 'period', 'extended', 'growth']","['greenspan', 'tell', 'congress', 'tuesday', 'economy', 'embrace', 'period', 'sustained', 'growth']",3.200000047683716,8,5462,3236,2226,4955076
2833,"['path', 'nicolo', 'jennifer', 'connelly', 'house', 'mean', 'stability', 'family']","['path', 'nicolo', 'jennifer', 'connelly', 'desperate', 'family', 'find', 'life', 'fall', 'apart']",2.0,5,4794,1901,2893,8369449
2834,"['institute', 'supply', 'management', 'index', 'nonmanufacture', 'activity', 'rise', 'unexpectedly', 'april', 'report', 'say']","['institute', 'supply', 'management', 'say', 'index', 'non', 'manufacturing', 'activity', 'rise', 'march']",3.400000095367432,7,5359,3485,1874,3511876
2835,"['spokesman', 'maria', 'agree', 'say', 'look', 'like', 'isolated', 'event']","['look', 'like', 'isolated', 'event', 'world', 'health', 'organization', 'spokesman', 'maria', 'say']",4.599999904632568,7,5357,5239,118,13924
2836,"['police', 'say', 'small', 'child', 'apartment', 'day']","['police', 'say', 'small', 'child', 'day', 'lie', 'dead']",3.25,5,4793,3372,1421,2019241
2837,"['priest', 'john', 'johnston', 'avenue', 'jackson', 'heights', 'charge', 'aggravated', 'harassment', 'criminal', 'possession', 'weapon']","['john', 'johnston', 'charge', 'aggravated', 'harassment', 'phone', 'case', 'criminal', 'possession', 'weapon', 'accord', 'police', 'statement']",3.75,8,5458,3991,1467,2152089
2838,"['settlement', 'include', 'million', 'attorney', 'fee', 'expense']","['plaintiff', 'attorney', 'million', 'settlement']",4.5,3,3651,5131,-1480,2190400
2839,"['vote', 'kill']","['vote', 'kill', 'acc', 'expansion']",3.6670000553131104,2,1854,3984,-2130,4536900
2840,"['prisoner', 'country', 'include', 'canada', 'hold', 'capture', 'war', 'afghanistan', 'al', 'said', 'network']","['prisoner', 'country', 'hold', 'naval', 'base', 'guantanamo', 'capture', 'war', 'll', 'qaeda', 'afghanistan']",3.3329999446868896,6,5135,3412,1723,2968729
2841,"['reach', 'john', 'dvorak', 'cover', 'kansas', 'send', 'e', 'mail']","['reach', 'cooper', 'johnson', 'county', 'municipal', 'reporter', 'send', 'e', 'mail']",1.0,4,4361,914,3447,11881809
2842,"['prosecutor', 'garden', 'call', 'decision', 'victory', 'kathleen', 'peterson', 'family']","['member', 'kathleen', 'peterson', 'family', 'present']",1.0,3,3656,964,2692,7246864
2843,"['want', 'alesha', 'bagley', 'tone', 'county', 'nursing', 'rehabilitation', 'enter', 'social', 'director', 'say', 'week']","['want', 'confirm', 'tone', 'county', 'nursing', 'rehabilitation', 'enter', 'social', 'director', 'alesha', 'bagley']",5.0,10,5582,5678,-96,9216
2844,"['national', 'denomination', 'episcopal', 'church', 'million', 'member', 'branch', 'million', 'member', 'anglican', 'communion']","['episcopal', 'church', 'million', 'member', 'american', 'branch', 'worldwide', 'anglican', 'communion', 'million', 'adherent']",5.0,7,5346,5658,-312,97344
2845,"['feel', 'confident', 'say', 'long', 'integration', 'story', 'irina', 'say']","['lot', 'feel', 'confident', 'long', 'integration', 'story']",3.400000095367432,5,4791,3541,1250,1562500
2846,"['british', 'police', 'arrest', 'people', 'early', 'tuesday', 'connection', 'suspect', 'ritual', 'murder', 'african', 'boy', 'tarso', 'find', 'thames', 'river']","['police', 'arrest', 'people', 'connection', 'murder', 'young', 'iberian', 'child', 'heedless', 'listless', 'tarso', 'find', 'float', 'river', 'thames']",3.5,9,5513,3739,1774,3147076
2847,"['late', 'afternoon', 'bones', 'industrial', 'average', 'percent', 'having', 'gain', 'point', 'monday', 'high', 'level', 'july']","['morning', 'trading', 'bones', 'industrial', 'average', 'percent', 'having', 'gain', 'point', 'monday']",1.25,8,5361,1255,4106,16859236
2848,"['uric', 'age', 'pitch', 'perfect', 'ninth', 'word', 'save', 'opportunity']","['age', 'strike', 'perfect', 'ninth', 'winning', 'word', 'save']",3.25,5,4770,3370,1400,1960000
2849,"['share', 'close', 'nasdaq', 'week', 'high']","['trading', 'echostar', 'stock', 'close', 'tuesday', 'week', 'high']",3.25,3,3640,3369,271,73441
2850,"['nice', 'belly', 'say', 'husband', 'receive', 'assurance', 'senior', 'official', 'public']","['tell', 'inquiry', 'husband', 'receive', 'assurance', 'line', 'manager', 'senior', 'ministry', 'official', 'come', 'forward', 'public']",3.75,6,5126,4010,1116,1245456
2851,"['convict', 'face', 'year', 'prison', 'fine', 'count']","['convict', 'face', 'year', 'prison', 'fine', 'base', 'gain', 'involve']",3.25,5,4769,3375,1394,1943236
2852,"['corporate', 'bond', 'yield', 'spread', 'tighten', 'spot', 'trading', 'friday', 'street', 'labor', 'foot', 'large', 'power', 'outrage', 'north', 'america']","['stock', 'rise', 'slightly', 'feather', 'light', 'volume', 'friday', 'street', 'group', 'big', 'power', 'outrage', 'north', 'america']",3.5999999046325684,6,5123,3892,1231,1515361
2853,"['evacuation', 'go', 'smoothly', 'passenger', 'tell', 'go', 'aunt', 'say']","['passenger', 'evacuate', 'smoothly', 'tell', 'go', 'say']",4.400000095367432,5,4768,5093,-325,105625
2854,"['allegation', 'sexual', 'assault', 'report']","['report', 'sexual', 'assault', 'academy']",3.5999999046325684,3,3637,3891,-254,64516
2855,"['smith', 'say', 'simply', 'oh', 'god', 'second', 'afterward', 'accord', 'weinshall']","['second', 'crash', 'add', 'captain', 'smith', 'say', 'simply', 'oh', 'god']",3.75,6,5122,4019,1103,1216609
2856,"['woolen', 'say', 'expect', 'muhammad', 'similarly', 'call', 'witness', 'arterial', 'hearing']","['old', 'call', 'witness', 'wednesday', 'arterial', 'hearing', 'fellow', 'supper', 'suspect', 'john', 'ellen', 'muhammad']",2.5,5,4767,2333,2434,5924356
2857,"['leave', 'smile', 'face', 'word', 'daughter', 'mind', 'hope', 'say']","['leave', 'smile', 'face', 'word', 'give', 'kiss', 'say']",3.25,5,4766,3376,1390,1932100
2858,"['bar', 'permanently', 'security', 'industry']","['young', 'face', 'fine', 'suspension', 'permanently', 'bar', 'security', 'industry']",3.3329999446868896,4,4360,3403,957,915849
2859,"['inspiration', 'couple', 'helpless', 'courageous', 'say', 'scar', 'win', 'film', 'director']","['say', 'inspiration', 'couple', 'helpless', 'courageous']",3.0,5,4765,3065,1700,2890000
2860,"['second', 'victim', 'michael', 'walker', 'strike', 'tarso', 'bullet', 'perforate', 'lung']","['victim', 'michael', 'walker', 'barley', 'street', 'strike', 'neck']",2.200000047683716,4,4358,2101,2257,5094049
2861,"['interview', 'criminologist', 'acknowledge', 'sentiment', 'legislator', 'country', 'weariness', 'capital', 'punishment']","['interview', 'criminologist', 'say', 'lawmaker', 'country', 'share', 'weariness', 'capital', 'punishment']",4.599999904632568,6,5118,5237,-119,14161
2862,"['franklin', 'county', 'judge', 'executive', 'versa', 'barton', 'say', 'firefighter', 'strike', 'lightning', 'take', 'frankfort', 'regional', 'medical', 'enter']","['county', 'firefighter', 'strike', 'lightning', 'stable', 'condition', 'frankfort', 'regional', 'medical', 'enter']",3.200000047683716,8,5367,3223,2144,4596736
2863,"['police', 'spokesman', 'brig', 'men', 'edward', 'aritonang', 'confirm', 'saturday', 'arrest', 'makarka', 'magelang', 'central', 'cava']","['brigadier', 'general', 'edward', 'aritonang', 'police', 'spokesman', 'confirm', 'yesterday', 'arrest', 'makarka', 'magelang', 'central', 'cava']",5.0,10,5581,5659,-78,6084
2864,"['federal', 'judge', 'william', 'harbour', 'say', 'tuesday', 'impose', 'maximum', 'sentence', 'event', 'show', 'remorse', 'brutal', 'slaying']","['district', 'judge', 'william', 'harbour', 'say', 'impose', 'maximum', 'event', 'show', 'remorse']",3.5999999046325684,9,5527,3885,1642,2696164
2865,"['potential', 'rumor', 'ask', 'complete', 'lengthy', 'questionnaire']","['rumor', 'take', 'courtroom', 'group', 'ask', 'fill', 'questionnaire']",3.200000047683716,3,3622,3220,402,161604
2866,"['alternate', 'rumor', 'choose', 'final', 'set', 'select', 'friday', 'morning', 'panel']","['alternate', 'rumor', 'select', 'sixth', 'alternate', 'pick', 'friday']",4.599999904632568,4,4357,5235,-878,770884
2867,"['california', 'arm', 'bureau', 'immediately', 'return', 'call', 'seek', 'comment']","['california', 'arm', 'bureau', 'immediately', 'official', 'response', 'tuesday', 'ruling']",3.799999952316284,4,4356,4101,255,65025
2868,"['prime', 'minister', 'tell', 'bbc', 'gather', 'poll', 'continue', 'believe', 'right']","['say', 'gather', 'poll', 'continue', 'believe', 'right', 'foreign', 'domestic', 'policy']",3.400000095367432,5,4763,3528,1235,1525225
2869,"['man', 'battle', 'head', 'combined', 'joint', 'ask', 'force', 'base', 'ship', 'gulf', 'den', 'indian', 'ocean']","['general', 'battle', 'head', 'combined', 'joint', 'ask', 'force', 'aboard', 'command', 'ship', 'count', 'whitney']",3.5999999046325684,7,5323,3904,1419,2013561
2870,"['street', 'analysis', 'expect', 'cent', 'share', 'accord', 'thomson']","['result', 'cent', 'share', 'low', 'forecast', 'analysis', 'survey', 'thomson']",2.200000047683716,4,4355,1974,2381,5669161
2871,"['legal', 'ruling', 'follow', 'day', 'intense', 'speculation', 'hewlett', 'backward', 'bid', 'company']","['legal', 'ruling', 'follow', 'day', 'wild', 'volatility', 'rim', 'stock', 'speculation', 'giant', 'hewlett', 'backward', 'bid', 'company']",3.5999999046325684,9,5519,3924,1595,2544025
2872,"['finding', 'publish', 'july', 'issue', 'annals', 'internal', 'medicine']","['finding', 'publish', 'today', 'annals', 'internal', 'medicine']",3.799999952316284,5,4762,4097,665,442225
2873,"['measure', 'take', 'senate', 'early', 'friday']","['bailiff', 'say', 'hope', 'bring', 'measure', 'senate', 'friday']",4.0,3,3632,4664,-1032,1065024
2874,"['union', 'spokesman', 'uric', 'rhode', 'decline', 'comment', 'mediation', 'order']","['think', 'great', 'news', 'say', 'union', 'spokesman', 'uric', 'rhode']",1.7330000400543213,4,4180,1600,2580,6656400
2875,"['labor', 'department', 'analysis', 'think', 'patrol', 'statistic', 'survey', 'business', 'provide', 'accurate', 'picture', 'economy', 'survey', 'figure', 'base', 'large', 'sample']","['analysis', 'say', 'believe', 'patrol', 'statistic', 'provide', 'accurate', 'picture', 'economy', 'base', 'large', 'sample']",4.0,10,5580,4666,914,835396
2876,"['parent', 'want', 'keep', 'alive', 'husband', 'say', 'want', 'keep', 'alive', 'artificially']","['michael', 'schiavo', 'argue', 'wife', 'want', 'keep', 'alive', 'artificially']",2.799999952316284,4,4354,2651,1703,2900209
2877,"['early', 'tell', 'france', 'enter', 'radio', 'think', 'qualify', 'happen', 'genuine', 'epidemic']","['think', 'qualify', 'happen', 'genuine', 'epidemic', 'health', 'minister', 'mean', 'francis', 'matter', 'say', 'france', 'enter', 'radio']",3.200000047683716,8,5375,3218,2157,4652649
2878,"['ferri', 'schiavo', 'expect', 'die', 'week', 'camp', 'area', 'hostile', 'spend', 'past', 'year']","['ferri', 'schiavo', 'undergo', 'procedure', 'camp', 'area', 'hostile', 'live', 'year', 'say', 'father', 'mob', 'schindler']",1.7999999523162842,6,5137,1675,3462,11985444
2879,"['prior', 'join', 'today', 'lumbo', 'work', 'trotter', 'gamble', 'manage', 'product', 'holders', 'canteen', 'shampoo']","['prior', 'join', 'batman', 'today', 'lumbo', 'hold', 'senior', 'marketing', 'position', 'trotter', 'gamble']",3.75,6,5105,4016,1089,1185921
2880,"['mcdevitt', 'grant', 'control', 'crucial', 'aspect', 'policy', 'solomon']","['mcdevitt', 'grant', 'control', 'aspect', 'policy', 'commissioner', 'william', 'sorrel']",3.75,5,4760,4022,738,544644
2881,"['official', 'north', 'carolina', 'speedway', 'rockingham', 'reach']","['nascar', 'official', 'reach', 'comment', 'tuesday']",2.9089999198913574,2,1919,2754,-835,697225
2882,"['say', 'child', 'take', 'vassar', 'county', 'medical', 'enter', 'observation']","['boy', 'take', 'vassar', 'university', 'medical', 'enter', 'staff', 'say', 'okay']",3.400000095367432,5,4759,3445,1314,1726596
2883,"['misha', 'dresser', 'spokesman', 'global', 'crossing', 'decline', 'comment']","['global', 'crossing', 'representative', 'immediate', 'comment']",3.5999999046325684,3,3705,3916,-211,44521
2884,"['union', 'stage', 'day', 'strike', 'march', 'force', 'pale', 'dining', 'hall', 'close']","['union', 'stage', 'day', 'strike', 'march', 'strike', 'precede', 'contract']",2.5999999046325684,5,4758,2379,2379,5659641
2885,"['sov', 'sick', 'merry', 'say', 'oppose', 'gambling', 'expansion', 'reluctant', 'veto', 'continuation', 'pottery', 'commission']","['sov', 'sick', 'merry', 'oppose', 'expansion', 'gambling', 'say', 'hard', 'press', 'veto', 'lottery', 'sunset', 'bill']",3.799999952316284,8,5366,4091,1275,1625625
2886,"['midafternoon', 'trading', 'nasdaq', 'composite', 'index', 'percent']","['nasdaq', 'composite', 'index', 'dip', 'point', 'percent']",1.600000023841858,4,4352,1553,2799,7834401
2887,"['kentucky', 'democratic', 'attorney', 'general', 'men', 'handle', 'face', 'urine', 'fletcher']","['kentucky', 'republican', 'urine', 'fletcher', 'term', 'house', 'member', 'rattle', 'democratic', 'state', 'attorney', 'general', 'men', 'handle']",3.799999952316284,8,5413,4098,1315,1729225
2888,"['bones', 'industrial', 'average', 'fall', 'percent']","['bones', 'industrial', 'average', 'finish', 'day', 'point']",3.400000095367432,3,3713,3422,291,84681
2889,"['union', 'plan', 'cover', 'worker', 'retire', 'beneficiary']","['union', 'stock', 'comprise', 'worker', 'portfolio']",2.5,2,1917,2346,-429,184041
2890,"['senate', 'judiciary', 'committee', 'overcome', 'significant', 'hardly', 'yesterday', 'battle', 'create', 'trust', 'fund', 'pay', 'victim', 'asbestos', 'exposure']","['senate', 'judiciary', 'committee', 'tuesday', 'overcome', 'significant', 'hardly', 'battle', 'create', 'trust', 'fund', 'pay', 'victim', 'asbestos', 'exposure', 'difficult', 'obstacle', 'remain']",3.75,14,5734,3988,1746,3048516
2891,"['certify', 'year', 'billion', 'budget']","['say', 'know', 'certify', 'budget']",3.1670000553131104,2,1915,3078,-1163,1352569
2892,"['difficult', 'overestimated', 'potential', 'danger', 'remote', 'procedure', 'rpc', 'vulnerability']","['flaw', 'involve', 'remote', 'procedure', 'rpc', 'protocol', 'deal', 'inter', 'computer', 'communication']",2.5,3,3717,2364,1353,1830609
2893,"['obesity', 'increase', 'risk', 'health', 'problem', 'skeptic', 'argue', 'smoking', 'high', 'cholestrol']","['obesity', 'increase', 'risk', 'host', 'health', 'problem', 'skeptic', 'argue', 'smoking', 'high', 'cholestrol', 'consider', 'disease']",4.25,10,5578,4927,651,423801
2894,"['michelle', 'lie', 'chip', 'sunday', 'victory', 'virada', 'nirapathpongporn', 'women', 'amateur', 'public', 'links', 'championship']","['trophy', 'victory', 'women', 'amateur', 'public', 'links', 'sunday']",2.75,6,5031,2550,2481,6155361
2895,"['bony', 'say', 'psp', 'feature', 'inch', 'lcd', 'screen', 'memory', 'stick', 'expansion', 'shot']","['feature', 'light', 'lcd', 'screen', 'memory', 'expansion', 'facility']",2.75,5,4764,2553,2211,4888521
2896,"['smile', 'site', 'huntington', 'bacteria', 'reading', 'come', 'june', 'june']","['reading', 'come', 'june', 'june', 'smile', 'site', 'huntington']",3.25,6,5028,3365,1663,2765569
2897,"['long', 'line', 'catch', 'fish', 'hook', 'past', 'decade', 'lucky', 'catch', 'study', 'find']","['long', 'line', 'catch', 'fish', 'hook', 'lucky', 'catch', 'eye', 'say']",4.199999809265137,6,5027,4871,156,24336
2898,"['carnival', 'stock', 'trade', 'midday', 'trading', 'wednesday', 'cent', 'percent']","['carnival', 'stock', 'percent', 'cent', 'new', 'work', 'stock', 'exchange']",3.200000047683716,4,4376,3269,1107,1225449
2899,"['senate', 'criticism', 'house', 'plan', 'tuesday', 'come', 'front']","['senate', 'republicans', 'crank', 'house', 'map']",2.75,2,1913,2560,-647,418609
2900,"['result', 'murphy', 'seek', 'substitute', 'tried', 'sister', 'ethel', 'celnik', 'trustee']","['murphy', 'say', 'tried', 'sister', 'ethel', 'celnik', 'courtroom', 'time', 'tried']",1.75,5,4774,1616,3158,9972964
2901,"['rule', 'bar', 'group', 'fire', 'promote', 'support', 'attack', 'oppose', 'candidate', 'time']","['uphold', 'fallacy', 'rule', 'bar', 'group', 'fire', 'promote', 'support', 'attack', 'oppose', 'candidate', 'time']",3.75,10,5576,3989,1587,2518569
2902,"['disco', 'pare', 'spending', 'compensate', 'sluggish', 'sale']","['response', 'sluggish', 'sale', 'disco', 'pare', 'spending']",4.800000190734863,5,4790,5449,-659,434281
2903,"['kansas', 'city', 'draft', 'outfielder', 'chris', 'lubanski', 'penned', 'enrich', 'high', 'school', 'pennsylvania', 'fifth', 'pick']","['royal', 'choose', 'chris', 'lubanski', 'high', 'school', 'outfielder', 'pennsylvania', 'hit', 'fifth', 'pick']",3.400000095367432,8,5410,3477,1933,3736489
2904,"['sterling', 'percent', 'dollar']","['dollar', 'rise', 'percent', 'japanese', 'currency', 'man']",0.800000011920929,2,1912,814,1098,1205604
2905,"['bones', 'industrial', 'average', 'rise', 'point', 'percent']","['bones', 'rise', 'point', 'friday', 'gain', 'day', 'week']",4.0,3,3679,4640,-961,923521
2906,"['right', 'beginning', 'want', 'cut', 'pay']","['rosy', 'tell', 'associated', 'dress', 'right', 'beginning', 'want', 'cut', 'pay']",4.0,5,4789,4641,148,21904
2907,"['number', 'bureaucratic', 'administrative', 'miss', 'signal', 'person', 'responsible', 'german', 'say']","['turn', 'nima', 'offer', 'german', 'say', 'number', 'bureaucratic', 'administrative', 'miss', 'signal']",3.75,7,5324,3995,1329,1766241
2908,"['series', 'stop', 'town', 'wednesday', 'registering', 'sex', 'offender', 'soledad', 'police', 'department']","['convict', 'child', 'molest', 'brian', 'series', 'speak', 'response', 'community', 'outrage', 'wednesday', 'afternoon', 'register', 'sex', 'offender', 'soledad', 'police', 'department']",3.25,7,5322,3363,1959,3837681
2909,"['edt', 'race', 'center', 'near', 'latitude', 'north', 'longitude', 'west', 'mile', 'east', 'southeast', 'corpus', 'christ']","['edt', 'cabin', 'center', 'near', 'latitude', 'north', 'longitude', 'west', 'mile', 'east', 'rewards']",1.25,9,5485,1256,4229,17884441
2910,"['saturday', 'mph', 'serve', 'agassi', 'equal', 'rusedski', 'world', 'record']","['saturday', 'roddick', 'equal', 'world', 'record', 'serve', 'beat', 'andre', 'agassi']",3.5,6,5042,3723,1319,1739761
2911,"['broad', 'standard', 'door', 'index', 'climb', 'point', 'percent']","['nasdaq', 'composite', 'index', 'jump', 'point', 'percent']",1.0,3,3692,988,2704,7311616
2912,"['october', 'heating', 'oil', 'future', 'settle', 'cent', 'low', 'cent', 'gallon']","['october', 'heating', 'oil', 'end', 'cent', 'cent', 'gallon']",2.5,5,4787,2352,2435,5929225
2913,"['divine', 'confirm', 'try', 'sell', 'story', 'world']","['lawyer', 'donald', 'divine', 'confirm', 'try', 'sell', 'story', 'february']",3.437999963760376,5,4786,3683,1103,1216609
2914,"['bankhead', 'say', 'crime', 'scene', 'indicate', 'killer', 'methodical']","['gbi', 'spokesman', 'john', 'bankhead', 'say', 'murder', 'scene', 'show', 'killer', 'methodical']",4.0,5,4785,4669,116,13456
2915,"['move', 'lot', 'close', 'say', 'foam', 'kind', 'damage', 'say', 'hubbard', 'member', 'columbia', 'accident', 'investigation', 'board']","['think', 'move', 'lot', 'close', 'say', 'foam', 'kind', 'damage', 'hubbard', 'say']",3.5999999046325684,8,5404,3880,1524,2322576
2916,"['internal', 'personnel', 'decision', 'microsoft', 'spokesman', 'mean', 'unwell', 'say']","['microsoft', 'absolutely', 'atstake', 'internal', 'personnel', 'decision', 'sundwall', 'say']",4.199999809265137,5,4784,4844,-60,3600
2917,"['egyptologist', 'cast', 'doubt', 'tuesday', 'expedition', 'claim', 'find', 'mummy', 'queen', 'nefertiti', 'well', 'know', 'ancient', 'egyptians']","['egyptologist', 'think', 'identify', 'long', 'seek', 'mummy', 'queen', 'nefertiti', 'ancient', 'world', 'legendary', 'beauty']",2.5999999046325684,5,4783,2369,2414,5827396
2918,"['long', 'range', 'plan', 'provide', 'retail', 'buyer', 'treasury', 'security', 'ability', 'manage', 'holding', 'online', 'single', 'account']","['treasury', 'say', 'want', 'retail', 'buyer', 'treasury', 'security', 'ability', 'eventually', 'manage', 'holding', 'online', 'single', 'account']",4.400000095367432,10,5596,4973,623,388129
2919,"['list', 'night', 'critical', 'stable', 'condition', 'kings', 'county', 'hospital', 'enter', 'police', 'say']","['victim', 'new', 'jersey', 'resident', 'critical', 'stable', 'condition', 'hospital']",3.25,4,4401,3362,1039,1079521
2920,"['year', 'bond', 'grow', 'yield', 'percent', 'percent', 'late', 'wednesday']","['gmt', 'year', 'note', 'yield', 'percent', 'percent', 'wednesday']",2.0,4,4400,1792,2608,6801664
2921,"['iac', 'stock', 'close', 'yesterday', 'percent']","['interactivecorp', 'share', 'close', 'percent', 'nasdaq', 'stock', 'market']",4.5,3,3685,5130,-1445,2088025
2922,"['word', 'speak', 'senate', 'floor', 'say', 'question', 'motive', 'deskbound', 'president', 'assume', 'garb', 'warrior', 'purpose', 'speech']","['question', 'motive', 'desk', 'bind', 'president', 'assume', 'garb', 'warrior', 'purpose', 'speech']",3.400000095367432,8,5401,3458,1943,3775249
2923,"['ministry', 'defence', 'face', 'compensation', 'claim', 'hundred', 'demyan', 'woman', 'claim', 'rapid', 'british', 'soldier']","['hundred', 'demyan', 'woman', 'claim', 'attack', 'rapid', 'british', 'soldier', 'grant', 'government', 'legal', 'aid', 'wednesday', 'pursue', 'case', 'ministry', 'defense']",3.0,8,5385,3035,2350,5522500
2924,"['share', 'usa', 'interactive', 'rise', 'percent', 'friday', 'nasdaq', 'stock', 'market', 'composite', 'trading', 'gain', 'percent', 'year']","['share', 'lendingtree', 'rise', 'percent', 'close', 'nasdaq', 'stock', 'market', 'yesterday']",1.0,6,5062,962,4100,16810000
2925,"['similar', 'bill', 'pass', 'house', 'twice', 'die', 'senate']","['year', 'ago', 'house', 'pass', 'similar', 'version', 'flounder', 'senate']",2.75,4,4399,2544,1855,3441025
2926,"['closure', 'affect', 'quarter', 'earning', 'share', 'penny']","['company', 'say', 'impact', 'earning', 'penny', 'share']",3.25,3,3674,3361,313,97969
2927,"['woman', 'hospitalize', 'june', 'kansas', 'health', 'official', 'say']","['missouri', 'health', 'official', 'say', 'hospitalize', 'recover']",1.0,4,4398,932,3466,12013156
2928,"['blue', 'chip', 'edge', 'lower', 'midday', 'wednesday', 'wave', 'profit', 'warning', 'drain', 'optimism', 'drive', 'rally', 'past', 'month']","['stock', 'fall', 'early', 'morning', 'trade', 'wednesday', 'wave', 'profit', 'warning', 'drain', 'optimism', 'drive', 'rally', 'past', 'month']",3.5999999046325684,10,5597,3902,1695,2873025
2929,"['technology', 'lace', 'nasdaq', 'composite', 'index', 'tack', 'point', 'percent']","['technology', 'focus', 'nasdaq', 'composite', 'index', 'advance', 'point', 'percent', 'ease', 'early', 'loss']",3.200000047683716,6,5057,3266,1791,3207681
2930,"['kuwaitis', 'palestinians', 'jordanian', 'passport', 'suspect', 'official', 'say']","['include', 'kuwaitis', 'palestinians', 'jordanian', 'passport', 'remainder', 'iraqis', 'audit', 'official', 'say']",3.0,6,5056,2883,2173,4721929
2931,"['birthday', 'april', 'declare', 'public', 'holiday', 'attend', 'reception', 'ball']","['grandmother', 'princess', 'elizabeth', 'turn', 'day', 'declare', 'public', 'holiday', 'attend', 'reception', 'ball']",3.200000047683716,6,5055,3265,1790,3204100
2932,"['working', 'face', 'charge', 'conspiracy', 'obstruct', 'justice', 'lie', 'grand', 'jury', 'try', 'separately']","['working', 'try', 'separately', 'charge', 'conspiracy', 'lie', 'grand', 'jury']",4.599999904632568,8,5395,5233,162,26244
2933,"['man', 'enter', 'post', 'office', 'lakeside', 'shortly', 'give', 'deputy']","['man', 'enter', 'post', 'office', 'roadside', 'avenue', 'maine', 'avenue', 'shortly']",2.799999952316284,5,4779,2638,2141,4583881
2934,"['few', 'fbi', 'office', 'conduct', 'investigation', 'involve', 'visit', 'mosque', 'justice', 'department', 'say']","['addition', 'justice', 'department', 'say', 'fbi', 'conduct', 'few', 'investigation', 'involve', 'visit', 'mosque']",4.199999809265137,10,5598,4837,761,579121
2935,"['outside', 'court', 'sriyanto', 'face', 'year', 'jail', 'deny', 'wrong']","['outside', 'court', 'sriyanto', 'deny', 'age', 'wrong']",3.200000047683716,5,4778,3264,1514,2292196
2936,"['university', 'michigan', 'president', 'mary', 'solemn', 'say', 'statement', 'university', 'web', 'site', 'fundamental', 'value', 'change']","['fundamental', 'value', 'change', 'mary', 'solemn', 'president', 'university', 'say', 'statement', 'inn', 'labor']",4.0,9,5495,4697,798,636804
2937,"['comcast', 'glass', 'share', 'cent', 'morning', 'trading', 'nasdaq', 'stock', 'market']","['stock', 'rise', 'cent', 'yesterday', 'nasdaq', 'stock', 'market', 'trading']",2.200000047683716,5,4777,1971,2806,7873636
2938,"['thomas', 'join', 'rehnquist', 'part', 'scala']","['join', 'chief', 'justice', 'william', 'rehnquist', 'justices', 'andre', 'antonio', 'scala']",2.799999952316284,3,3709,2618,1091,1190281
2939,"['cross', 'line', 'violate', 'constitutional', 'right', 'say', 'charles', 'weisselberg', 'berkeley', 'law', 'professor']","['cross', 'line', 'violate', 'constitutional', 'right', 'say', 'charles', 'weisselberg', 'reach', 'law', 'university', 'california', 'berkeley']",5.0,10,5618,5662,-44,1936
2940,"['preliminary', 'report', 'man', 'see', 'airport', 'source', 'say']","['man', 'pakistani', 'passport', 'reportedly', 'see', 'airport', 'early', 'evening', 'law', 'enforcement', 'source', 'say']",2.0,5,4776,1774,3002,9012004
2941,"['toronto', 'yesterday', 'probable', 'case', 'sars', 'suspect', 'case']","['wednesday', 'probable', 'sars', 'case', 'toronto', 'region']",3.25,4,4396,3341,1055,1113025
2942,"['nasdaq', 'composite', 'index', 'rise', 'cent']","['technology', 'lace', 'nasdaq', 'composite', 'index', 'gain', 'point', 'percent', 'finish']",3.75,3,3704,4057,-353,124609
2943,"['toll', 'australia', 'second', 'large', 'transport', 'company', 'week', 'offer', 'share', 'franz', 'nail']","['toll', 'week', 'offer', 'buy', 'company', 'share', 'million']",3.5,5,4755,3726,1029,1058841
2944,"['messagelabs', 'run', 'outsourced', 'e', 'mail', 'serve', 'customer', 'world', 'say', 'filter', 'infected', 'e', 'mail', 'country', 'thursday', 'morning']","['messagelabs', 'run', 'outsourced', 'e', 'mail', 'serve', 'customer', 'world', 'label', 'worm', 'high', 'risk', 'report', 'infection', 'country']",2.75,9,5472,2555,2917,8508889
2945,"['carlton', 'tuesday', 'say', 'refuse', 'case']","['service', 'official', 'say', 'carlton', 'refuse', 'refuse', 'case']",4.0,4,4395,4688,-293,85849
2946,"['oracle', 'share', 'high', 'trade', 'cent']","['share', 'redwood', 'shores', 'base', 'oracle', 'rise', 'cent']",2.0,3,3631,1809,1822,3319684
2947,"['precinct', 'report', 'fletcher', 'term', 'congressman', 'lexington', 'overwhelming', 'percent', 'vote']","['precinct', 'report', 'fletcher', 'vote', 'percent', 'total']",3.0,5,4669,2783,1886,3556996
2948,"['long', 'long', 'patient', 'quarantine', 'wednesday', 'seven', 'public', 'hospital', 'worker', 'develop', 'fly', 'like', 'symptom']","['seven', 'health', 'care', 'worker', 'public', 'hospital', 'fall', 'ill', 'fly', 'like', 'symptom']",3.0,7,5343,2782,2561,6558721
2949,"['upside', 'local', 'old', 'nose', 'news', 'people', 'report', 'high', 'profit', 'quarter', 'early', 'thursday', 'help', 'european', 'demand']","['local', 'old', 'report', 'high', 'profit', 'quarter', 'help', 'european', 'demand', 'early', 'thursday']",4.599999904632568,11,5646,5231,415,172225
2950,"['unemployment', 'rate', 'rise', 'tenth', 'percentage', 'point', 'high', 'level', 'july']","['unemployment', 'rate', 'predict', 'pick', 'percentage', 'point']",3.200000047683716,4,4394,3254,1140,1299600
2951,"['deal', 'delainey', 'agree', 'cooperate', 'continue', 'investigation']","['delainey', 'agree', 'cooperate', 'federal', 'prospector', 'exchange', 'plea']",4.400000095367432,3,3619,4960,-1341,1798281
2952,"['source', 'close', 'sale', 'say', 'vivendi', 'keep', 'door', 'open', 'bid', 'hope', 'bidder', 'interested', 'individual', 'asset', 'team']","['source', 'close', 'sale', 'say', 'vivendi', 'keep', 'door', 'open', 'bid', 'day']",4.0,9,5473,4674,799,638401
2953,"['iron', 'declare', 'quarterly', 'profit', 'year']","['iron', 'number', 'mark', 'quarterly', 'profit', 'year', 'dram', 'manufacturer']",3.75,4,4393,4024,369,136161
2954,"['fine', 'fail', 'republican', 'effort', 'force', 'entice', 'democrats', 'return']","['merry', 'say', 'back', 'senate', 'effort', 'include', 'fine', 'force', 'democrats', 'return']",2.799999952316284,5,4623,2586,2037,4149369
2955,"['teach', 'load', 'nasdaq', 'composite', 'rise', 'point', 'end', 'high', 'level', 'month']","['technology', 'lace', 'nasdaq', 'composite', 'index', 'climb', 'point', 'percent']",2.400000095367432,3,3666,2184,1482,2196324
2956,"['prospector', 'arrest', 'individual', 'seize', 'million', 'continue', 'crackdown', 'internet', 'fraud', 'abuse']","['people', 'arrest', 'million', 'worth', 'property', 'seize', 'internet', 'fraud', 'sweep', 'announce', 'friday', 'government', 'agency']",4.599999904632568,5,4625,5230,-605,366025
2957,"['say', 'investigator', 'feel', 'confident', 'get', 'fire', 'resolve', 'regard']","['albuquerque', 'mayor', 'martin', 'say', 'investigator', 'feel', 'confident', 'arrest', 'fire', 'resolve']",3.799999952316284,6,5220,4095,1125,1265625
2958,"['man', 'accuse', 'face', 'grenade', 'commander', 'cuban', 'plane', 'land', 'key', 'west', 'april', 'sentence', 'friday', 'year', 'prison']","['cuban', 'architect', 'sentence', 'year', 'prison', 'friday', 'face', 'grenade', 'jack', 'passenger', 'plane', 'cuba', 'florida', 'april']",4.400000095367432,9,5500,4965,535,286225
2959,"['williams', 'director', 'visit', 'project', 'say', 'middle', 'november', 'arrive', 'passenger', 'atlanta', 'fingerprint', 'photographer']","['williams', 'director', 'visit', 'project', 'say', 'middle', 'november', 'inspector', 'fingerprinting', 'photographic', 'foreign', 'passenger', 'arrive', 'atlanta']",4.199999809265137,10,5617,4850,767,588289
2960,"['hearing', 'occur', 'day', 'pentagon', 'time', 'single', 'officer', 'villager', 'address', 'scandal']","['hearing', 'come', 'day', 'pentagon', 'time', 'single', 'officer', 'villager', 'fail', 'address', 'scandal']",5.0,9,5478,5663,-185,34225
2961,"['episcopal', 'church', 'alienate', 'anglican', 'communion', 'say', 'peter', 'karanja', 'provost', 'saints', 'cathedral', 'nairobi']","['nairobi', 'provost', 'saints', 'cathedral', 'reverend', 'peter', 'karanja', 'say', 'episcopal', 'church', 'alienate', 'anglican', 'communion']",5.0,12,5712,5665,47,2209
2962,"['county', 'population', 'decline', 'vermillion', 'money', 'madison']","['vermillion', 'money', 'madison', 'county', 'population', 'decline']",5.0,6,5216,5666,-450,202500
2963,"['wart', 'indict', 'february', 'argue', 'new', 'hampshire', 'wrong', 'place', 'charge']","['wart', 'seek', 'charge', 'dismiss', 'say', 'new', 'hampshire', 'wrong', 'place', 'charge']",3.400000095367432,6,5210,3682,1528,2334784
2964,"['baffled', 'hospital', 'weekend', 'evaluation']","['undergo', 'test', 'weekend', 'warn', 'baffled', 'hospital']",3.200000047683716,3,3653,3252,401,160801
2965,"['bomb', 'explode', 'vasa', 'de', 'españa', 'customer', 'eat', 'dinner', 'play', 'lingo']","['vasa', 'de', 'span', 'customer', 'eat', 'dinner', 'play', 'lingo', 'bomb', 'go']",5.0,8,5394,5667,-273,74529
2966,"['plofsky', 'say', 'commission', 'will', 'investigate', 'year', 'statute', 'limitation', 'expire']","['panel', 'begin', 'formal', 'investigation', 'statute', 'limitation', 'expire', 'plofsky', 'say']",4.400000095367432,5,4626,4985,-359,128881
2967,"['convict', 'spying', 'charge', 'face', 'death', 'penalty']","['charge', 'espionage', 'aid', 'enemy', 'carry', 'death', 'penalty']",3.5999999046325684,3,3806,3851,-45,2025
2968,"['entrenched', 'interest', 'petition', 'control', 'network', 'chokepoint', 'sob', 'fcc', 'aid', 'aet']","['die', 'entrenched', 'interest', 'petition', 'control', 'internet', 'choke', 'point', 'sob', 'fcc', 'aid', 'aet']",3.200000047683716,8,5393,3251,2142,4588164
2969,"['church', 'member', 'observer', 'expect', 'decision', 'problematical', 'episcopalian']","['church', 'member', 'observer', 'anticipate', 'decision', 'pose', 'doctrine', 'problem', 'episcopalian', 'believe', 'bible', 'prohibit', 'homosexuality']",3.799999952316284,5,4633,4106,527,277729
2970,"['square', 'principal', 'investigator', 'payload', 'collection', 'science', 'instrument', 'cart', 'rover']","['steve', 'squares', 'cornell', 'university', 'scientist', 'principal', 'investigator', 'mission', 'science', 'instrument']",4.199999809265137,4,4389,4863,-474,224676
2971,"['military', 'say', 'kill', 'rebel', 'capture', 'campaign', 'far', 'loss', 'soldier', 'wound']","['military', 'say', 'kill', 'rebel', 'capture', 'campaign', 'far', 'soldier', 'kill', 'wound']",3.0,9,5503,2816,2687,7219969
2972,"['express', 'script', 'share', 'fall', 'percent', 'close', 'nasdaq']","['share', 'express', 'script', 'fall', 'percent', 'nasdaq', 'late', 'morning', 'trade']",3.0,6,5206,2796,2410,5808100
2973,"['police', 'launch', 'international', 'hunt', 'shevaun', 'bennington', 'run', 'away', 'year', 'old', 'studabaker', 'saturday']","['shevaun', 'bennington', 'disappear', 'saturday', 'morning', 'arrange', 'meet', 'year', 'old', 'studabaker']",3.0,6,5208,2815,2393,5726449
2974,"['lawyer', 'familiar', 'federal', 'investigation', 'remain', 'focused', 'campbell', 'prospector', 'decline', 'discuss', 'probe']","['federal', 'prospector', 'refuse', 'discuss', 'investigation', 'lawyer', 'familiar', 'remain', 'focused', 'campbell']",4.800000190734863,9,5476,5380,96,9216
2975,"['bones', 'industrial', 'average', 'point', 'percent']","['blue', 'chip', 'bones', 'industrial', 'average', 'fall', 'point', 'percent', 'give', 'percent', 'early']",2.5,5,4618,2343,2275,5175625
2976,"['peace', 'rules', 'defeat', 'funny', 'louisiana', 'derby']","['peace', 'rule', 'funny', 'draw', 'away']",2.25,2,1911,2153,-242,58564
2977,"['say', 'final', 'agreement', 'expect', 'sign', 'week']","['organ', 'air', 'deal', 'expect', 'penalize', 'week', 'spokesman', 'mob', 'having', 'say']",3.0,3,3790,2813,977,954529
2978,"['share', 'eds', 'close', 'thursday', 'gain', 'cent']","['share', 'eds', 'close', 'thursday', 'cent', 'new', 'work', 'stock', 'exchange']",3.6670000553131104,5,4637,3979,658,432964
2979,"['divide', 'supreme', 'court', 'rule', 'monday', 'congress', 'force', 'nation', 'public', 'library', 'equip', 'computer', 'anti', 'pornography', 'filter']","['supreme', 'court', 'say', 'monday', 'government', 'require', 'public', 'library', 'equip', 'computer', 'anti', 'pornography', 'filter', 'reject', 'librarian', 'complaint', 'law', 'amount', 'censorship']",3.5999999046325684,10,5615,3847,1768,3125824
2980,"['weakness', 'exist', 'way', 'vba', 'look', 'property', 'document', 'pass', 'document', 'open', 'host', 'application']","['vulnerability', 'exist', 'way', 'microsoft', 'visual', 'basic', 'applications', 'check', 'document', 'property', 'pass', 'document', 'open']",3.799999952316284,6,5225,4092,1133,1283689
2981,"['million', 'phone', 'vote', 'percent', 'studdard', 'put', 'vote', 'ahead', 'like']","['million', 'phone', 'vote', 'cast', 'studdard', 'vote', 'ahead', 'like']",3.400000095367432,6,5226,3654,1572,2471184
2982,"['consumer', 'descrambling', 'security', 'card', 'cable', 'operator', 'plug', 'set']","['watch', 'pay', 'television', 'consumer', 'insert', 'set', 'security', 'card', 'provide', 'cable', 'service']",3.400000095367432,5,4617,3677,940,883600
2983,"['decide', 'opt', 'european', 'consortium', 'engine', 'good', 'overall', 'solution', 'substantial', 'price', 'effort']","['decide', 'opt', 'european', 'consortium', 'engine', 'good', 'overall', 'solution']",3.799999952316284,8,5422,4083,1339,1792921
2984,"['good', 'drug', 'administration', 'reject', 'imclone', 'application', 'sell', 'erbitux', 'bite', 'shod', 'research']","['good', 'drug', 'administration', 'reject', 'imclone', 'original', 'application', 'december', 'say', 'trial', 'sleepily', 'conduct']",2.799999952316284,6,5228,2589,2639,6964321
2985,"['critic', 'law', 'violate', 'civil', 'liberty', 'house', 'judiciary', 'committee', 'chairman', 'james', 'sensenbrenner', 'r', 'say', 'sensitive']","['house', 'judiciary', 'committee', 'chairman', 'james', 'sensenbrenner', 'r', 'say', 'sensitive', 'civil', 'liberty', 'complaint']",3.75,11,5644,4035,1609,2588881
2986,"['lodges', 'win', 'sixth', 'consecutive', 'game', 'long', 'win', 'streak', 'edge', 'colorado', 'wednesday', 'crowd', 'lodger', 'stadium']","['lodges', 'win', 'sixth', 'consecutive', 'game', 'seventh', 'beat', 'colorado', 'wednesday', 'crowd', 'lodger', 'stadium']",4.400000095367432,10,5613,5020,593,351649
2987,"['far', 'search', 'pennsylvania', 'ohio', 'michigan', 'illinois', 'indiana', 'authority', 'state', 'say']","['far', 'authority', 'search', 'area', 'pennsylvania', 'ohio', 'indiana', 'michigan']",3.75,7,5315,4027,1288,1658944
2988,"['year', 'bond', 'form', 'take', 'yield', 'percent', 'record', 'low', 'percent']","['year', 'bond', 'form', 'take', 'yield', 'percent', 'hit', 'record', 'low', 'percent']",2.75,8,5421,2561,2860,8179600
2989,"['argue', 'hand', 'document', 'violation', 'fifth', 'amendment', 'right', 'self', 'discrimination']","['refuse', 'turn', 'paper', 'assert', 'fifth', 'amendment', 'right', 'self', 'discrimination']",3.799999952316284,5,4603,4093,510,260100
2990,"['strayhorn', 'say', 'time', 'texas', 'history', 'comptroller', 'terrify', 'appropriation', 'act']","['news', 'release', 'thursday', 'strayhorn', 'say', 'time', 'comptroller', 'reject', 'budget']",3.200000047683716,4,4388,3247,1141,1301881
2991,"['exclude', 'charge', 'analysis', 'average', 'expect', 'loss', 'cent', 'share']","['analysis', 'poll', 'thomson', 'financial', 'expect', 'loss', 'cent', 'share', 'continue', 'operation']",3.799999952316284,5,4605,4094,511,261121
2992,"['security', 'expert', 'warn', 'new', 'mass', 'fail', 'worm', 'spread', 'widely', 'internet', 'lose', 'e', 'mail', 'microsoft', 'founder']","['new', 'worm', 'spread', 'rapidly', 'internet', 'pretend', 'e', 'mail', 'microsoft', 'chairman', 'rates', 'antivirus', 'vendor', 'say', 'monday']",4.800000190734863,7,5332,5378,-46,2116
2993,"['hazel', 'say', 'police', 'identify', 'body', 'seven', 'strong', 'cell', 'believe', 'carry', 'simultaneous', 'attack', 'saturday']","['say', 'police', 'identify', 'body', 'seven', 'comber', 'launch', 'simultaneous', 'maid', 'friday', 'night']",4.0,6,5212,4555,657,431649
2994,"['new', 'jersey', 'bank', 'holder', 'earner', 'permit', 'intermediate', 'license', 'cell', 'phone', 'paper', 'tireless', 'device', 'drive']","['addition', 'ntsb', 'recommend', 'nhtsa', 'state', 'legislation', 'enact', 'prohibit', 'holder', 'earner', 'permit', 'intermediate', 'license', 'mobile', 'phone', 'drive']",1.399999976158142,7,5335,1277,4058,16467364
2995,"['university', 'michigan', 'release', 'today', 'new', 'admission', 'policy', 'supreme', 'court', 'strike', 'june', 'way', 'previously', 'admit', 'undergraduate']","['university', 'michigan', 'plan', 'release', 'new', 'undergraduate', 'admission', 'policy', 'thursday', 'acceptance', 'requirement', 'reject', 'supreme', 'court', 'june']",4.199999809265137,10,5612,4812,800,640000
2996,"['audiotape', 'tired', 'week', 'arab', 'll', 'jazeera', 'television', 'network', 'appear', 'effort', 'invite', 'attack']","['audiotape', 'tired', 'week', 'arab', 'al', 'jazeera', 'television', 'network', 'strong', 'evidence', 'madam', 'survive', 'war']",1.7999999523162842,7,5336,1629,3707,13741849
2997,"['company', 'detail', 'cost', 'replacement', 'repair']","['company', 'official', 'expect', 'cost', 'replacement', 'work', 'run', 'million', 'dollar']",2.0,3,3785,1866,1919,3682561
2998,"['mean', 'tell', 'reporter', 'travel', 'city', 'sleepless', 'summer', 'tour', 'consider', 'campaign', 'texas', 'challenge']","['today', 'mean', 'end', 'day', 'city', 'sleepless', 'summer', 'tour', 'chicago', 'new', 'work']",2.5999999046325684,5,4611,2459,2152,4631104
2999,"['feel', 'disagree', 'rose', 'lose', 'job', 'say']","['lavender', 'feel', 'disagree', 'rose', 'lose', 'job']",3.25,5,4612,3332,1280,1638400
3000,"['american', 'decision', 'provoke', 'angry', 'reaction', 'european', 'commission', 'describe', 'legally', 'warrant', 'economically', 'unfounded', 'politically', 'helpful']","['european', 'commission', 'powerful', 'executive', 'body', 'describe', 'legally', 'warrant', 'economically', 'unfounded', 'politically', 'helpful']",3.75,9,5551,4030,1521,2313441
3001,"['grippe', 'prawak', 'leave', 'friday', 'day', 'department', 'introduce', 'plan', 'distribute', 'medical', 'marijuana', 'doctor', 'office']","['director', 'office', 'medical', 'access', 'windy', 'grippe', 'prawak', 'leave', 'job', 'department', 'introduce', 'plan', 'distribute', 'marijuana', 'doctor', 'office']",4.25,11,5640,4912,728,529984
3002,"['morgenthau', 'say', 'wire', 'transfer', 'deacon', 'account', 'total', 'billion']","['fire', 'transfer', 'account', 'open', 'deacon', 'total', 'billion', 'morgenthau', 'say']",4.75,7,5337,5342,-5,25
3003,"['year', 'unsuccessful', 'bid', 'democratic', 'nomination', 'governor']","['run', 'year', 'democratic', 'nomination', 'texas', 'governor', 'lose', 'primary', 'multimillionaire', 'bony', 'ranches']",3.25,4,4386,3340,1046,1094116
3004,"['nation', 'large', 'retailer', 'tell', 'supplier', 'start', 'electronic', 'tag', 'pellet', 'good']","['pal', 'tell', 'supplier', 'need', 'radio', 'frequency', 'system', 'place', 'crack', 'pellet', 'good', 'supply', 'chain']",3.75,4,4385,4049,336,112896
3005,"['take', 'hospital', 'precautionary', 'x', 'ray', 'neck']","['harvey', 'take', 'duke', 'hospital', 'precautionary', 'neck', 'x', 'ray', 'come', 'negative']",3.25,6,5227,3335,1892,3579664
3006,"['bill', 'say', 'woman', 'undergo', 'abortion', 'prosecute']","['woman', 'undergo', 'abortion', 'prosecute', 'bill']",5.0,5,4659,5668,-1009,1018081
3007,"['democrats', 'assembly', 'republicans']","['democrats', 'dominate', 'assembly', 'republicans', 'control', 'senate']",2.0,3,3734,1868,1866,3481956
3008,"['come', 'basically', 'washington', 'establish', 'relationship', 'sure', 'get', 'federal', 'money', 'california', 'schwarzenegger', 'say', 'meet', 'congressional', 'republicans']","['come', 'washington', 'basically', 'establish', 'relationship', 'sure', 'get', 'federal', 'money', 'schwarzenegger', 'say', 'meeting']",4.199999809265137,11,5641,4803,838,702244
3009,"['late', 'snapshot', 'labor', 'market', 'slightly', 'well', 'economist', 'expect', 'forecast', 'claim', 'fall', 'low', 'week']","['despite', 'problem', 'job', 'market', 'late', 'snapshot', 'labor', 'market', 'slightly', 'well', 'economist', 'expect']",3.400000095367432,8,5364,3575,1789,3200521
3010,"['chante', 'away', 'millard', 'go', 'trial', 'monday', 'charge', 'degree', 'murder']","['chante', 'lawton', 'millard', 'charge', 'murder', 'tapering', 'evidence']",3.0,4,4383,2756,1627,2647129
3011,"['mind', 'blunders', 'plead', 'guilty', 'federal', 'court', 'charge', 'include', 'extortion', 'money', 'wandering', 'conspiracy']","['ships', 'aide', 'mind', 'blunders', 'hobby', 'mclamb', 'plead', 'guilty', 'federal', 'charge', 'include', 'extortion']",2.75,8,5368,2568,2800,7840000
3012,"['vivendi', 'share', 'close', 'percent', 'paris', 'europe']","['vivendi', 'share', 'percent', 'europe', 'paris', 'gmt']",2.5999999046325684,5,4666,2453,2213,4897369
3013,"['microsoft', 'identify', 'freely', 'distribute', 'sinus', 'software', 'big', 'threat', 'sale']","['company', 'publicly', 'identify', 'sinus', 'big', 'competitive', 'threat']",3.400000095367432,4,4381,3576,805,648025
3014,"['antonio', 'monteiro', 'de', 'gastro', 'currently', 'director', 'group', 'latin', 'america', 'caribbean', 'operation', 'chief', 'operating', 'officer', 'date']","['bat', 'say', 'antonio', 'monteiro', 'de', 'gastro', 'director', 'latin', 'america', 'caribbean', 'chief', 'operating', 'officer', 'january']",3.5999999046325684,11,5652,3842,1810,3276100
3015,"['pin', 'manipulation', 'public', 'relation', 'propaganda', 'answer', 'say']","['report', 'add', 'spin', 'manipulation', 'public', 'relation', 'answer', 'avoid', 'debate']",3.5999999046325684,4,4380,3874,506,256036
3016,"['shooting', 'link', 'spree', 'occur', 'sov', 'hamilton', 'central', 'elementary', 'bet', 'mile', 'freely']","['late', 'shooting', 'link', 'spree', 'sov', 'shooting', 'hamilton', 'township', 'elementary', 'school', 'bet', 'mile', 'freely']",4.800000190734863,9,5540,5376,164,26896
3017,"['tuesday', 'central', 'bank', 'leave', 'interest', 'rate', 'steady', 'expect', 'declare', 'overall', 'risk', 'weight', 'weakness', 'warn', 'relation', 'risk']","['central', 'bank', 'policy', 'board', 'leave', 'rate', 'steady', 'widely', 'expect', 'surprise', 'market', 'declare', 'overall', 'risk', 'weight', 'weakness']",4.0,11,5662,4549,1113,1238769
3018,"['fighting', 'erupt', 'north', 'organ', 'journalist', 'confront', 'dozen', 'south', 'organ', 'activist', 'protest', 'human', 'right', 'abuse', 'north', 'outside', 'main', 'medium', 'centre']","['trouble', 'flare', 'north', 'organ', 'reporter', 'rush', 'taegu', 'media', 'centre', 'confront', 'dozen', 'activist', 'protest', 'human', 'right', 'abuse', 'north']",3.400000095367432,10,5611,3548,2063,4255969
3019,"['dusty', 'battle', 'kidney', 'cancer', 'year']","['dusty', 'surgery', 'cancer', 'kidney', 'remove']",2.400000095367432,3,3759,2224,1535,2356225
3020,"['kadyrov', 'injure', 'bodyguard', 'kill']","['star', 'pass', 'news', 'agency', 'say', 'bodyguard', 'kill', 'bomb']",3.0,2,1910,2762,-852,725904
3021,"['commission', 'estimate', 'california', 'lose', 'billion', 'state', 'tax', 'shelter']","['commission', 'estimate', 'california', 'lose', 'million', 'corporate', 'tax', 'shelter']",2.75,6,5165,2571,2594,6728836
3022,"['official', 'force', 'cross', 'syrian', 'territory', 'vague', 'syrian', 'border', 'guard', 'involved']","['official', 'american', 'force', 'act', 'intelligence', 'cross', 'syrian', 'territory', 'vague', 'syrian', 'guard', 'involve']",4.0,7,5325,4548,777,603729
3023,"['verisign', 'introduce', 'site', 'hinder', 'service', 'kept']","['battle', 'week', 'old', 'site', 'hinder', 'service', 'rage']",1.75,3,3611,1617,1994,3976036
3024,"['truce', 'hold', 'prison', 'isolation', 'say']","['truce', 'night', 'hold', 'isolation', 'prison']",4.5,4,4350,5147,-797,635209
3025,"['leader', 'bu', 'war', 'al', 'di', 'turn', 'june', 'deputy', 'kill', 'recent', 'shootout', 'maude', 'force']","['leader', 'bu', 'war', 'al', 'di', 'surrender', 'june', 'deputy', 'kill', 'shoot', 'maude', 'force', 'recently']",5.0,10,5610,5669,-59,3481
3026,"['freita', 'opening', 'statement', 'king', 'county', 'superior', 'court', 'judge', 'charles', 'vertex', 'recess', 'trial', 'thanksgiving', 'weekend']","['king', 'county', 'superior', 'court', 'judge', 'charles', 'vertex', 'recess', 'trial', 'monday']",3.0,9,5521,2766,2755,7590025
3027,"['google', 'investor', 'include', 'prominent', 'firm', 'plainer', 'jerking', 'garfield', 'eyes', 'sequoia', 'capital', 'paper', 'note']","['google', 'early', 'stage', 'banker', 'include', 'california', 'base', 'stanford', 'university', 'firm', 'plainer', 'jerking', 'sequoia', 'capital']",2.799999952316284,7,5320,2593,2727,7436529
3028,"['july', 'st', 'sixth', 'anniversary', 'long', 'long', 'return', 'chinese', 'rule']","['rally', 'overshadow', 'ceremony', 'mark', 'sixth', 'anniversary', 'long', 'long', 'return', 'china', 'july']",2.6670000553131104,5,4675,2533,2142,4588164
3029,"['calm', 'wednesday', 'announce', 'plan', 'acquire', 'handspring', 'company', 'start', 'jeff', 'napkins', 'regard', 'father', 'calm', 'hand']","['calm', 'say', 'wednesday', 'plan', 'buy', 'handspring', 'company', 'create', 'renegade', 'calm', 'co', 'founder', 'jeff', 'napkins']",4.0,7,5313,4534,779,606841
3030,"['government', 'recently', 'shell', 'peace', 'talk', 'milf', 'border', 'malaysia', 'string', 'attack', 'include', 'coming', 'mindanao']","['government', 'recently', 'shell', 'peace', 'talk', 'border', 'neighbour', 'malaysia', 'state', 'attack', 'mindanao', 'include', 'deadly', 'coming', 'blame', 'milf']",4.25,12,5710,4935,775,600625
3031,"['company', 'post', 'profit', 'million', 'cent', 'share', 'year', 'ago', 'period']","['year', 'ago', 'quarter', 'company', 'earn', 'million', 'cent', 'share']",4.176000118255615,6,5160,4704,456,207936
3032,"['join', 'boston', 'monday', 'massachusetts', 'community', 'watertown', 'august', 'framingham']","['long', 'boston', 'watertown', 'august', 'framingham', 'go', 'smoke', 'free', 'monday']",3.0,5,4676,2817,1859,3455881
3033,"['israeli', 'soldier', 'knock', 'mobile', 'home', 'water', 'tower', 'tiny', 'west', 'bank', 'settlement', 'outpost', 'overnight', 'back', 'ideas', 'peace', 'plan']","['israel', 'soldier', 'begin', 'tear', 'settlement', 'outpost', 'west', 'bank', 'yesterday', 'israel', 'obligation', 'new', 'ideas', 'peace', 'plan']",3.799999952316284,8,5379,4068,1311,1718721
3034,"['union', 'reveal', 'chain', 'target']","['union', 'say', 'reveal', 'later', 'chain', 'target']",4.599999904632568,4,4404,5227,-823,677329
3035,"['met', 'say', 'davidowitz', 'chairman', 'davidowitz', 'associates', 'national', 'retail', 'consulting', 'firm', 'base', 'new', 'work', 'city']","['innocent', 'damage', 'good', 'say', 'davidowitz', 'chairman', 'davidowitz', 'associates', 'national', 'retail', 'consulting', 'firm', 'new', 'work']",1.399999976158142,10,5619,1287,4332,18766224
3036,"['update', 'product', 'include', 'salon', 'fro', 'salon', 'conduct', 'salon', 'salon', 'application', 'server']","['new', 'product', 'desktop', 'include', 'late', 'version', 'salon', 'conduct', 'salon', 'fro']",2.799999952316284,5,4658,2596,2062,4251844
3037,"['turkish', 'authority', 'say', 'suicide', 'comber', 'turks']","['ankara', 'say', 'suicide', 'comber', 'turkish']",4.199999809265137,4,4347,4830,-483,233289
3038,"['april', 'forecast', 'operating', 'earning', 'range', 'cent', 'share']","['today', 'expect', 'earning', 'cent', 'cent', 'share', 'quarter']",1.0,3,3794,934,2860,8179600
3039,"['florida', 'alaska', 'thousand', 'reveler', 'vow', 'push', 'legal', 'right', 'include', 'sex', 'marriage']","['thousand', 'reveller', 'celebrate', 'decision', 'vow', 'push', 'legal', 'right', 'include', 'sex', 'marriage']",4.199999809265137,8,5424,4814,610,372100
3040,"['status', 'egypt', 'israel', 'australia']","['nation', 'like', 'israel', 'australia', 'status']",2.5,3,3802,2360,1442,2079364
3041,"['finding', 'appear', 'wednesday', 'journal', 'american', 'medical', 'association', 'news', 'web', 'site']","['result', 'publish', 'wednesday', 'issue', 'journal', 'american', 'medical', 'association']",3.5,5,4644,3720,924,853776
3042,"['additionally', 'cradle', 'room', 'charge', 'second', 'battery']","['cradle', 'space', 'charge', 'second', 'battery']",4.75,4,4316,5337,-1021,1042441
3043,"['word', 'point', 'word', 'refugee', 'english', 'turkish', 'dictionary']","['man', 'banish', 'english', 'turkish', 'dictionary', 'point', 'word', 'refugee']",3.5,6,5154,3717,1437,2064969
3044,"['close', 'co', 'operation', 'law', 'enforcement', 'agency', 'intelligence', 'service', 'lie', 'heart', 'go', 'fight', 'terrorist', 'say']","['close', 'cooperation', 'regional', 'law', 'enforcement', 'agency', 'intelligence', 'service', 'heart', 'fight', 'terrorist', 'say']",4.0,10,5607,4530,1077,1159929
3045,"['group', 'say', 'market', 'rebound', 'percent', 'billion', 'sale']","['asia', 'pacific', 'report', 'growth', 'percent', 'billion']",2.0,2,1907,1832,75,5625
3046,"['captain', 'robert', 'damsel', 'st', 'humoured', 'division', 'say', 'truck', 'explode', 'outside', 'building', 'compound', 'outer', 'wall', 'collapse']","['captain', 'robert', 'damsel', 'humored', 'division', 'say', 'truck', 'explode', 'outside', 'building']",3.200000047683716,9,5534,3242,2292,5253264
3047,"['northern', 'autumn', 'trainer', 'work', 'soldier', 'north', 'african', 'country', 'patrol', 'gather', 'intelligence']","['later', 'year', 'command', 'send', 'trainer', 'soldier', 'north', 'african', 'nation', 'patrolling', 'intelligence', 'gathering', 'mission']",3.799999952316284,5,4656,4075,581,337561
3048,"['figure', 'catastrophe', 'say', 'patrick', 'pelloux', 'president', 'association', 'emergency', 'room', 'physician']","['unacceptable', 'say', 'patrick', 'pelloux', 'president', 'france', 'association', 'emergency', 'doctors']",2.5,6,5147,2362,2785,7756225
3049,"['happen', 'way', 'punishment', 'certainly', 'covello', 'tell', 'year', 'old', 'family', 'friend', 'supporter', 'fill', 'half', 'courtroom']","['happen', 'sir', 'way', 'punishment', 'certainly', 'covello', 'say']",3.0,5,4657,2892,1765,3115225
3050,"['mother', 'allege', 'lawsuit', 'sexually', 'assault', 'guard']","['mother', 'contend', 'sexually', 'assault', 'guard', 'confrontation']",4.0,4,4312,4531,-219,47961
3051,"['yes', 'today', 'clash', 'memory', 'purchase', 'amd', 'fujitsu', 'brand', 'passion']","['passion', 'clash', 'memory', 'solution', 'available', 'worldwide', 'amd', 'fujitsu']",2.625,5,4651,2526,2125,4515625
3052,"['world', 'large', 'automaker', 'say', 'sale', 'decline', 'predict', 'month', 'late', 'summer', 'sale', 'frenzy', 'cause', 'industry', 'backwash', 'expect']","['domestic', 'sale', 'word', 'motor', 'decline', 'predict', 'late', 'summer', 'sale', 'frenzy', 'prompt', 'large', 'expect', 'industry', 'backwash']",3.200000047683716,10,5606,3275,2331,5433561
3053,"['tropical', 'storm', 'rapidly', 'develop', 'gulf', 'mexico', 'sunday', 'expect', 'hit', 'texas', 'louisiana', 'coast', 'monday', 'night']","['tropical', 'storm', 'rapidly', 'develop', 'gulf', 'mexico', 'sunday', 'hurricane', 'force', 'wind', 'hit', 'land', 'louisiana', 'coast', 'monday', 'night']",4.0,12,5706,4533,1173,1375929
3054,"['pressure', 'rise', 'thursday', 'national', 'coverage', 'final', 'round', 'plan', 'espn', 'cable', 'sport', 'network']","['pressure', 'intensify', 'today', 'national', 'coverage', 'final', 'round', 'plan', 'espn', 'word', 'difficult']",3.200000047683716,7,5321,3306,2015,4060225
3055,"['pataki', 'praise', 'abraham', 'decision', 'lipa', 'chairman', 'richard', 'vessel', 'say', 'cable', 'keep', 'operation', 'permanently']","['lipa', 'chairman', 'richard', 'vessel', 'say', 'mean', 'cable', 'fit']",2.400000095367432,6,5142,2188,2954,8726116
3056,"['eye', 'come', 'diego', 'year', 'physician', 'cabs']","['eye', 'diego', 'spend', 'year', 'cabs', 'work', 'superconductor', 'material']",3.5999999046325684,4,4311,3860,451,203401
3057,"['meningitis', 'infection', 'spinal', 'cord', 'fluid', 'tissue', 'brain']","['meningitis', 'infection', 'fluid', 'person', 'spinal', 'cord', 'brain']",4.599999904632568,6,5140,5226,-86,7396
3058,"['mayor', 'toe', 'parker', 'say', 'late', 'thursday', 'worker', 'man', 'woman', 'inside', 'building', 'blast', 'occur']","['miss', 'worker', 'man', 'woman', 'inside', 'building', 'blast', 'occur', 'mayor', 'toe', 'parker', 'say']",4.400000095367432,11,5654,5013,641,410881
3059,"['london', 'base', 'ncri', 'official', 'li', 'safavi', 'tell', 'letter', 'condemn', 'raid', 'view', 'illegal', 'morally', 'politically', 'unjustifiable']","['condemn', 'raid', 'view', 'illegal', 'morally', 'politically', 'unjustifiable', 'london', 'base', 'ncri', 'official', 'li', 'safavi', 'tell', 'letters', 'telephone']",4.599999904632568,14,5733,5249,484,234256
3060,"['explode', 'hand', 'italian', 'prime', 'minister', 'hurt']","['letter', 'bomb', 'send', 'rode', 'explode', 'hand', 'hurt']",3.5999999046325684,3,3693,3858,-165,27225
3061,"['falaba', 'military', 'attorney', 'air', 'force', 'james', 'key', 'deny', 'charge', 'carry', 'death', 'penalty']","['attorney', 'represent', 'al', 'falaba', 'air', 'force', 'james', 'key', 'iii', 'deny', 'charge', 'accord', 'associated', 'dress']",3.200000047683716,8,5440,3284,2156,4648336
3062,"['nasal', 'letter', 'court', 'say', 'tear', 'family', 'apart']","['seek', 'tendency', 'nasal', 'apologize', 'court', 'employee', 'family']",2.0,3,3647,1841,1806,3261636
3063,"['early', 'city', 'receive', 'report', 'dead', 'blue', 'day', 'crow', 'jayroe', 'say']","['early', 'city', 'receive', 'report', 'say']",2.799999952316284,5,4645,2600,2045,4182025
3064,"['forest', 'freedom', 'organisation', 'right', 'enjoy', 'smoking', 'tobacco', 'say', 'mention', 'word', 'prohibition', 'know', 'happen']","['forest', 'freedom', 'organisation', 'right', 'enjoy', 'smoking', 'tobacco', 'say', 'greet', 'lancet', 'amusement', 'disbelieve']",1.600000023841858,8,5453,1590,3863,14922769
3065,"['convert', 'baystar', 'aggregate', 'approximately', 'million', 'share', 'sco', 'common', 'stock', 'percent', 'company', 'outstanding', 'share']","['investment', 'give', 'larkspur', 'baystar', 'million', 'share', 'sco', 'common', 'stock', 'percent', 'company', 'outstanding', 'share']",4.0,9,5557,4546,1011,1022121
3066,"['opec', 'producer', 'meeting', 'wednesday', 'set', 'pressure', 'independent', 'oil', 'export', 'contribute', 'carted', 'supply', 'cut', 'allow', 'return', 'iraqi', 'oil']","['opec', 'week', 'set', 'pressure', 'independent', 'export', 'carted', 'supply', 'cut', 'prevent', 'resumption', 'iraqi', 'export', 'undercut', 'oil', 'price']",2.799999952316284,10,5605,2614,2991,8946081
3067,"['federal', 'trade', 'commission', 'ftc', 'ask', 'congress', 'today', 'additional', 'authority', 'fight', 'unwanted', 'internet', 'spasm', 'account', 'half', 'e', 'mail', 'traffic']","['federal', 'trade', 'commission', 'ask', 'congress', 'yesterday', 'broad', 'power', 'attack', 'rapidly', 'grow', 'problem', 'spasm', 'new', 'study', 'account', 'half', 'e', 'mail', 'traffic']",5.0,11,5668,5672,-4,16
3068,"['federal', 'grand', 'jury', 'indict', 'tuesday', 'document', 'seal', 'yesterday', 'allow', 'authority', 'arrest']","['federal', 'official', 'say', 'document', 'remained', 'seal', 'thursday', 'morning', 'allow', 'authority', 'arrest', 'western', 'state']",3.400000095367432,6,5170,3599,1571,2468041
3069,"['people', 'oppose', 'action', 'try', 'find', 'fresh', 'reason', 'right', 'thing']","['happen', 'people', 'oppose', 'action', 'try', 'find', 'fresh', 'reason', 'right', 'thing']",4.0,9,5543,4536,1007,1014049
3070,"['richard', 'miller', 'remained', 'hospitalize', 'undergo', 'liver', 'transplant', 'wife', 'recover']","['richard', 'miller', 'survive', 'lifesave', 'liver', 'transplant', 'remains', 'hospitalize']",3.200000047683716,5,4665,3295,1370,1876900
3071,"['frequent', 'representative', 'immediately', 'reach', 'comment', 'sco', 'announcement']","['spokesman', 'sco', 'reach', 'comment', 'afternoon']",3.799999952316284,3,3680,4064,-384,147456
3072,"['proportion', 'people', 'cover', 'employer', 'drop', 'percent', 'percent', 'year']","['proportion', 'americans', 'insurance', 'employer', 'decline', 'percent', 'percent', 'percent']",3.200000047683716,3,3678,3296,382,145924
3073,"['world', 'clayton', 'hewitt', 'accuse', 'association', 'tennis', 'professional', 'malice', 'include', 'allege', 'attempt', 'year', 'dupe', 'refuse', 'drug', 'test']","['world', 'clayton', 'hewitt', 'accuse', 'professional', 'peer', 'long', 'stand', 'malice', 'include', 'attempt', 'year', 'dupe', 'refuse', 'drug', 'test']",4.0,13,5726,4540,1186,1406596
3074,"['msn', 'messenger', 'available', 'download', 'start', 'gmt', 'wednesday']","['msn', 'messenger', 'software', 'available', 'pst', 'wednesday', 'accord', 'microsoft']",3.25,4,4310,3336,974,948676
3075,"['connection', 'incident', 'acknowledge', 'behave', 'inappropriately']","['acknowledge', 'behave', 'inappropriately', 'say']",4.25,3,3675,4949,-1274,1623076
3076,"['spokesman', 'say', 'november', 'co', 'operate', 'fully', 'police']","['add', 'co', 'operate', 'fully', 'police', 'november']",4.25,5,4607,4931,-324,104976
3077,"['woman', 'eat', 'potato', 'numerous', 'vegetable', 'pregnancy', 'risk', 'trigger', 'type', 'diabete', 'child', 'melbourne', 'research', 'believe']","['australian', 'research', 'believe', 'find', 'trigger', 'type', 'diabete', 'child', 'mother', 'eat', 'potato', 'numerous', 'vegetable', 'pregnancy']",4.25,11,5667,4937,730,532900
3078,"['broad', 'standard', 'door', 'index', 'inch', 'point', 'percent']","['technology', 'lace', 'nasdaq', 'composite', 'index', 'lose', 'point', 'percent']",0.75,3,3722,748,2974,8844676
3079,"['people', 'think', 'blood', 'pressure', 'fine', 'actually', 'way', 'hypertension', 'new', 'guideline', 'publish', 'wednesday']","['people', 'think', 'blood', 'pressure', 'fine', 'actually', 'need', 'start', 'exercise', 'eat', 'well', 'accord', 'new', 'guideline', 'publish', 'wednesday']",3.0,10,5604,2898,2706,7322436
3080,"['amazon', 'report', 'new', 'work', 'attorney', 'general', 'office', 'settle', 'civil', 'fraud', 'charge', 'spoofer', 'identify']","['amazon', 'new', 'work', 'attorney', 'general', 'office', 'settle', 'alleged', 'e', 'mail', 'forget']",3.75,7,5327,4044,1283,1646089
3081,"['lead', 'actress', 'nod', 'go', 'energetic', 'newcomer', 'drissa', 'caret', 'winokur', 'anna', 'daughter', 'gray']","['drissa', 'caret', 'winokur', 'gray', 'win', 'good', 'actress', 'musical']",4.0,5,4606,4543,63,3969
3082,"['appear', 'initial', 'report', 'textbook', 'land', 'consider', 'circumstance', 'burke', 'say']","['say', 'burke', 'textbook', 'land', 'consider', 'circumstance']",4.0,6,5189,4544,645,416025
3083,"['allegiant', 'share', 'rise', 'percent', 'thursday', 'morning', 'trading', 'nasdaq', 'stock', 'market']","['allegiant', 'stock', 'close', 'wednesday', 'cent', 'trading', 'nasdaq', 'market']",2.0,5,4673,1856,2817,7935489
3084,"['state', 'law', 'call', 'public', 'information', 'release']","['law', 'call', 'public', 'information', 'rhode', 'island']",3.400000095367432,4,4308,3593,715,511225
3085,"['adr', 'fall', 'cent', 'new', 'work', 'stock', 'exchange', 'composite', 'trading', 'today']","['share', 'box', 'entertainment', 'group', 'news', 'medium', 'entertainment', 'arm', 'fall', 'cent', 'new', 'work', 'stock', 'exchange', 'composite', 'trading']",1.399999976158142,8,5433,1270,4163,17330569
3086,"['prefer', 'say', 'initiative', 'launch', 'million', 'nationwide', 'program', 'week', 'clean', 'neighborhood', 'build', 'community', 'project']","['prefer', 'say', 'launch', 'million', 'program', 'week', 'clean', 'neighborhood', 'ran', 'build', 'community', 'project', 'give', 'detail']",3.400000095367432,11,5665,3435,2230,4972900
3087,"['nasdaq', 'composite', 'index', 'add', 'point', 'percent']","['nasdaq', 'weekly', 'gain', 'percent', 'close', 'gain', 'yesterday']",2.400000095367432,2,1906,2208,-302,91204
3088,"['british', 'foreign', 'office', 'say', 'monday', 'coalition', 'authority', 'ran', 'pleased', 'man', 'free']","['british', 'foreign', 'office', 'say', 'meditate', 'man', 'release']",2.5999999046325684,5,4672,2469,2203,4853209
3089,"['pal', 'estimate', 'million', 'americans', 'visit', 'store', 'week']","['week', 'million', 'shipper', 'visit', 'pal', 'store']",2.799999952316284,5,4655,2610,2045,4182025
3090,"['add', 'rode', 'maybe', 'old', 'age', 'help', 'understand', 'strength', 'weakness']","['maybe', 'old', 'age', 'help', 'understand', 'strength', 'weakness', 'reality', 'world']",3.200000047683716,7,5339,3299,2040,4161600
3091,"['proud', 'stand', 'richard', 'dixon', 'merry', 'say']","['march', 'street', 'richard', 'dixon', 'vietnam', 'war', 'say']",2.400000095367432,3,3669,2220,1449,2099601
3092,"['share', 'corixa', 'gain', 'cent', 'nasdaq']","['late', 'morning', 'trading', 'nasdaq', 'stock', 'market', 'corixa', 'cent']",3.25,3,3696,3397,299,89401
3093,"['spokesman', 'fbi', 'cia', 'canadian', 'security', 'intelligence', 'service', 'royal', 'canadian', 'mounted', 'police', 'decline', 'comment', 'll', 'shukrijumah', 'stay', 'canada']","['fbi', 'cia', 'canadian', 'security', 'intelligence', 'service', 'royal', 'canadian', 'mounted', 'police', 'decline', 'comment', 'washington', 'times', 'report']",2.75,11,5664,2570,3094,9572836
3094,"['persistent', 'problem', 'solve', 'investigation', 'board', 'member', 'palace', 'say']","['persistent', 'problem', 'solve', 'mechanically', 'physically', 'say', 'board', 'member', 'palace']",4.0,7,5340,4545,795,632025
3095,"['americans', 'cut', 'run', 'misadventure', 'say']","['pledge', 'bring', 'peace', 'ran', 'americans', 'cut', 'run', 'misadventure']",3.5999999046325684,4,4306,3962,344,118336
3096,"['doubt', 'chemical', 'programme', 'biological', 'programme', 'nuclear', 'programme', 'document', 'say']","['add', 'doubt', 'chemical', 'programme', 'biological', 'programme', 'nuclear', 'weapon', 'programme']",3.799999952316284,5,4650,4077,573,328329
3097,"['ridge', 'say', 'real', 'explosive', 'harmful', 'device', 'exercise']","['ridge', 'say', 'actual', 'explosive', 'harmful', 'substance']",4.599999904632568,4,4303,5252,-949,900601
3098,"['america', 'friend', 'happen', 'say', 'loud', 'applause']","['america', 'friend', 'happen']",3.25,3,3668,3391,277,76729
3099,"['crawl', 'narrow', 'wind', 'canyon', 'appeal', 'foot', 'cliff', 'walk', 'mile', 'canyon']","['crawl', 'narrow', 'wind', 'canyon', 'appeal', 'foot', 'cliff', 'walk', 'mile', 'canyon', 'near', 'canyonlands', 'national', 'dark', 'southwestern', 'utah']",3.75,9,5510,4043,1467,2152089
3100,"['amnesty', 'international', 'say', 'past', 'year', 'collect', 'information', 'disappearance', 'ran', 'actual', 'figure', 'high']","['amnesty', 'international', 'say', 'past', 'year', 'collect', 'information', 'disappearance', 'ran']",4.0,9,5496,4576,920,846400
3101,"['texas', 'instruments', 'climb', 'yesterday', 'novellus', 'systems', 'advance']","['texas', 'instruments', 'climb', 'novellus', 'systems', 'advance', 'having', 'raise', 'overnight', 'german']",3.75,6,5179,4042,1137,1292769
3102,"['ask', 'excuse', 'week', 'cabinet', 'session', 'prepare', 'meeting', 'president', 'swandam', 'agenda']","['take', 'highly', 'unusual', 'step', 'shipping', 'cabinet', 'attend', 'meeting', 'president', 'swandam', 'agenda']",3.4549999237060547,5,4646,3686,960,921600
3103,"['mixture', 'ancient', 'pagan', 'modern', 'christian', 'rate', 'villager', 'stage', 'series', 'ceremony', 'hope', 'ease', 'misfortune', 'believe', 'keep', 'poor']","['mixture', 'ancient', 'melanesian', 'pagan', 'modern', 'christian', 'ceremony', 'people', 'try', 'ease', 'misfortune', 'believe', 'keep', 'poor', 'long', 'ago', 'meal']",4.0,11,5671,4604,1067,1138489
3104,"['bones', 'industrial', 'average', 'edge', 'point', 'percent']","['bones', 'industrial', 'average', 'point', 'percent']",2.5,5,4677,2342,2335,5452225
3105,"['monkeypox', 'usually', 'find', 'central', 'western', 'africa']","['prairie', 'dog', 'usually', 'find', 'southwestern', 'western', 'state', 'indigenous', 'wisconsin']",0.25,3,3628,444,3184,10137856
3106,"['film', 'second', 'trilogy', 'wrap', 'november', 'matrix', 'revolutions']","['reload', 'second', 'installment', 'trilogy', 'matrix', 'revolutions', 'seat', 'debut', 'november']",3.8329999446868896,5,4680,4330,350,122500
3107,"['addition', 'justice', 'department', 'say', 'fbi', 'conduct', 'few', 'investigation', 'involve', 'visit', 'mosque']","['addition', 'few', 'fbi', 'office', 'conduct', 'investigation', 'involve', 'visit', 'islamic', 'mosque', 'justice', 'department', 'say']",3.75,11,5663,4034,1629,2653641
3108,"['launch', 'coincide', 'javaone', 'developer', 'conference', 'francisco', 'week']","['news', 'come', 'conjunction', 'gun', 'annual', 'javaone', 'developer', 'conference', 'francisco']",3.25,4,4301,3380,921,848241
3109,"['royal', 'duty', 'base', 'experience', 'diana', 'princess', 'tales', 'letter', 'allegedly']","['royal', 'household', 'race', 'revelation', 'royal', 'duty', 'base', 'servant', 'time', 'diana', 'princess', 'tales']",2.75,6,5175,2549,2626,6895876
3110,"['army', 'say', 'raid', 'come', 'day', 'israel', 'troop', 'shoot', 'kill', 'abdullah', 'kawasme', 'james', 'leader', 'city', 'target', 'militant', 'james']","['arrest', 'come', 'day', 'israel', 'troop', 'shoot', 'kill', 'abdullah', 'kawasme', 'militant', 'group', 'leader', 'neuron']",3.0,10,5602,2907,2695,7263025
3111,"['sars', 'go', 'claim', 'life', 'people', 'toronto', 'area', 'include', 'nurse', 'doctor']","['virus', 'kill', 'people', 'toronto', 'area', 'include', 'doctor', 'nurse']",3.200000047683716,6,5158,3229,1929,3721041
3112,"['apple', 'computer', 'new', 'online', 'music', 'service', 'sell', 'million', 'song', 'week', 'operation', 'company', 'say', 'monday']","['apple', 'computer', 'say', 'monday', 'exceed', 'record', 'industry', 'expectation', 'sell', 'million', 'song', 'launch', 'online', 'music', 'store', 'week', 'ago']",4.599999904632568,10,5601,5275,326,106276
3113,"['arrest', 'twice', 'trespassing', 'bar', 'complex', 'home', 'mother', 'child']","['arrest', 'twice', 'trespassing', 'bar', 'complex']",3.5999999046325684,5,4614,3933,681,463761
3114,"['oracle', 'chairman', 'ceo', 'carry', 'allison', 'rule', 'sweeten', 'company', 'unsolicited', 'offer', 'acquire', 'rival', 'peoplesoft']","['oracle', 'chairman', 'carry', 'allison', 'hint', 'company', 'increase', 'offer', 'rival', 'peoplesoft']",4.400000095367432,8,5456,4993,463,214369
3115,"['portuguese', 'weather', 'service', 'say', 'europe', 'heatwave', 'cause', 'mass', 'hot', 'dry', 'air', 'move', 'southeast']","['heatwave', 'mass', 'hot', 'dry', 'air', 'southeast', 'say', 'paris', 'almeida', 'portugal', 'weather', 'service']",4.056000232696533,9,5542,4698,844,712336
3116,"['spend', 'taxpayer', 'dollar', 'create', 'terrorist', 'bet', 'parlor', 'wasteful', 'repugnant', 'announce', 'press', 'conference', 'yesterday']","['spend', 'taxpayer', 'dollar', 'create', 'terrorist', 'bet', 'parlor', 'wasteful', 'repugnant', 'den', 'organ', 'say', 'monday', 'letter', 'pentagon']",3.5,9,5483,3712,1771,3136441
3117,"['somewhat', 'ambiguous', 'ruling', 'setback', 'static', 'control', 'depend', 'develop', 'compete', 'product', 'merrily', 'lynch', 'analyst', 'milunovich', 'say']","['merrily', 'lynch', 'analyst', 'milunovich', 'say', 'somewhat', 'ambiguous', 'ruling', 'regulatory', 'setback', 'static', 'control', 'depend', 'develop', 'compete', 'product']",5.0,15,5740,5674,66,4356
3118,"['monkey', 'track', 'progress', 'watch', 'schematic', 'representation', 'arm', 'motion', 'video', 'screen']","['arm', 'keep', 'separate', 'room', 'monkey', 'track', 'progress', 'watch', 'representation', 'arm', 'motion', 'video', 'screen']",4.0,9,5482,4609,873,762129
3119,"['trigger', 'hour', 'police', 'standoff', 'inconvenience', 'thousand', 'computer', 'traffic', 'back', 'downtown', 'washington', 'northern', 'virginia']","['protest', 'lead', 'hour', 'standoff', 'police', 'cause', 'huge', 'traffic', 'jame', 'downtown', 'washington', 'northern', 'virginia']",4.0,8,5463,4611,852,725904
3120,"['standard', 'door', 'index', 'advance', 'cent']","['broad', 'standard', 'door', 'index', 'rise', 'point', 'percent']",4.75,3,3650,5327,-1677,2812329
3121,"['agriculture', 'minister', 'nation', 'expect', 'attend', 'day', 'ministerial', 'conference', 'po', 'agricultural', 'science', 'technology', 'sponsor', 'department', 'agriculture']","['agriculture', 'secretary', 'inn', 'enema', 'kick', 'day', 'ministerial', 'conference', 'po', 'agricultural', 'science', 'technology', 'monday']",3.75,8,5464,4048,1416,2005056
3122,"['complicate', 'situation', 'presence', 'battle', 'harden', 'iberian', 'fight', 'side']","['fighting', 'continue', 'sporadically', 'west', 'complicate', 'presence', 'battle', 'harden', 'iberian', 'side']",4.0,6,5171,4613,558,311364
3123,"['year', 'audubon', 'society', 'host', 'annual', 'christmas', 'bird', 'count']","['national', 'audubon', 'society', 'annual', 'christmas', 'bird', 'count', 'season']",3.5,6,5174,3740,1434,2056356
3124,"['remove', 'site', 'list', 'broken', 'english', 'rule', 'hawker', 'participate']","['organizer', 'establish', 'web', 'site', 'list', 'broken', 'english', 'rule', 'hawker', 'participate']",3.0,7,5247,2902,2345,5499025
3125,"['doctor', 'sacculate', 'body', 'nitrogen', 'protect', 'cell', 'damage', 'improve', 'blood', 'flow']","['belief', 'base', 'speculation', 'nitrogen', 'prevent', 'cell', 'damage', 'improve', 'blood', 'flow']",4.199999809265137,6,5180,4874,306,93636
3126,"['find', 'shortness', 'associate', 'family', 'history', 'hear', 'loss']","['shortness', 'find', 'twice', 'hearing', 'loss']",3.400000095367432,3,3747,3656,91,8281
3127,"['disco', 'executive', 'say', 'encourage', 'billion', 'cash', 'flow', 'increase', 'net', 'income', 'hope', 'rebound']","['disco', 'executive', 'encourage', 'billion', 'cash', 'flow', 'increase', 'net', 'income', 'say', 'remain', 'cautiously', 'optimistic', 'rebound']",4.599999904632568,11,5658,5274,384,147456
3128,"['e', 'mail', 'statement', 'knoxville', 'news', 'sentinel', 'shumaker', 'say', 'give', 'consideration', 'resignation']","['give', 'consideration', 'resignation', 'shumaker', 'say', 'statement']",4.0,6,5181,4615,566,320356
3129,"['poll', 'show', 'fbi', 'begging', 'mayor', 'give', 'boost', 'reelection', 'effort', 'gop', 'opponent']","['poll', 'release', 'week', 'show', 'fbi', 'begging', 'mayor', 'give', 'boost', 'election', 'effort']",4.0,8,5434,4616,818,669124
3130,"['injured', 'passenger', 'john', 'peter', 'smith', 'hospital', 'die', 'later', 'friday', 'morning', 'bones', 'say']","['injured', 'passenger', 'john', 'peter', 'smith', 'die', 'later', 'morning', 'release', 'bone', 'say']",3.642999887466431,9,5506,3978,1528,2334784
3131,"['doctor', 'plan', 'deliver', 'week', 'early', 'november']","['caesarean', 'originally', 'plan', 'november', 'week', 'early']",3.5999999046325684,4,4298,3941,357,127449
3132,"['big', 'f', 'spread', 'suspect', 'computer', 'user', 'open', 'file', 'attachment', 'email', 'contain', 'familiar', 'heading', 'thank', 'detail', 'movie']","['virus', 'spread', 'suspect', 'computer', 'user', 'open', 'file', 'attachment', 'email', 'contain', 'familiar', 'heading', 'like', 'thank', 'detail']",4.0,13,5719,4618,1101,1212201
3133,"['technology', 'lace', 'nasdaq', 'composite', 'index', 'rise', 'point', 'percent', 'base', 'late', 'datum']","['broad', 'standard', 'door', 'index', 'gain', 'point', 'percent']",1.0,3,3804,948,2856,8156736
3134,"['founder', 'group', 'matsushita', 'electric', 'bony', 'hitachi', 'nec', 'royal', 'philip', 'electronics', 'samsung', 'sharp', 'toshiba']","['celf', 'found', 'member', 'hitachi', 'matsushita', 'nec', 'philip', 'samsung', 'sharp', 'bony', 'toshiba']",3.400000095367432,8,5425,3645,1780,3168400
3135,"['food', 'supply', 'say', 'david', 'ropeik', 'director', 'risk', 'communication', 'harvard', 'enter', 'risk', 'analysis']","['zero', 'say', 'david', 'ropeik', 'director', 'risk', 'communication', 'harvard', 'enter', 'risk', 'analysis']",1.75,9,5501,1611,3890,15132100
3136,"['scream', 'match', 'carolyn', 'tell', 'john', 'sleep', 'begin']","['turn', 'occasionally', 'tell', 'john', 'sleep', 'ex', 'boyfriend', 'baywatch', 'hang', 'michael', 'begin']",3.0,4,4296,2840,1456,2119936
3137,"['hand', 'help', 'establish', 'steve', 'innocence', 'welcome']","['drain', 'pond', 'maryland', 'help', 'establish', 'steve', 'innocence', 'welcome']",3.25,5,4631,3378,1253,1570009
3138,"['fletcher', 'say', 'expect', 'support', 'lawmaker', 'agricultural', 'state', 'committee']","['say', 'expect', 'support', 'lawmaker', 'agricultural', 'state']",3.400000095367432,6,5199,3468,1731,2996361
3139,"['year', 'old', 'cadet', 'thicken', 'police', 'drink', 'alcohol', 'camp', 'hotel', 'room', 'early', 'saturday', 'young', 'woman', 'age']","['year', 'old', 'male', 'cadet', 'catch', 'camp', 'hotel', 'room', 'early', 'saturday', 'female', 'ten', 'year']",3.200000047683716,8,5444,3272,2172,4717584
3140,"['step', 'issue', 'security', 'council']","['matter', 'send', 'security', 'council']",2.799999952316284,2,1905,2605,-700,490000
3141,"['plan', 'stay', 'day', 'river', 'create', 'forecast', 'late', 'night']","['lawyer', 'plan', 'stay', 'river', 'starts', 'recede']",2.400000095367432,3,3793,2209,1584,2509056
3142,"['camp', 'host', 'summer', 'religious', 'retreat', 'child', 'event', 'year', 'round', 'accord', 'web', 'site']","['faint', 'sophia', 'camp', 'host', 'religious', 'retreat', 'child', 'summer', 'month', 'event', 'year', 'round', 'accord', 'web', 'site']",3.400000095367432,12,5698,3447,2251,5067001
3143,"['dealer', 'say', 'single', 'currency', 'downward', 'momentum', 'dollar', 'pick', 'speed', 'break']","['dealer', 'say', 'neuro', 'downward', 'momentum', 'pick', 'speed', 'break']",3.5999999046325684,7,5257,3949,1308,1710864
3144,"['gemstar', 'share', 'gather', 'percent', 'add', 'cent', 'close']","['gemstar', 'share', 'move', 'higher', 'news', 'close', 'percent', 'nasdaq']",3.799999952316284,4,4295,4103,192,36864
3145,"['long', 'chipmaker', 'company', 'include', 'bony', 'microsoft', 'hewlett', 'backward', 'ibm', 'gateway', 'foka']","['long', 'chip', 'maker', 'company', 'include', 'bony', 'microsoft', 'hewlett', 'backward', 'international', 'business', 'machines', 'gateway', 'foka']",4.800000190734863,9,5486,5403,83,6889
3146,"['roger', 'own', 'alpha', 'albertsons', 'bargain', 'jointly', 'gateway', 'lock', 'union', 'worker', 'day']","['corporate', 'solidarity', 'roger', 'own', 'alpha', 'robertson', 'lock', 'worker', 'morning']",3.799999952316284,5,4628,4069,559,312481
3147,"['accord', 'census', 'bureau', 'hispanic', 'population', 'increase', 'percent', 'april', 'census', 'figure']","['hispanic', 'population', 'increase', 'cent', 'april', 'census', 'figure', 'despite', 'favourable', 'social', 'economic', 'condition']",3.3329999446868896,6,5190,3410,1780,3168400
3148,"['share', 'jump', 'pre', 'open', 'trading', 'wednesday', 'close']","['share', 'jump', 'percent', 'pre', 'open', 'trading', 'rise', 'tuesday', 'close']",2.5,6,5191,2328,2863,8196769
3149,"['bones', 'industrial', 'average', 'point', 'percent']","['bones', 'industrial', 'average', 'fall', 'point', 'percent', 'friday']",2.400000095367432,5,4627,2175,2452,6012304
3150,"['lawyer', 'lackey', 'say', 'bryant', 'expect', 'completely', 'exonerate']","['bryant', 'innocent', 'expect', 'completely', 'exonerate', 'lackey', 'say', 'statement']",3.799999952316284,6,5194,4073,1121,1256641
3151,"['good', 'advance', 'act', 'index', 'gain']","['standard', 'door', 'index', 'rise', 'good', 'advance', 'act', 'gain']",3.0,5,4620,2833,1787,3193369
3152,"['ask', 'say', 'sullen', 'take', 'somerset', 'county', 'nail', 'thursday', 'move', 'inn', 'vein', 'forensic', 'hospital', 'outside', 'trenton', 'psychiatric', 'care']","['charles', 'sullen', 'transfer', 'somerset', 'county', 'nail', 'somerville', 'anne', 'vein', 'forensic', 'enter', 'bed', 'psychiatric', 'treatment', 'facility', 'trenton']",3.691999912261963,8,5448,3987,1461,2134521
3153,"['scientist', 'believe', 'stardust', 'wrap', 'thousand', 'particle', 'dust']","['stardust', 'design', 'gather', 'thousand', 'dust', 'particle', 'stream', 'mild']",3.0,4,4294,2831,1463,2140369
3154,"['report', 'independent', 'expert', 'committee', 'aim', 'dissipate', 'suspicion', 'long', 'long', 'government', 'handling', 'sars', 'crisis']","['long', 'await', 'report', 'long', 'long', 'government', 'handling', 'sars', 'outbreak', 'release']",2.75,5,4629,2540,2089,4363921
3155,"['device', 'implement', 'standard', 'esco', 'facility', 'provide', 'basis', 'new', 'careless', 'telephone', 'application']","['implement', 'esco', 'facility', 'provide', 'basis', 'advanced', 'careless', 'telephone', 'application', 'bluetooth', 'transmission']",3.25,8,5443,3389,2054,4218916
3156,"['drop', 'core', 'wholesale', 'price', 'april', 'reflect', 'fall', 'price', 'car', 'trunk', 'man', 'boy', 'clothe', 'cigarette']","['big', 'drop', 'august', 'stem', 'fall', 'price', 'car', 'trunk', 'man', 'boy', 'clothe', 'cigarette']",3.5,9,5548,3741,1807,3265249
3157,"['international', 'rescue', 'worker', 'scout', 'flatten', 'debris', 'survivor', 'ran', 'shattered', 'ancient', 'silk', 'road', 'city', 'violent', 'earthquake', 'kill', 'people']","['international', 'rescue', 'worker', 'hack', 'desperately', 'flatten', 'debris', 'survivor', 'cemetery', 'overflow', 'ran', 'ancient', 'silk', 'road', 'city', 'yesterday']",3.0,11,5656,2829,2827,7991929
3158,"['griffith', 'count', 'airy', 'native', 'live', 'north', 'carolina', 'coast', 'wanted']","['griffiths', 'grow', 'count', 'airy', 'live', 'wanted']",4.0,4,4319,4602,-283,80089
3159,"['conference', 'board', 'report', 'consumer', 'confidence', 'index', 'slip', 'june']","['consumer', 'confidence', 'index', 'come', 'june', 'slightly', 'revise', 'conference', 'board', 'say']",4.666999816894531,6,5152,5316,-164,26896
3160,"['notice', 'mood', 'change', 'priority', 'politician', 'say']","['notice', 'mood', 'change', 'priority', 'say', 'iraqi', 'politician', 'meet', 'prefer']",3.3329999446868896,6,5139,3411,1728,2985984
3161,"['weather', 'lose', 'leg', 'road', 'accident', 'think', 'steel', 'plate', 'fit', 'hip', 'natural', 'childbirth', 'impossible']","['model', 'lady', 'mccartney', 'lose', 'leg', 'road', 'accident', 'understand', 'steel', 'plate', 'fit', 'hip', 'natural', 'childbirth', 'difficult']",2.400000095367432,10,5600,2181,3419,11689561
3162,"['network', 'drop', 'friday', 'night', 'vaseline', 'edition']","['network', 'drop', 'edition', 'vaseline', 'newsmagazine', 'franchise']",3.857000112533569,4,4320,4334,-14,196
3163,"['vice', 'president', 'sick', 'henry', 'mississippi', 'republican', 'gubernatorial', 'candidate', 'pale', 'harbour', 'acknowledge', 'cheering', 'crowd']","['vice', 'president', 'sick', 'henry', 'say', 'mississippi', 'republican', 'pale', 'harbour', 'good', 'governor', 'government', 'business', 'navvy']",2.400000095367432,8,5436,2185,3251,10569001
3164,"['year', 'old', 'nurse', 'work', 'north', 'work', 'general', 'hospital', 'epicentre', 'late', 'outbreak']","['smile', 'aroma', 'contract', 'sars', 'work', 'nurse', 'north', 'work', 'general', 'hospital', 'epicentre', 'second', 'sars', 'outbreak']",3.0,7,5294,2825,2469,6095961
3165,"['allow', 'earn', 'run', 'start']","['german', 'allow', 'earn', 'run', 'start']",2.0,4,4346,1785,2561,6558721
3166,"['turner', 'transfer', 'million', 'share', 'charitable', 'trust', 'sell']","['sale', 'leave', 'turner', 'million', 'share', 'aol']",1.600000023841858,3,3784,1565,2219,4923961
3167,"['recruit', 'participate', 'scheme', 'convince', 'receive', 'fraudulent', 'obtain', 'merchandise', 'order']","['recruit', 'people', 'delivery', 'fraudulent', 'obtain', 'merchandise', 'order']",4.0,5,4663,4600,63,3969
3168,"['new', 'work', 'get', 'select', 'outfielder', 'hastings', 'milledge', 'lakewood', 'ranch', 'high', 'school', 'florida']","['gets', 'take', 'hastings', 'milledge', 'outfielder', 'florida', 'pick']",3.799999952316284,4,4344,4105,239,57121
3169,"['florida', 'men', 'mob', 'graham', 'identifiable', 'percent', 'poll']","['merry', 'view', 'favorably', 'percent', 'poll', 'mean', 'percent']",1.2730000019073486,2,1903,1259,644,414736
3170,"['broad', 'standard', 'door', 'index', 'rise', 'point', 'percent']","['teach', 'laden', 'nasdaq', 'composite', 'index', 'shed', 'point', 'percent']",1.0,3,3746,949,2797,7823209
3171,"['result', 'player', 'break', 'par', 'round']","['player', 'break', 'par', 'round', 'high', 'figure', 'open', 'history']",3.0,4,4343,2820,1523,2319529
3172,"['albertson', 'roger', 'alpha', 'chain', 'lock', 'worker', 'response']","['roger', 'alpha', 'chain', 'albertsons', 'immediately', 'lock', 'grocer', 'worker', 'solidarity']",4.0,5,4648,4577,71,5041
3173,"['technology', 'pack', 'nasdaq', 'composite', 'index', 'drop', 'point', 'percent']","['nasdaq', 'composite', 'index', 'fall', 'percent', 'week', 'stumble', 'yesterday']",2.0,4,4342,1953,2389,5707321
3174,"['share', 'sco', 'close', 'cent', 'monday', 'trading', 'nasdaq', 'stock', 'market']","['ibm', 'share', 'close', 'percent', 'new', 'work', 'stock', 'exchange']",1.0,3,3737,951,2786,7761796
3175,"['house', 'vote', 'clear', 'bill', 'congress', 'pass', 'year', 'fund', 'federal', 'government']","['bill', 'congress', 'pass', 'year', 'fund', 'federal', 'government']",3.0,7,5301,2845,2456,6031936
3176,"['night', 'agree', 'year', 'million', 'contract', 'include', 'signing', 'bonus']","['espn', 'report', 'night', 'year', 'deal', 'worth', 'million', 'include', 'signing', 'bonus']",4.75,6,5146,5325,-179,32041
3177,"['japanese', 'currency', 'neuro', 'man', 'late', 'new', 'work', 'level']","['dollar', 'man', 'japanese', 'currency', 'percent']",2.75,3,3753,2543,1210,1464100
3178,"['procedure', 'generally', 'perform', 'second', 'trimester']","['technique', 'second', 'occasionally', 'trimester', 'pregnancy']",4.5,2,1922,5126,-3204,10265616
3179,"['hampton', 'newport', 'news', 'grant', 'fund', 'water', 'testing', 'yorktown', 'king', 'george', 'county', 'norfolk', 'virginia']","['grant', 'fund', 'beach', 'testing', 'king', 'george', 'county', 'norfolk', 'virginia']",3.0,8,5461,2870,2591,6713281
3180,"['say', 'attacker', 'leave', 'leaflet', 'urge', 'staff', 'star', 'sheraton', 'stop', 'work', 'hotel', 'demand', 'force', 'leave', 'ran']","['say', 'attacker', 'leave', 'leaflet', 'urge', 'worker', 'star', 'sheraton', 'stop', 'work', 'hotel']",3.0,10,5599,2869,2730,7452900
3181,"['diplomacy', 'heating', 'nearly', 'month', 'old', 'nuclear', 'crisis', 'chinese', 'foreign', 'minister', 'zhaoxing', 'seat', 'visit', 'south', 'august']","['diplomacy', 'heating', 'nearly', 'month', 'old', 'crisis', 'chinese', 'foreign', 'minister', 'zhaoxing', 'fly', 'japan', 'sunday', 'en', 'route', 'south', 'august']",3.0,12,5713,2868,2845,8094025
3182,"['fond', 'ball', 'like', 'red', 'recognize', 'risk', 'base', 'economic', 'weakness']","['red', 'say', 'risk', 'economy', 'base', 'weakness']",2.588000059127808,4,4341,2368,1973,3892729
3183,"['real', 'potential', 'secondary', 'collapse', 'sov', 'james', 'mcgreevey', 'say']","['damage', 'area', 'garage', 'stable', 'real', 'potential', 'secondary', 'collapse', 'mcgreevey', 'say']",3.5999999046325684,6,5149,3947,1202,1444804
3184,"['see', 'server', 'sale', 'drop', 'percent', 'billion']","['fall', 'second', 'place', 'server', 'sale', 'grow', 'percent', 'billion']",2.3329999446868896,4,4340,2171,2169,4704561
3185,"['people', 'obviously', 'inconvenience', 'say', 'young', 'ontario', 'commissioner', 'public', 'safety']","['hyper', 'vigilant', 'say', 'james', 'young', 'ontario', 'commissioner', 'public', 'safety']",2.25,6,5153,2158,2995,8970025
3186,"['give', 'copy', 'stains', 'new', 'diet', 'revolution', 'tell', 'follow']","['research', 'give', 'copy', 'stains', 'new', 'diet', 'revolution', 'care', 'cutter']",2.5,6,5167,2350,2817,7935489
3187,"['rapier', 'lawyer', 'dark', 'kann', 'return', 'call', 'comment']","['year', 'old', 'rapier', 'attorney', 'civil', 'matter', 'dark', 'kann', 'return', 'call', 'comment']",4.5,6,5155,5122,33,1089
3188,"['weigh', 'market', 'news', 'general', 'doors', 'n', 'plan', 'issue', 'billion', 'debt', 'plug', 'hole', 'pension', 'plan']","['hurt', 'news', 'general', 'doors', 'n', 'issue', 'billion', 'debt', 'plug', 'hole', 'pension', 'plan']",4.75,11,5659,5324,335,112225
3189,"['russian', 'comment', 'lawyer', 'attend', 'hearing', 'return', 'phone', 'message']","['lawyer', 'cousin', 'basil', 'russian', 'attend', 'hearing', 'return', 'phone', 'message']",3.400000095367432,7,5299,3470,1829,3345241
3190,"['licensing', 'revenue', 'slide', 'percent', 'million']","['license', 'sale', 'key', 'measure', 'demand', 'fall', 'percent', 'million']",4.0,2,1923,4582,-2659,7070281
3191,"['hispanics', 'fat', 'grow', 'ethnic', 'group', 'overtake', 'black', 'large', 'minority', 'accord', 'newly', 'release', 'government', 'figure']","['hispanic', 'officially', 'overtake', 'african', 'americans', 'large', 'minority', 'group', 'accord', 'report', 'release', 'census', 'bureau']",3.5,6,5157,3692,1465,2146225
3192,"['bishop', 'armidale', 'peter', 'brain', 'fortnight']","['get', 'choice', 'say', 'bishop', 'armidale', 'peter', 'brain']",2.0,4,4339,1797,2542,6461764
3193,"['fully', 'operational', 'facility', 'expect', 'employ', 'people']","['plant', 'employ', 'people', 'fully', 'build', 'company', 'say']",4.0,3,3767,4583,-816,665856
3194,"['american', 'stock', 'exchange', 'bitch', 'index', 'urge', 'percent']","['philadelphia', 'stock', 'exchange', 'semiconductor', 'index', 'jump', 'percent']",1.399999976158142,4,4338,1362,2976,8856576
3195,"['like', 'tell', 'herald', 'yesterday']",['like'],3.200000047683716,1,928,3283,-2355,5546025
3196,"['month', 'period', 'end', 'june', 'advanced', 'service', 'line', 'adsl', 'increase', 'percent', 'cable', 'mode', 'connection', 'increase', 'percent']","['month', 'period', 'end', 'june', 'high', 'speed', 'line', 'instal', 'home', 'business', 'increase', 'percent']",1.7999999523162842,7,5274,1765,3509,12313081
3197,"['state', 'education', 'commissioner', 'go', 'king', 'say', 'wednesday', 'score', 'missouri', 'assessment', 'program', 'test', 'disappoint']","['missouri', 'education', 'commissioner', 'go', 'king', 'say', 'disappoint', 'score']",3.200000047683716,8,5374,3285,2089,4363921
3198,"['agent', 'find', 'credit', 'card', 'credit', 'card', 'implicate', 'machine', 'search', 'address']","['address', 'raid', 'authority', 'find', 'credit', 'card', 'implicate', 'machine']",4.800000190734863,6,5161,5402,-241,58081
3199,"['owe', 'half', 'store', 'report', 'percent', 'increase', 'quarter', 'profit', 'percent', 'jump', 'store', 'sale']","['depot', 'report', 'percent', 'jump', 'quarter', 'profit', 'nearly', 'percent', 'rise', 'store', 'sale']",1.399999976158142,7,5286,1366,3920,15366400
3200,"['calder', 'acquire', 'server', 'software', 'original', 'sco', 'change', 'sco', 'group']","['sco', 'change', 'tarantella', 'calder', 'later', 'change', 'sco', 'group']",2.5999999046325684,4,4336,2393,1943,3775249
3201,"['officer', 'throw', 'ground', 'handcuff', 'jena', 'drop', 'knee', 'accord', 'testimony']","['officer', 'throw', 'ground', 'handcuff', 'accord', 'testimony']",3.25,6,5163,3395,1768,3125824
3202,"['well', 'perform', 'stock', 'ultra', 'group', 'rise', 'percent', 'close', 'share']","['ultra', 'group', 'n', 'fall', 'cent', 'percent']",1.75,3,3758,1615,2143,4592449
3203,"['official', 'try', 'retrieve', 'body', 'water', 'police', 'officer', 'tell', 'letters', 'add', 'dead', 'woman']","['official', 'try', 'retrieve', 'body', 'water', 'police', 'official', 'tell', 'letters']",3.0,8,5362,2853,2509,6295081
3204,"['accord', 'market', 'research', 'npd', 'group', 'number', 'people', 'download', 'music', 'drop', 'million', 'april', 'million', 'june']","['number', 'household', 'acquire', 'music', 'fall', 'high', 'million', 'april', 'million', 'million', 'june', 'accord', 'npd']",3.5,7,5279,3687,1592,2534464
3205,"['easy', 'case', 'view', 'wholly', 'merit', 'actually', 'legally']","['case', 'wholly', 'merit', 'actually', 'legally', 'judge', 'penny', 'thin', 'coffee']",3.25,5,4640,3379,1261,1590121
3206,"['weather', 'service', 'report', 'maximum', 'sustained', 'wind', 'nearly', 'mile', 'hour', 'strong', 'guest']","['maximum', 'sustained', 'wind', 'strong', 'guest']",2.25,5,4639,2148,2491,6205081
3207,"['iii', 'patty', 'veil', 'summer', 'music', 'festival', 'britain']","['world', 'portal', 'petty', 'soon', 'roll', 'summer', 'festival', 'great', 'britain']",4.0,3,3084,4584,-1500,2250000
3208,"['men', 'drink', 'tea', 'particularly', 'green', 'tea', 'greatly', 'reduce', 'risk', 'prostate', 'cancer', 'landmark', 'study', 'find']","['drinking', 'green', 'tea', 'dramatically', 'reduce', 'risk', 'man', 'contract', 'prostate', 'cancer', 'study', 'australian', 'research', 'discover']",4.25,7,5283,4918,365,133225
3209,"['forecaster', 'say', 'warning', 'cuba', 'later', 'thursday']","['patch', 'warning', 'issue', 'eastern', 'cuba', 'later', 'thursday']",4.0,4,4335,4586,-251,63001
3210,"['white', 'percent', 'country', 'population']","['tennis', 'percent', 'pakistan', 'population', 'white', 'percent']",3.0,3,2680,2848,-168,28224
3211,"['cwa', 'represent', 'comcast', 'employee', 'call', 'excessive', 'typical', 'union', 'employee', 'make', 'year']","['communications', 'workers', 'union', 'represent', 'comcast', 'employee', 'call', 'executive', 'pay', 'package', 'excessive', 'typical', 'union', 'employee', 'make', 'annually']",3.400000095367432,8,5371,3584,1787,3193369
3212,"['consumer', 'group', 'generate', 'billion', 'profit', 'billion', 'revenue', 'january', 'june', 'citigroup', 'profit', 'revenue']","['generate', 'billion', 'profit', 'billion', 'revenue', 'year', 'half', 'percent', 'citigroup', 'total']",3.799999952316284,5,4679,4087,592,350464
3213,"['galloway', 'township', 'annika', 'sorenstam', 'draw', 'crowd', 'michelle', 'lie', 'get', 'publicity', 'angela', 'stanford', 'take', 'lpga', 'victory']","['galloway', 'township', 'annika', 'sorenstam', 'michelle', 'lie', 'draw', 'crowd', 'angela', 'stanford', 'take', 'lpga', 'victory']",4.0,13,5728,4588,1140,1299600
3214,"['british', 'airways', 'new', 'work', 'london', 'run', 'end', 'october']","['british', 'airways', 'plan', 'retire', 'seven', 'concordes', 'end', 'october']",2.5,4,4334,2335,1999,3996001
3215,"['new', 'policy', 'give', 'great', 'weight', 'grade', 'test', 'score', 'student', 'high', 'school', 'curriculum']","['academic', 'achievement', 'include', 'grade', 'test', 'score', 'high', 'school', 'curriculum', 'give', 'high', 'priority']",4.5,7,5293,5127,166,27556
3216,"['new', 'version', 'big', 'c', 'mm', 'reach', 'high', 'level', 'outbreak', 'status', 'monday', 'accord', 'security', 'analysis']","['security', 'analysis', 'say', 'new', 'version', 'big', 'c', 'mm', 'reach', 'high', 'level', 'outbreak', 'status', 'mid', 'afternoon', 'monday']",4.5,13,5730,5125,605,366025
3217,"['person', 'account', 'sunday', 'man', 'sort', 'north', 'texas']","['person', 'man', 'sort', 'north', 'texas', 'miss']",3.5999999046325684,5,4662,3935,727,528529
3218,"['broad', 'standard', 'door', 'index', 'give', 'point', 'percent']","['technology', 'lace', 'nasdaq', 'composite', 'index', 'decline', 'point', 'percent']",0.800000011920929,3,2677,759,1918,3678724
3219,"['aftra', 'member', 'approve', 'merger', 'vote']","['aftra', 'hand', 'approve', 'merger', 'shop', 'percent']",4.091000080108643,3,2694,4700,-2006,4024036
3220,"['currency', 'briefly', 'weaken', 'slightly', 'monday', 'trade', 'far', 'record', 'low']","['currency', 'briefly', 'weaken', 'monday', 'morning', 'resound', 'trade', 'little', 'change', 'friday']",2.25,5,4653,2159,2494,6220036
3221,"['part', 'africa', 'staying', 'ground', 'terror', 'group', 'kalaw', 'previously', 'major', 'focus', 'investigation', 'al', 'said']","['part', 'africa', 'll', 'qaeda', 'staying', 'ground', 'kalaw', 'previously', 'major', 'focus', 'investigation', 'group']",5.0,10,5627,5675,-48,2304
3222,"['sunday', 'soldier', 'kill', 'injure', 'southern', 'ran', 'munition', 'dump', 'explode']","['sunday', 'soldier', 'kill', 'injure', 'munition', 'dump', 'guard', 'exploded', 'southern', 'ran']",3.75,8,5405,4008,1397,1951609
3223,"['real', 'excited', 'cleveland', 'cavalier', 'james', 'say']","['excited', 'go', 'cleveland', 'james', 'tell']",3.6670000553131104,3,2674,3985,-1311,1718721
3224,"['accord', 'law', 'enforcement', 'official', 'person', 'arrest', 'know', 'sophisticated', 'packer']","['accord', 'law', 'enforcement', 'official', 'individual', 'decrypt', 'password', 'server']",2.6670000553131104,4,4331,2530,1801,3243601
3225,"['exclude', 'litigation', 'charge', 'rim', 'loss', 'narrow', 'cent', 'share']","['exclude', 'patent', 'litigation', 'rim', 'loss', 'quarter', 'cent', 'share']",3.3329999446868896,6,5211,3415,1796,3225616
3226,"['broad', 'standard', 'door', 'index', 'gain', 'point', 'percent']","['bones', 'industrial', 'average', 'jump', 'percent', 'standard', 'door', 'index', 'leapt', 'percent']",3.0,4,4329,2851,1478,2184484
3227,"['help', 'reform', 'royal', 'solomon', 'islands', 'police', 'strengthen', 'court', 'prison', 'system', 'protect', 'key', 'institution', 'finance', 'ministry', 'intimidation']","['intervention', 'force', 'confiscate', 'weapon', 'reform', 'police', 'strengthen', 'court', 'prison', 'system', 'protect', 'key', 'institution', 'finance', 'ministry']",3.444000005722046,11,5692,3684,2008,4032064
3228,"['alibek', 'say', 'outcome', 'encouraging']","['outcome', 'encouraging', 'george', 'mason', 'researcher', 'men', 'alibek', 'say']",3.799999952316284,4,4328,4084,244,59536
3229,"['jury', 'convict', 'rapier', 'c', 'murder', 'know', 'miller', 'second', 'degree', 'murder', 'tuesday', 'night', 'shooting', 'death', 'year', 'old', 'jefferson', 'parish', 'nightclub']","['paper', 'c', 'murder', 'convict', 'second', 'degree', 'murder', 'crime', 'carry', 'automatic', 'life', 'sentence', 'shooting', 'death', 'year', 'old', 'inside', 'jefferson', 'parish', 'nightclub']",3.5999999046325684,12,5707,3970,1737,3017169
3230,"['cell', 'series', 'include', 'nbc', 'watch']","['cell', 'series', 'include', 'nbc', 'watch']",5.0,5,4641,5676,-1035,1071225
3231,"['thirty', 'man', 'arrest', 'wednesday', 'evening', 'say', 'daniel', 'ogden', 'attorney', 'nevada']","['thirty', 'man', 'arrest', 'seek', 'attorney', 'daniel', 'ogden', 'say', 'yesterday']",3.0,7,5307,2852,2455,6027025
3232,"['time', 'de', 'france', 'winner', 'cancer', 'survivor', 'dance', 'armstrong', 'word', 'advice', 'cancer', 'survivor', 'denver', 'friday']","['time', 'de', 'france', 'winner', 'dance', 'armstrong', 'denver', 'today', 'meeting', 'survive', 'cancer']",3.400000095367432,8,5408,3665,1743,3038049
3233,"['survive', 'child', 'son', 'anthony', 'belly', 'daughter', 'mind', 'hope', 'dora', 'powers', 'grandchild']","['hope', 'survive', 'wife', 'son', 'anthony', 'belly', 'daughter', 'mind', 'dora', 'powers', 'grandchild']",3.799999952316284,10,5635,4065,1570,2464900
3234,"['police', 'pepper', 'spray', 'arrest', 'people', 'monday', 'night', 'march', 'rally', 'activist', 'protest', 'annual', 'training', 'seminar', 'saw', 'enforcement', 'intelligence', 'knit']","['police', 'pepper', 'spray', 'rubber', 'bullet', 'disperse', 'downtown', 'march', 'rally', 'night', 'activist', 'protest', 'annual', 'police', 'intelligence', 'training', 'seminar']",3.5999999046325684,12,5709,3964,1745,3045025
3235,"['department', 'order', 'percent', 'reduction', 'allstate', 'texas', 'clouds', 'percent', 'reduction', 'state', 'arm', 'clouds']","['department', 'order', 'percent', 'reduction', 'state', 'arm', 'clouds', 'state', 'large', 'insure', 'percent', 'reduction', 'allstate', 'texas', 'clouds', 'large']",3.5999999046325684,9,5514,3963,1551,2405601
3236,"['oleate', 'share', 'close', 'monday', 'new', 'work', 'stock', 'exchange']","['oleate', 'share', 'cent', 'morning', 'trade', 'new', 'work', 'stock', 'exchange']",2.400000095367432,6,5204,2313,2891,8357881
3237,"['shot', 'ring', 'darkness', 'later', 'kill']","['shot', 'ring', 'wednesday', 'night', 'gate', 'kill']",2.400000095367432,3,2661,2308,353,124609
3238,"['broad', 'standard', 'door', 'index', 'point', 'low', 'percent']","['technology', 'lace', 'nasdaq', 'composite', 'index', 'point', 'percent']",0.8889999985694885,3,2659,888,1771,3136441
3239,"['republicans', 'pledge', 'complete', 'dedicate', 'drug', 'package', 'august', 'extend', 'deadline', 'act', 'work']","['republicans', 'pledge', 'complete', 'dedicate', 'drug', 'package', 'august', 'extend', 'act']",4.75,9,5564,5330,234,54756
3240,"['index', 'measure', 'activity', 'service', 'sector', 'climb', 'month', 'march']","['arizona', 'base', 'ism', 'report', 'monday', 'non', 'manufacturing', 'index', 'rise', 'month', 'march']",3.5,3,2795,3689,-894,799236
3241,"['rush', 'plan', 'meet', 'israel', 'crime', 'minister', 'cried', 'charon', 'new', 'palestinian', 'prime', 'minister', 'mahmoud', 'bias', 'jordanian', 'port', 'aqaba', 'wednesday']","['wednesday', 'week', 'rush', 'meet', 'israel', 'crime', 'minister', 'cried', 'charon', 'new', 'palestinian', 'leader', 'mahmoud', 'bias', 'aqaba', 'jordan']",5.0,13,5722,5562,160,25600
3242,"['unlike', 'early', 'stage', 'internet', 'firm', 'google', 'believe', 'profitable']","['privately', 'hold', 'google', 'believe', 'profitable']",3.5999999046325684,3,2787,3975,-1188,1411344
3243,"['safe', 'assume', 'senate', 'prepared', 'pass', 'form', 'cap', 'king', 'say']","['safe', 'assume', 'senate', 'prepared', 'pass', 'form', 'cap', 'level', 'debate']",3.0,7,5291,2862,2429,5900041
3244,"['ask', 'feel', 'regret', 'guilt', 'attack', 'answer', 'adamant']","['ask', 'feel', 'regret', 'theoctober', 'attack', 'answer', 'adamant']",3.799999952316284,6,5223,4078,1145,1311025
3245,"['big', 'gainer', 'famous', 'nasal', 'rmbs', 'news', 'people', 'shoot', 'percent', 'high']","['famous', 'nasal', 'rmbs', 'news', 'people', 'shoot', 'percent', 'make', 'big', 'percentage', 'gainer', 'nasdaq']",3.0,9,5475,2863,2612,6822544
3246,"['fuss', 'write', 'os', 'angeles', 'bureau', 'chief']","['emily', 'church', 'london', 'bureau', 'chief']",1.7999999523162842,2,1945,1738,207,42849
3247,"['pass', 'bill', 'fig', 'brother', 'watch', 'say', 'john', 'mary', 'd', 'face']","['pass', 'bill', 'john', 'mary', 'd', 'face', 'tell', 'colleague', 'fig', 'brother', 'watch']",4.800000190734863,9,5474,5399,75,5625
3248,"['douglas', 'robinson', 'senior', 'vice', 'president', 'finance', 'chief', 'financial', 'officer', 'interim', 'basis']","['douglas', 'robinson', 'senior', 'vice', 'president', 'finance', 'fill', 'position', 'interim']",3.799999952316284,7,5237,4178,1059,1121481
3249,"['state', 'federal', 'government', 'later', 'pass', 'similar', 'strict', 'bank']","['follow', 'california', 'lead', 'state', 'federal', 'government', 'pass', 'similar', 'rougher', 'bank']",4.0,6,5207,4598,609,370881
3250,"['note', 'diam', 'decide', 'seek', 'acc', 'membership', 'school', 'year', 'june', 'adhere', 'fig', 'guideline']","['note', 'diam', 'decide', 'seek', 'membership', 'june', 'adhere', 'fig', 'guideline']",4.599999904632568,9,5490,5272,218,47524
3251,"['revenue', 'bulk', 'come', 'month', 'marvel', 'topics', 'adaptation', 'x', 'men', 'united', 'cross', 'million', 'opening', 'weekend']","['bulk', 'trail', 'month', 'marvel', 'topics', 'adaptation', 'x', 'men', 'united', 'cross', 'million', 'opening', 'weekend']",4.800000190734863,12,5711,5397,314,98596
3252,"['share', 'littleton', 'colorado', 'base', 'echostar', 'rise', 'percent']","['monday', 'echostar', 'dish', 'news', 'chart', 'profile', 'share', 'shrink', 'percent']",2.0,3,2819,1782,1037,1075369
3253,"['valid', 'signature', 'register', 'california', 'voter', 'collect', 'turn', 'county', 'election', 'official', 'kept']","['force', 'recall', 'election', 'davis', 'valid', 'signature', 'register', 'california', 'voter', 'turn', 'election', 'official']",3.200000047683716,8,5391,3122,2269,5148361
3254,"['benchmark', 'year', 'note', 'lose', 'price', 'take', 'yield', 'percent', 'percent', 'late', 'monday']","['curve', 'benchmark', 'year', 'note', 'shed', 'price', 'take', 'yield', 'percent', 'percent']",2.200000047683716,7,5256,2055,3201,10246401
3255,"['mdc', 'call', 'strike', 'force', 'mugabe', 'resign', 'negotiate', 'settlement', 'zimbabwe', 'crisis']","['mdc', 'call', 'week', 'long', 'protest', 'urge', 'mugabe', 'resign', 'negotiate', 'settlement', 'crisis', 'grip', 'country']",4.0,7,5253,4596,657,431649
3256,"['revenue', 'rise', 'percent', 'billion', 'billion']","['clean', 'virginia', 'base', 'company', 'say', 'newspaper', 'revenue', 'increase', 'percent', 'billion']",1.2000000476837158,3,2806,1113,1693,2866249
3257,"['january', 'notebook', 'represent', 'percent', 'sale', 'volume']","['compare', 'january', 'captor', 'represent', 'percent', 'sale', 'volume', 'npd', 'say']",4.0,5,4667,4593,74,5476
3258,"['argentina', 'guillermo', 'boris', 'netherlander', 'martin', 'verkerk', 'half']","['seminal', 'guillermo', 'boris', 'argentina', 'martin', 'verkerk', 'netherlands', 'compelling']",3.0,5,4664,2867,1797,3229209
3259,"['tell', 'crowd', 'cemetery', 'thousand', 'headstone', 'mark', 'grave', 'entire', 'family']","['lowell', 'tell', 'crowd', 'cemetery', 'thousand', 'headstone', 'mark', 'grave', 'entire', 'family']",2.799999952316284,9,5493,2616,2877,8277129
3260,"['single', 'condition', 'book', 'publish', 'death']","['insist', 'publish', 'death']",4.400000095367432,2,1944,4959,-3015,9090225
3261,"['finding', 'publish', 'november', 'edition', 'journal', 'nature']","['study', 'publish', 'thursday', 'nature', 'british', 'weekly', 'science', 'journal']",2.5999999046325684,3,2728,2449,279,77841
3262,"['median', 'household', 'income', 'decline', 'percent', 'account', 'inflation']","['survey', 'find', 'median', 'household', 'income', 'rise', 'account', 'inflation']",1.399999976158142,5,4613,1325,3288,10810944
3263,"['european', 'leader', 'pledge', 'wednesday', 'work', 'ran', 'develop', 'nuclear', 'weapon', 'present', 'united', 'month', 'bitter', 'alimony', 'ran']","['rush', 'say', 'european', 'union', 'leader', 'annual', 'washington', 'summit', 'agree', 'need', 'ran', 'develop', 'nuclear', 'weapon']",3.200000047683716,6,5219,3095,2124,4511376
3264,"['leave', 'army', 'syria', 'receive', 'religious', 'training']","['move', 'syria', 'undergo', 'religious', 'training', 'traditional', 'islamic', 'belief']",3.0,3,2724,2846,-122,14884
3265,"['meeting', 'schedule', 'end', 'wednesday', 'night', 'attend', 'approve', 'resolution', 'express', 'denomination', 'view', 'issue', 'bind', 'church']","['wednesday', 'attend', 'vote', 'resolution', 'express', 'southern', 'baptist', 'view', 'issue', 'bind', 'individual', 'church']",3.2730000019073486,8,5398,3399,1999,3996001
3266,"['inadequate', 'performance', 'student', 'subgroup', 'rag', 'state', 'deficient', 'federal', 'child', 'left', 'act']","['inadequate', 'performance', 'student', 'subgroup', 'race', 'push', 'state', 'need', 'improvement', 'list', 'federal', 'child', 'left', 'act']",4.0,9,5477,4590,887,786769
3267,"['lead', 'recovery', 'kilogram', 'cancuen', 'altar', 'announce', 'wednesday', 'vanderbilts', 'university', 'nashville', 'national', 'geographic', 'society']","['lead', 'month', 'recovery', 'pound', 'cancun', 'altar', 'vanderbilts', 'university', 'nashville', 'national', 'geographic', 'society', 'announce', 'wednesday']",3.25,11,5653,3383,2270,5152900
3268,"['subtle', 'wipe', 'mean', 'predict', 'americans', 'elect', 'democrat', 'sound', 'uncertain', 'trumpet', 'dangerous', 'time']","['elect', 'president', 'democrat', 'sound', 'uncertain', 'trumpet', 'dangerous', 'time']",3.5,7,5245,3691,1554,2414916
3269,"['report', 'forecast', 'hot', 'spot', 'worldwide', 'year']","['report', 'claim', 'million', 'visitor', 'hot', 'spot', 'year', 'meagre', 'million']",1.75,4,4323,1601,2722,7409284
3270,"['new', 'study', 'conduct', 'europe', 'find', 'medicine', 'work', 'early', 'dispute', 'study', 'sponsor', 'imclone', 'systems', 'say']","['doctor', 'conclude', 'erbitux', 'cancer', 'drug', 'enmesh', 'imclone', 'systems', 'insider', 'trading', 'scandal', 'work', 'early', 'company', 'sponsor', 'study', 'say']",2.700000047683716,7,5244,2535,2709,7338681
3271,"['lawyer', 'donald', 'divine', 'tell', 'telegraph', 'offer', 'tell', 'story', 'exclusively', 'australian']","['divine', 'say', 'offer', 'tell', 'story', 'australian', 'network']",3.75,5,4622,4002,620,384400
3272,"['merry', 'call', 'lawmaker', 'special', 'session', 'address', 'congressional', 'redistributing']","['merry', 'call', 'special', 'legislative', 'session', 'try', 'force', 'redistribute', 'plan']",3.75,4,4204,4006,198,39204
3273,"['airtran', 'official', 'official', 'decline', 'comment', 'yesterday']","['irish', 'work', 'spokesman', 'decline', 'comment', 'deal']",4.0,2,1943,4589,-2646,7001316
3274,"['lawsuit', 'name', 'shell', 'democrat', 'registrar', 'os', 'angeles', 'range', 'diego', 'county']","['lawsuit', 'name', 'secretary', 'state', 'shell', 'democrat', 'registrar', 'voter', 'os', 'angeles', 'range', 'diego', 'county']",4.199999809265137,10,5628,4872,756,571536
3275,"['negotiator', 'say', 'friday', 'good', 'progress', 'late', 'round', 'talk', 'create', 'central', 'american', 'free', 'trade', 'agreement']","['negotiator', 'say', 'friday', 'progress', 'late', 'round', 'free', 'trade', 'negotiation', 'united', 'states', 'central', 'american', 'country', 'week', 'houston']",3.75,10,5574,4011,1563,2442969
3276,"['difficult', 'large', 'indicate', 'loan', 'japan', 'lack', 'expertise', 'say', 'banker']","['difficult', 'large', 'indicate', 'loan', 'japan', 'say', 'banker']",3.799999952316284,7,5243,4323,920,846400
3277,"['case', 'come', 'illinois', 'involve', 'profit', 'company', 'call', 'telemarketing', 'associates']","['case', 'decide', 'monday', 'center', 'illinois', 'fund', 'raise', 'telemarketing', 'associates']",4.400000095367432,4,4322,4987,-665,442225
3278,"['urge', 'congress', 'send', 'final', 'bill', 'soon', 'possible', 'sign', 'law']","['urge', 'congress', 'quickly', 'resolve', 'difference', 'send', 'final', 'bill', 'soon', 'possible', 'sign', 'law', 'say']",4.599999904632568,9,5480,5271,209,43681
3279,"['pigeon', 'director', 'litigation', 'massachusetts', 'correctional', 'legal', 'services', 'prisoner', 'right', 'group']","['pigeon', 'say', 'attorney', 'organization', 'massachusetts', 'correctional', 'legal', 'services', 'interview', 'san', 'tuesday']",1.6670000553131104,5,4977,1595,3382,11437924
3280,"['graduate', 'military', 'academy', 'west', 'joint', 'new', 'work']","['grow', 'united', 'states', 'graduate', 'military', 'academy', 'west', 'joint']",4.0,5,4983,4579,404,163216
3281,"['pnc', 'regret', 'involvement', 'deal', 'chairman', 'chief', 'executive', 'officer', 'james', 'say', 'statement']","['james', 'chairman', 'chief', 'executive', 'officer', 'say', 'pnc', 'regret', 'incident']",4.333000183105469,8,5396,4956,440,193600
3282,"['ccag', 'support', 'hurry', 'poland', 'opponent', 'gubernatorial', 'election']","['swan', 'group', 'support', 'governor', 'democratic', 'opponent', 'hurry', 'election']",3.0,4,4324,2827,1497,2241009
3283,"['later', 'fall', 'back', 'series', 'rival', 'congolese', 'militia', 'recent', 'year']","['invade', 'country', 'later', 'fall', 'back', 'rival', 'faction']",3.5,4,4325,3732,593,351649
3284,"['say', 'member', 'continue', 'million', 'phone', 'number', 'federal', 'trade', 'commission', 'list']","['meantime', 'direct', 'marketing', 'association', 'say', 'member', 'nearly', 'million', 'number', 'list']",2.0,5,4984,1861,3123,9753129
3285,"['veteran', 'entertain', 'mob', 'hope', 'celebrate', 'birthday', 'year', 'showbusiness', 'thursday']","['hollywood', 'world', 'hear', 'celebrate', 'legendary', 'entertain', 'mob', 'hope', 'birthday', 'thursday']",3.75,6,5213,3990,1223,1495729
3286,"['decline', 'issue', 'outnumber', 'advance', 'nearly', 'new', 'work', 'stock', 'exchange']","['dancer', 'outnumber', 'decline', 'nearly', 'nyse', 'nasdaq']",1.7999999523162842,3,2757,1746,1011,1022121
3287,"['float', 'fairfield', 'flight', 'deck', 'cover', 'acre', 'ship', 'take', 'year', 'build']","['began', 'float', 'fairfield', 'flight', 'deck', 'cover', 'acre', 'ninth', 'limit', 'class', 'carrier', 'build', 'newport', 'news', 'shipyard']",2.6670000553131104,7,5260,2534,2726,7431076
3288,"['proud', 'citizen', 'state', 'say', 'sov', 'john', 'baldacci', 'causing', 'foe']","['proud', 'citizen', 'state', 'sov', 'john', 'baldacci', 'say', 'vote', 'referendum', 'count']",3.799999952316284,7,5229,4303,926,857476
3289,"['injure', 'woman', 'co', 'worker', 'hospitalize', 'list', 'good', 'condition']","['woman', 'list', 'good', 'condition', 'memorial', 'healthpark', 'camp', 'say']",2.200000047683716,4,4326,1981,2345,5499025
3290,"['shooting', 'victim', 'take', 'kings', 'county', 'hospital', 'enter', 'later', 'die', 'police', 'say']","['victim', 'identify', 'take', 'king', 'county', 'hospital', 'pronounce', 'dead']",4.333000183105469,4,4327,4954,-627,393129
3291,"['report', 'symptom', 'fever', 'headache', 'rash', 'muscle', 'ache']","['symptom', 'include', 'stiff', 'neck', 'fever', 'headache', 'sensitivity', 'light']",2.3329999446868896,3,2715,2167,548,300304
3292,"['like', 'total', 'stranger', 'vein', 'quote', 'say']","['like', 'total', 'stranger', 'john', 'tell', 'pal', 'day', 'death']",3.25,3,2722,3386,-664,440896
3293,"['graduate', 'saturday', 'northwest', 'college', 'affiliate', 'assemblies', 'god', 'bachelor', 'art', 'degree', 'religion', 'philosophy']","['start', 'attend', 'northwest', 'college', 'affiliate', 'assemblies', 'god', 'plan', 'minister']",2.25,5,4993,2150,2843,8082649
3294,"['technology', 'lace', 'nasdaq', 'composite', 'index', 'fall', 'point', 'percent']","['broad', 'standard', 'door', 'index', 'give', 'point', 'percent']",0.75,3,2725,742,1983,3932289
3295,"['final', 'test', 'deliver', 'missile', 'armed', 'force']","['state', 'radio', 'say', 'test', 'missile', 'deliver', 'armed', 'force']",4.0,5,4973,4624,349,121801
3296,"['withdrawal', 'country', 'inevitable', 'happen', 'today', 'tomorrow', 'tomorrow', 'come', 'soon']","['withdrawal', 'country', 'inevitable', 'happen', 'today', 'tomorrow', 'add', 'voice', 'sign', 'give', 'date', 'mid', 'september']",3.5,6,5209,3724,1485,2205225
3297,"['accord', 'news', 'release', 'send', 'merry', 'schindler', 'schiavo', 'foundation', 'florida', 'speaker', 'johnnie', 'word', 'introduce', 'ferri', 'special', 'session', 'monday']","['florida', 'speaker', 'house', 'johnnie', 'word', 'expect', 'introduce', 'ferri', 'day', 'special', 'session', 'state', 'legislature', 'hold', 'today', 'tallahassee']",3.75,8,5407,4047,1360,1849600
3298,"['business', 'utah', 'volunteer', 'display', 'amber', 'alert', 'sign']","['business', 'volunteer', 'alert', 'electronic', 'sign', 'billboard']",3.75,4,4330,4026,304,92416
3299,"['thank', 'neuro', 'rise', 'japanese', 'currency', 'dollar', 'man', 'overnight', 'month', 'low', 'man']","['neuro', 'rise', 'man', 'speculation', 'japanese', 'intervention', 'help', 'dollar', 'firm', 'man', 'month', 'low', 'man', 'hit', 'thursday']",4.25,7,5272,4933,339,114921
3300,"['russian', 'stock', 'fall', 'arrest', 'saturday', 'mikhail', 'khodorkovsky', 'chief', 'executive', 'dukes', 'oil', 'charge', 'fraud', 'tax', 'invasion']","['weekend', 'arrest', 'russia', 'rich', 'man', 'mikhail', 'khodorkovsky', 'chief', 'executive', 'oil', 'major', 'yuko', 'charge', 'fraud', 'tax', 'invasion', 'unnerve', 'financial', 'market']",4.0,10,5632,4612,1020,1040400
3301,"['year', 'expect', 'sale', 'million', 'profit', 'cent', 'share', 'continue', 'operation']","['increase', 'million', 'cent', 'share', 'previously', 'forecast']",0.75,3,2802,747,2055,4223025
3302,"['hughes', 'refuse', 'retire', 'hernandez', 'complain', 'equal', 'employment', 'opportunity', 'commission']","['hernandez', 'file', 'equal', 'employment', 'opportunity', 'commission', 'complaint', 'sue']",3.400000095367432,5,4954,3439,1515,2295225
3303,"['dewhurst', 'proposal', 'call', 'abrupt', 'end', 'controversial', 'robin', 'good', 'plan', 'school', 'finance']","['committee', 'propose', 'replacement', 'robin', 'good', 'school', 'finance', 'system']",2.5999999046325684,4,4332,2496,1836,3370896
3304,"['country', 'private', 'creditor', 'owe', 'billion', 'addition']","['country', 'owe', 'billion', 'billion']",3.400000095367432,3,2811,3441,-630,396900
3305,"['telemarketer', 'number', 'list', 'act', 'face', 'fine']","['law', 'telemarketer', 'number', 'list', 'fine', 'violation']",3.5999999046325684,4,4333,3934,399,159201
3306,"['explain', 'find', 'antetonitrus', 'come', 'post', 'doctor', 'research', 'assistant', 'england', 'university', 'bristol']","['explain', 'find', 'antetonitrus', 'come', 'post', 'doctor', 'research', 'assistant', 'bristol', 'university', 'britain']",5.0,10,5639,5737,-98,9604
3307,"['air', 'canada', 'large', 'airline', 'canada', 'world', 'court', 'protection', 'creditor', 'april']","['airline', 'world', 'air', 'canada', 'court', 'protection', 'creditor', 'april']",4.25,8,5369,4914,455,207025
3308,"['jury', 'find', 'gonzale', 'guilty', 'excessive', 'force', 'rouse', 'vera', 'carrera', 'pepper', 'spray']","['gonzales', 'find', 'guilty', 'excessive', 'force', 'spray', 'vera', 'pepper', 'spray']",4.25,7,5241,4947,294,86436
3309,"['body', 'dead', 'pull', 'train', 'lay', 'track', 'emergency', 'service', 'bring', 'wooden', 'coffin']","['body', 'dead', 'pull', 'partially', 'detailed', 'train', 'lay', 'track', 'await', 'identification']",3.25,6,5200,3396,1804,3254416
3310,"['earner', 'say', 'self', 'proclaim', 'mayor', 'baghdad', 'mohammed', 'chosen', 'al', 'zubaidi', 'release', 'day', 'coalition', 'custody']","['earner', 'say', 'self', 'proclaim', 'baghdad', 'mayor', 'mohammed', 'chosen', 'zubaidi', 'release', 'hour', 'detention', 'late', 'april']",4.25,10,5579,4948,631,398161
3311,"['union', 'company', 'executive', 'engage', 'widespread', 'evasive', 'fraud', 'prosecution', 'samuel', 'quell', 'tell', 'associated', 'dress']","['union', 'company', 'executive', 'engage', 'widespread', 'evasive', 'fraud', 'manipulate', 'company', 'earning', 'result', 'quell', 'say']",3.75,8,5370,4046,1324,1752976
3312,"['customer', 'pay', 'entrance', 'fee', 'sms', 'device', 'client', 'access', 'license']","['detail', 'prick', 'sms', 'device', 'client', 'access', 'license']",4.333000183105469,5,4960,4957,3,9
3313,"['result', 'original', 'peoples', 'survey', 'release', 'yesterday', 'statistics', 'canada', 'suggest', 'living', 'standard', 'improve', 'law', 'reserve']","['original', 'peoples', 'survey', 'release', 'wednesday', 'statistics', 'canada', 'say', 'living', 'standard', 'improve', 'law', 'suit', 'leave', 'impoverished', 'reserve']",3.908999919891357,11,5670,4337,1333,1776889
3314,"['recent', 'turnaround', 'stock', 'market', 'easing', 'unemployment', 'claim', 'consumer', 'expectation', 'current', 'level', 'signal', 'favorable', 'economic', 'time', 'ahead']","['recent', 'turnaround', 'stock', 'market', 'easing', 'unemployment', 'claim', 'signal', 'favorable', 'economic', 'time', 'ahead', 'say']",3.933000087738037,12,5700,4341,1359,1846881
3315,"['day', 'trading', 'lackluster', 'standard', 'door', 'index', 'prepare', 'close', 'good', 'month', 'period', 'fourth', 'quarter']","['standard', 'door', 'stock', 'index', 'end', 'quarter', 'point', 'gain', 'percent', 'good', 'performance', 'broad', 'market', 'benchmark']",3.75,5,4967,4053,914,835396
3316,"['ona', 'explicitly', 'state', 'receive', 'intelligence', 'material', 'indicate', 'jemaah', 'islamiyah', 'terrorist', 'network', 'plan', 'mount', 'operation', 'ali']","['stage', 'ona', 'receive', 'intelligence', 'material', 'indicate', 'jemaah', 'islamiyah', 'plan', 'mount', 'operation', 'ali']",4.25,11,5673,4945,728,529984
3317,"['report', 'deny', 'interior', 'minister', 'prince', 'layer']","['maude', 'interior', 'minister', 'prince', 'layer', 'deny', 'report']",4.25,6,5148,4940,208,43264
3318,"['bryant', 'previously', 'say', 'like', 'great', 'impact', 'demand', 'official', 'expect']","['chief', 'financial', 'officer', 'andy', 'bryant', 'say', 'like', 'great', 'affect', 'volume', 'official', 'expect']",3.5,6,5144,3715,1429,2042041
3319,"['judge', 'follette', 'reduce', 'punishment', 'life', 'prison', 'parole', 'muhammad', 'formally', 'sentence', 'web', 'virginia', 'judge', 'rarely', 'action']","['judge', 'reduce', 'punishment', 'life', 'prison', 'parole', 'expert', 'virginia', 'judge', 'rarely', 'opportunity']",3.25,8,5439,3392,2047,4190209
3320,"['spokesman', 'strong', 'memorial', 'hospital', 'say', 'loud', 'satisfactory', 'condition', 'tuesday', 'night']","['spokesman', 'strong', 'memorial', 'hospital', 'say', 'loud', 'evaluation', 'tuesday', 'evening', 'emergency', 'room']",3.0,7,5298,2841,2457,6036849
3321,"['rent', 'harsh', 'face', 'multiple', 'count', 'burial', 'service', 'fraud', 'make', 'false', 'statement', 'abuse', 'dead', 'body', 'theft']","['rent', 'harsh', 'face', 'charge', 'abuse', 'body', 'theft']",3.799999952316284,6,5143,4244,899,808201
3322,"['college', 'president', 'paul', 'pribbenow', 'tell', 'wrap', 'speech']","['edge', 'microphone', 'plug', 'second', 'time', 'pribbenow', 'tell', 'wrap', 'speech']",3.400000095367432,4,4345,3647,698,487204
3323,"['month', 'period', 'end', 'june', 'high', 'speed', 'line', 'instal', 'home', 'business', 'increase', 'percent']","['year', 'period', 'end', 'june', 'high', 'speed', 'line', 'increase', 'percent']",3.857000112533569,8,5429,4333,1096,1201216
3324,"['sick', 'lemons', 'brief', 'troubled', 'missouri', 'basketball', 'career']","['missouri', 'kick', 'sick', 'lemons', 'team', 'end', 'troubled', 'career']",4.0,5,5007,4535,472,222784
3325,"['military', 'official', 'motor', 'wash', 'helicopter', 'blow', 'banner']","['official', 'say', 'downward', 'motor', 'wash', 'generate', 'cover', 'helicopter', 'strip', 'flag', 'tower']",3.400000095367432,4,4321,3633,688,473344
3326,"['settlement', 'take', 'effect', 'week', 'reach', 'month', 'take', 'helm', 'nation', 'fourth', 'large', 'archdiocese']","['million', 'agreement', 'reach', 'september', 'month', 'archbishop', 'mean', 'take', 'leader', 'nation', 'fourth', 'large', 'diese']",3.0,6,5141,2873,2268,5143824
3327,"['capitol', 'evacuate', 'yesterday', 'authority', 'detect', 'possibly', 'hazardous', 'material', 'basement', 'senate', 'wing', 'capitol', 'police', 'say']","['capitol', 'police', 'evacuate', 'capitol', 'yesterday', 'senior', 'detect', 'possible', 'biohazard', 'senate', 'wing', 'authority', 'later', 'say', 'false', 'alarm']",3.200000047683716,9,5563,3098,2465,6076225
3328,"['president', 'give', 'numerous', 'speech', 'compensation', 'say', 'spokesman', 'penned']","['spokesman', 'penned', 'say', 'president', 'give', 'speech', 'compensation']",3.5999999046325684,7,5235,3864,1371,1879641
3329,"['broad', 'standard', 'door', 'index', 'point', 'percent']","['standard', 'door', 'stock', 'index', 'future', 'june', 'point', 'nasdaq', 'future', 'point']",1.600000023841858,4,4305,1493,2812,7907344
3330,"['rubbed', 'project', 'matter', 'sinus', 'base', 'desktop', 'promote', 'run', 'secure', 'expensive', 'alternative', 'windows']","['design', 'compete', 'microsoft', 'project', 'matter', 'position', 'run', 'cheap', 'secure', 'alternative', 'desktop', 'operating', 'system', 'microsoft', 'desktop', 'offering']",3.799999952316284,6,5198,4294,904,817216
3331,"['key', 'figure', 'state', 'treasurer', 'paul', 'silvester', 'bribery', 'scheme', 'accuse', 'wednesday', 'change', 'story', 'silvester', 'alleged', 'corrupt', 'dealing', 'boston', 'investment', 'firm']","['key', 'player', 'state', 'treasurer', 'paul', 'silvester', 'corruption', 'scheme', 'testify', 'tuesday', 'kickback', 'bribe', 'silvester', 'trade', 'state', 'business']",2.0,6,5195,1825,3370,11356900
3332,"['mission', 'capps', 'system', 'aviation', 'security', 'say', 'administration', 'copeland', 'security', 'department']","['mission', 'capps', 'system', 'aviation', 'security', 'say']",3.5999999046325684,6,5193,3870,1323,1750329
3333,"['woman', 'speak', 'lawyer', 'john', 'speranza', 'say', 'client', 'wake', 'day', 'intending', 'hurt']","['woman', 'wake', 'day', 'intending', 'hurt', 'defense', 'attorney', 'john', 'speranza', 'say']",4.5,8,5455,5143,312,97344
3334,"['believe', 'necessary', 'division', 'confirmation', 'fight', 'supreme', 'court', 'appointment', 'daschle', 'write']","['believe', 'necessary', 'division', 'confirmation', 'fight', 'daschle', 'south', 'dakota', 'write', 'republican', 'president']",4.0,7,5258,4572,686,470596
3335,"['yahoo', 'account', 'bsd', 'site', 'ntt', 'period', 'infospace', 'survey', 'find']","['service', 'company', 'ntt', 'period', 'infospace', 'survey', 'find']",3.0,5,4866,2874,1992,3968064
3336,"['late', 'level', 'scuffle', 'cnn', 'petya', 'leave', 'post', 'general', 'manager', 'programming', 'network', 'announce']","['cnn', 'late', 'rejuvenated', 'rating', 'network', 'dust', 'petya', 'general', 'manager', 'programming']",3.7690000534057617,7,5252,4059,1193,1423249
3337,"['suspect', 'key', 'figure', 'jemaah', 'islamiyah', 'al', 'link', 'terror', 'group', 'blame', 'coming']","['samudra', 'suspect', 'key', 'figure', 'al', 'say', 'link', 'terror', 'group', 'jemaah', 'islamiyah', 'blame', 'carry', 'coming']",3.400000095367432,11,5657,3580,2077,4313929
3338,"['firefighter', 'mosque', 'today', 'albuquerque', 'fire', 'chief', 'robert', 'ortega', 'say']","['second', 'away', 'have', 'happen', 'albuquerque', 'fire', 'chief', 'robert', 'ortega', 'say']",1.7999999523162842,6,5182,1760,3422,11710084
3339,"['issue', 'resolve', 'darling', 'president', 'david', 'samson', 'say', 'club', 'spokesman']","['darling', 'say', 'issue', 'resolve']",3.0,4,4299,2903,1396,1948816
3340,"['china', 'health', 'ministry', 'say', 'people', 'die', 'war', 'infect']","['monday', 'china', 'say', 'people', 'die', 'sars', 'infect', 'virus']",3.0,5,4947,2904,2043,4173849
3341,"['share', 'mcdonald', 'rise', 'percent', 'close', 'day', 'high']","['mcdonald', 'share', 'rise', 'close', 'friday', 'new', 'work', 'stock', 'exchange']",4.25,4,4300,4944,-644,414736
3342,"['say', 'fda', 'hope', 'congress', 'court', 'bring', 'clarity', 'situation', 'financial', 'relief', 'consumer']","['say', 'fda', 'hope', 'congress', 'court', 'bring', 'clarity', 'situation', 'financial', 'relief', 'consumer', 'election']",4.0,11,5661,4564,1097,1203409
3343,"['rest', 'young', 'admit', 'wrongdoing', 'settlement']","['rest', 'young', 'spokesman', 'kenneth', 'corrigan', 'say', 'firm', 'admit', 'wrongdoing']",4.0,4,4302,4556,-254,64516
3344,"['witness', 'year', 'old', 'kosovan', 'parking', 'attendant', 'criminal', 'conviction', 'dishonesty', 'pay', 'news', 'world']","['witness', 'year', 'old', 'kosovan', 'parking', 'attendant', 'pay', 'news', 'world', 'court', 'hear']",3.625,9,5492,3977,1515,2295225
3345,"['difference', 'grassley', 'thomas', 'energy', 'dedicate', 'point', 'member', 'angry', 'personal', 'relationship', 'embarrass', 'party']","['difference', 'energy', 'dedicate', 'point', 'member', 'embarrassing', 'party']",3.5,6,5178,3718,1460,2131600
3346,"['wound', 'security', 'guard', 'flee', 'stab', 'passer', 'run', 'promenade']","['stab', 'passer', 'flee', 'promenade', 'mediterranean', 'tea']",3.200000047683716,4,4304,3190,1114,1240996
3347,"['colleague', 'attribute', 'communication', 'gap', 'doctor', 'feel', 'press', 'time']","['attribute', 'communication', 'gap', 'doctor', 'feel', 'press', 'time', 'patient', 'cite', 'discomfort', 'discuss', 'financial', 'issue']",3.400000095367432,7,5358,3553,1805,3258025
3348,"['state', 'police', 'say', 'worker', 'wrap', 'immediately', 'garage', 'collapse']","['people', 'believe', 'wrap', 'inside', 'initially', 'state', 'police', 'say']",4.0,4,4318,4554,-236,55696
3349,"['angeles', 'bulk', 'monster', 'box', 'office', 'debut', 'weekend', 'take', 'june', 'opening', 'record', 'million']","['bulk', 'take', 'million', 'box', 'office', 'monster', 'opening', 'new', 'june', 'record']",4.800000190734863,9,5489,5395,94,8836
3350,"['congratulation', 'name', 'time', 'magazine', 'person', 'dear']","['time', 'magazine', 'name', 'american', 'soldier', 'person', 'dear']",2.400000095367432,5,4833,2251,2582,6666724
3351,"['indictment', 'say', 'attend', 'important', 'meeting', 'plan', 'attack', 'recruit', 'fellow', 'comber', 'coordinate', 'operation']","['samudra', 'present', 'bangkok', 'indictment', 'say', 'attend', 'series', 'meeting', 'attack', 'recruit', 'fellow', 'comber', 'coordinate', 'operation']",3.200000047683716,10,5603,3186,2417,5841889
3352,"['microsoft', 'opportunity', 'comment', 'remedy', 'propose', 'commission']","['thing', 'microsoft', 'comment', 'propose', 'remedy', 'response']",4.199999809265137,4,4309,4855,-546,298116
3353,"['texans', 'saddle', 'skyrocket', 'homeowner', 'premium', 'finally', 'get', 'relief']","['relief', 'sight', 'texans', 'saddle', 'skyrocket', 'homeowner', 'insurance', 'premium']",5.0,6,5192,5704,-512,262144
3354,"['democrats', 'vie', 'succeed', 'jacques', 'qualify', 'web', 'primary', 'ballot']","['democrats', 'republicans', 'run', 'seat', 'qualify', 'web', 'primary', 'ballot']",3.400000095367432,5,4844,3559,1285,1651225
3355,"['halliburton', 'tuesday', 'reiterate', 'contention', 'kbr', 'deliver', 'fuel', 'ran', 'good', 'value', 'good', 'price', 'good', 'term']","['believe', 'kbr', 'deliver', 'fuel', 'ran', 'good', 'value', 'good', 'price', 'good', 'term', 'halliburton', 'spokesman', 'end', 'say']",4.0,9,5552,4574,978,956484
3356,"['lucia', 'battle', 'cleveland', 'tell', 'police', 'drop', 'purse', 'leave', 'quick', 'shop', 'good', 'week', 'buy', 'ticket']","['lucia', 'battle', 'drop', 'purse', 'buy', 'began', 'millions', 'pottery', 'ticket', 'week', 'believe', 'ticket', 'blow', 'away']",3.3329999446868896,7,5333,3401,1932,3732624
3357,"['customer', 'include', 'mitsubishi', 'niemen', 'dbtel', 'calm', 'philip', 'sharp', 'bony']","['medial', 'customer', 'include', 'major', 'hand', 'maker', 'mitsubishi', 'niemen', 'calm', 'sharp', 'philip', 'bony']",3.200000047683716,8,5431,3183,2248,5053504
3358,"['cleveland', 'cavaliers', 'win', 'right', 'draft', 'james', 'win', 'nba', 'annual', 'lottery', 'thursday', 'night']","['case', 'thursday', 'night', 'cleveland', 'cavaliers', 'win', 'neuron', 'james', 'pottery', 'know', 'nba', 'draft', 'lottery']",4.0,9,5523,4627,896,802816
3359,"['worker', 'research', 'find', 'short', 'worker', 'bad', 'hearing', 'expect', 'age']","['short', 'worker', 'bad', 'hearing', 'expect', 'age', 'time', 'tall', 'worker', 'write', 'barrenas']",3.799999952316284,6,5145,4271,874,763876
3360,"['olin', 'specify', 'system', 'centre', 'investigation']","['olaf', 'belgian', 'prospector', 'specify', 'system', 'centre', 'investigation']",2.200000047683716,4,4313,2125,2188,4787344
3361,"['sale', 'entertainment', 'torment', 'limit', 'united', 'states', 'canada']","['computer', 'currently', 'sell', 'canada', 'united', 'states']",3.75,3,2697,4054,-1357,1841449
3362,"['calmer', 'vocal', 'past', 'warning', 'sinus', 'threat', 'microsoft']","['meme', 'calmer', 'reiterate', 'open', 'source', 'threat', 'microsoft']",3.0,3,2699,2912,-213,45369
3363,"['broad', 'standard', 'door', 'stock', 'index', 'point', 'cent']","['standard', 'door', 'stock', 'index', 'future', 'decline', 'point', 'nasdaq', 'future', 'fall', 'point']",1.25,5,4856,1258,3598,12945604
3364,"['talabani', 'tell', 'governing', 'council', 'need', 'assistance', 'advice', 'implement', 'new', 'decision', 'take']","['talabani', 'tell', 'iraqi', 'leader', 'need', 'assistance', 'advice', 'implement', 'new', 'decision', 'take', 'organize', 'interim', 'iraqi', 'government', 'june']",3.25,9,5532,3388,2144,4596736
3365,"['stanford', 'play', 'south', 'carolina', 'today', 'round', 'game', 'rosenblatt', 'stadium', 'omaha', 'web']","['stanford', 'play', 'south', 'carolina', 'friday', 'opening', 'game', 'double', 'elimination', 'tournament']",3.3329999446868896,5,4859,3420,1439,2070721
3366,"['survey', 'month', 'ago', 'street', 'lead', 'percent', 'percent', 'percent', 'undecided']","['month', 'ago', 'poll', 'lead', 'percent']",2.0,4,4314,1833,2481,6155361
3367,"['broad', 'standard', 'door', 'index', 'advance', 'point', 'percent']","['standard', 'door', 'index', 'gain', 'percent', 'new', 'work']",3.0,4,4315,2917,1398,1954404
3368,"['realize', 'late', 'course', 'potential', 'victim', 'horror', 'movie']","['realize', 'late', 'course', 'potential', 'victim']",3.6670000553131104,5,4917,3981,936,876096
3369,"['arthur', 'reason', 'attorney', 'case', 'plaintiff', 'schoolchildren', 'say', 'appeal']","['attorney', 'plaintiff', 'schoolchildren', 'say', 'plan', 'appeal']",3.6670000553131104,5,4920,3982,938,879844
3370,"['neuro', 'slip', 'nearly', 'percent', 'watch', 'record', 'peak', 'week', 'hit', 'time', 'high', 'man', 'late']","['neuro', 'slip', 'cent', 'watch', 'record', 'peak', 'near', 'week', 'hit', 'record', 'high', 'man', 'late']",4.333000183105469,10,5609,4955,654,427716
3371,"['pennsylvania', 'aggressive', 'treatment', 'program', 'treat', 'inmate']","['texas', 'time', 'michigan', 'inmate', 'population', 'treat', 'infect', 'inmate']",1.3329999446868896,2,1941,1263,678,459684
3372,"['teach', 'load', 'nasdaq', 'composite', 'rise', 'point', 'end', 'high', 'level', 'month']","['technology', 'lace', 'nasdaq', 'composite', 'index', 'climb', 'point', 'percent']",2.200000047683716,3,2693,2141,552,304704
3373,"['expose', 'feature', 'open', 'window', 'shrink', 'fit', 'screen', 'clear', 'identify']","['expose', 'ex', 'oh', 'feature', 'open', 'window', 'desktop', 'immediately', 'shrink', 'fit', 'screen', 'clear', 'identify']",4.400000095367432,9,5535,4962,573,328329
3374,"['instead', 'prospector', 'dismiss', 'charge', 'pucker', 'leave', 'courtroom', 'free', 'man']","['instead', 'leave', 'courtroom', 'free', 'man', 'authority', 'dismiss', 'criminal', 'charge']",3.400000095367432,7,5347,3590,1757,3087049
3375,"['case', 'mentally', 'challenging', 'emotional', 'exhausting', 'say', 'foreman', 'wolfcale', 'year', 'old', 'minister']","['wolfcale', 'jury', 'foreman', 'minister', 'say', 'case', 'mentally', 'challenging', 'emotional', 'exhausting']",4.199999809265137,9,5531,4836,695,483025
3376,"['arrive', 'later', 'week', 'state', 'visit', 'president']","['rush', 'arrive', 'tuesday', 'state', 'visit', 'american', 'president']",3.0,4,4349,2924,1425,2030625
3377,"['deal', 'approve', 'company', 'board', 'director', 'expect', 'complete', 'quarter', 'nvidia', 'fiscal', 'quarter']","['acquisition', 'approve', 'company', 'board', 'director', 'expect', 'close', 'quarter', 'year']",3.400000095367432,6,5201,3544,1657,2745649
3378,"['volatile', 'mix', 'drag', 'session', 'day', 'allot', 'rush', 'say', 'senate', 'president', 'king']","['senate', 'support', 'tap', 'noneconomic', 'damage', 'sov', 'web', 'rush', 'propose', 'say', 'senate', 'president', 'king']",2.75,5,4926,2552,2374,5635876
3379,"['police', 'officer', 'involve', 'bust', 'culmination', 'year', 'operation', 'investigation', 'cocaine', 'import', 'money', 'wander', 'gang']","['officer', 'launch', 'london', 'maid', 'final', 'phase', 'year', 'operation', 'investigation', 'cocaine', 'money', 'wandering', 'ring']",4.0,6,5162,4695,467,218089
3380,"['strip', 'extraordinary', 'item', 'fourth', 'quarter', 'earning', 'cent', 'share', 'compare', 'cent', 'share', 'prior', 'year']","['earning', 'cent', 'share', 'month', 'end', 'compare', 'cent', 'share', 'year', 'early']",1.0,5,4930,959,3971,15768841
3381,"['age', 'reach', 'pound', 'difficult', 'decision', 'time', 'try', 'surgery']","['age', 'weigh', 'shopping', 'kg', 'come', 'difficult', 'decision', 'time', 'try', 'surgery']",4.25,6,5166,4925,241,58081
3382,"['world', 'end', 'terrorist', 'say']","['hospital', 'treat', 'everybody', 'people', 'world', 'end', 'terrorist']",3.5,3,2790,3730,-940,883600
3383,"['rates', 'comdex', 'denote', 'time', 'new', 'tablet']","['sunday', 'night', 'comdex', 'time', 'rates', 'denote']",3.066999912261963,4,4379,3072,1307,1708249
3384,"['accord', 'report', 'night', 'allegedly', 'punch', 'parking', 'attendant', 'outside', 'os', 'angeles', 'nightclub']","['arrest', 'week', 'allegedly', 'munch', 'parking', 'attendant', 'outside', 'nightclub']",3.25,5,4934,3377,1557,2424249
3385,"['wait', 'turn', 'rode', 'finger', 'sixth', 'grade', 'washington']","['rode', 'finger', 'sixth', 'grade', 'washington', 'anxiously', 'await', 'turn', 'microphone']",3.75,6,5222,4023,1199,1437601
3386,"['cancer', 'society', 'say', 'study', 'miss']","['american', 'cancer', 'society', 'scientist', 'say', 'study', 'flow', 'way']",2.25,4,4382,2152,2230,4972900
3387,"['hold', 'armstrong', 'county', 'nail']","['later', 'hold', 'bail', 'armstrong', 'county', 'prison', 'today']",2.5,3,2771,2363,408,166464
3388,"['mile', 'east', 'tehuacan', 'corn', 'domesticate', 'year', 'ago']","['mile', 'west', 'pyramid', 'teotihuacan', 'corn', 'domesticate', 'year', 'ago']",3.75,5,4938,3996,942,887364
3389,"['confusion', 'tap', 'tumultuous', 'week', 'list', 'intend', 'block', 'percent', 'telemarketing', 'call']","['free', 'service', 'originally', 'intend', 'block', 'percent', 'telemarketer', 'call']",3.25,4,4384,3337,1047,1096209
3390,"['strong', 'preference', 'achieve', 'financial', 'restructuring', 'court', 'remain', 'hopeful', 'chief', 'executive', 'parce', 'fuller', 'say']","['strong', 'preference', 'achieve', 'financial', 'restructuring', 'court', 'grant', 'ceo', 'parce', 'fuller', 'say', 'prepared', 'statement', 'early', 'friday']",4.0,9,5562,4630,932,868624
3391,"['name', 'complaint', 'chief', 'executive', 'officer', 'paul', 'allaire', 'richard', 'woman', 'cfo', 'carry', 'romeril']","['executive', 'fine', 'include', 'chief', 'executive', 'paul', 'allaire', 'richard', 'woman', 'chief', 'financial', 'officer', 'carry', 'romeril']",3.444000005722046,9,5556,3685,1871,3500641
3392,"['margin', 'manhattan', 'charge', 'sham', 'marriage', 'charge', 'mercury', 'file', 'false', 'instrument']","['margin', 'manhattan', 'charge', 'mercury', 'file', 'false', 'instrument', 'marriage', 'application']",4.599999904632568,8,5406,5269,137,18769
3393,"['estimate', 'thursday', 'percent', 'market', 'share', 'europe']","['boston', 'scientific', 'say', 'gain', 'percent', 'coat', 'send', 'market', 'europe']",2.799999952316284,3,2817,2597,220,48400
3394,"['senate', 'banking', 'committee', 'schedule', 'hold', 'hearing', 'tuesday', 'donaldson', 'schedule', 'testify', 'hedge', 'mutual', 'fund']","['senate', 'banking', 'committee', 'schedule', 'hold', 'hearing', 'tuesday', 'donaldson', 'question', 'hedge', 'mutual', 'fund']",4.800000190734863,11,5651,5371,280,78400
3395,"['teach', 'heavy', 'nasdaq', 'composite', 'index', 'percent', 'point']","['broad', 'standard', 'door', 'index', 'point', 'percent']",0.6000000238418579,3,2814,657,2157,4652649
3396,"['horse', 'charge', 'assault', 'parish', 'charge', 'file', 'false', 'report']","['partner', 'ivan', 'parish', 'charge', 'file', 'false', 'police', 'report']",2.75,5,4919,2566,2353,5536609
3397,"['appointment', 'new', 'job', 'executive', 'vice', 'president', 'chief', 'staff', 'officer']","['truce', 'hawthorne', 'name', 'executive', 'vice', 'president', 'chief', 'staff', 'officer']",3.25,6,5203,3338,1865,3478225
3398,"['analysis', 'expect', 'net', 'loss', 'cent', 'share', 'accord', 'thomson']","['analysis', 'forecast', 'second', 'quarter', 'sale', 'million', 'accord', 'thomson', 'web', 'site']",1.5,3,2810,1437,1373,1885129
3399,"['district', 'send', 'letter', 'yesterday', 'inform', 'parent', 'situation']","['parent', 'receive', 'letter', 'inform', 'possible', 'contamination', 'yesterday']",3.0,4,4387,2880,1507,2271049
3400,"['richard', 'grass', 'quit', 'chairman', 'week', 'lose', 'support', 'board', 'amid', 'public', 'million', 'pay', 'package']","['grass', 'quit', 'week', 'wake', 'firestorm', 'criticism', 'million', 'compensation', 'package']",3.799999952316284,5,4893,4251,642,412164
3401,"['new', 'serve', 'run', 'sinus', 'x', 'version', 'molars', 'say']","['serve', 'run', 'molars', 'x', 'operating', 'system', 'standard', 'sinus', 'operating', 'system']",4.308000087738037,5,4894,4950,-56,3136
3402,"['glide', 'ice', 'moriarty', 'patella', 'hit', 'spongy', 'rocky', 'floor', 'river', 'immediately', 'feel', 'pull']","['glide', 'embankment', 'rescue', 'hit', 'spongy', 'rocky', 'floor', 'river', 'immediately', 'feel', 'pull']",3.400000095367432,9,5558,3612,1946,3786916
3403,"['marbury', 'schweppes', 'ply', 'plan', 'cut', 'job', 'shut', 'factory', 'billion', 'billion', 'acquisition', 'spree', 'past', 'year', 'inflated', 'cost']","['marbury', 'schweppes', 'veil', 'plan', 'slash', 'job', 'percent', 'factory', 'year', 'cut', 'cost', 'bring', 'acquisition', 'spree']",3.200000047683716,10,5614,3173,2441,5958481
3404,"['sweeney', 'outline', 'plan', 'campaign', 'speech', 'night', 'philadelphia', 'annual', 'meeting', 'american', 'political', 'science', 'association']","['sweeney', 'outline', 'plan', 'campaign', 'speech', 'saturday', 'night', 'annual', 'meeting', 'american', 'political', 'science', 'association']",3.5,12,5716,3707,2009,4036081
3405,"['like', 'isolated', 'incident', 'say', 'cried', 'mean', 'washington', 'earn', 'degree', 'political', 'science']","['like', 'isolated', 'incident', 'say', 'graduate', 'cried', 'mean', 'washington']",3.75,7,5314,4015,1299,1687401
3406,"['jury', 'award', 'tvt', 'million', 'compensatory', 'damage', 'roughly', 'million', 'punitive', 'damage']","['tvt', 'records', 'seek', 'million', 'punitive', 'damage', 'million', 'compensatory', 'damage', 'official', 'say']",1.75,5,4906,1613,3293,10843849
3407,"['tvt', 'records', 'seek', 'million', 'punitive', 'damage', 'million', 'compensatory', 'damage', 'official', 'say']","['damage', 'include', 'million', 'compensatory', 'damage', 'million', 'punitive', 'damage', 'idj']",1.25,4,4390,1254,3136,9834496
3408,"['democrats', 'member', 'fcc', 'panel', 'hold', 'news', 'conference', 'sway', 'opinion', 'lowell']","['democrats', 'member', 'fcc', 'hold', 'news', 'conference', 'sway', 'opinion', 'lowell', 'panel', 'republicans']",3.400000095367432,10,5616,3615,2001,4004001
3409,"['knit', 'volume', 'set', 'record', 'notebook', 'account', 'percent', 'sale']","['lcds', 'account', 'percent', 'monitor', 'sale']",1.2000000476837158,3,2759,1175,1584,2509056
3410,"['rattle', 'sale', 'slump', 'rebel', 'spur', 'investor', 'upset', 'huge', 'stock', 'option', 'windfall', 'company', 'manager', 'pocket']","['sale', 'slump', 'rebel', 'spur', 'shareholder', 'management', 'stock', 'option', 'windfall']",3.799999952316284,7,5354,4260,1094,1196836
3411,"['stanford', 'vice', 'play', 'national', 'championship', 'tonight']","['vice', 'stanford', 'meet', 'winner', 'match', 'monday']",3.5,2,1939,3713,-1774,3147076
3412,"['count', 'indictment', 'strike', 'target', 'drug', 'trafficking', 'world', 'attorney', 'marcus', 'jimenez', 'say']","['newly', 'seal', 'count', 'indictment', 'allege', 'money', 'wandering', 'conspiracy', 'strike', 'target', 'drug', 'traffic', 'world', 'jiménez', 'say']",3.5,7,5352,3703,1649,2719201
3413,"['soldier', 'kill', 'monday', 'wound', 'convoy', 'amuse', 'northern', 'ran']","['sunday', 'soldier', 'kill', 'injure', 'munition', 'dump', 'guard', 'exploded', 'southern', 'ran']",2.0,3,2752,1821,931,866761
3414,"['cost', 'analysis', 'way', 'say', 'michael', 'bell', 'cfe', 'executive', 'director']","['look', 'robin', 'good', 'remedy', 'say', 'michael', 'bell', 'campaign', 'executive', 'director']",2.0,5,4913,1819,3094,9572836
3415,"['go', 'court', 'believe', 'play', 'good', 'tennis']","['believe', 'confident', 'case', 'play', 'good', 'tennis']",4.800000190734863,4,4392,5388,-996,992016
3416,"['watson', 'tell', 'fbi', 'agent', 'shoot', 'dennehy', 'player', 'try', 'shoot', 'accord', 'arrest', 'warrant', 'affidavit']","['watson', 'arrest', 'july', 'tell', 'fbi', 'agent', 'shoot', 'dennehy', 'dennehy', 'try', 'shoot', 'accord', 'arrest', 'warrant', 'affidavit']",3.799999952316284,11,5645,4261,1384,1915456
3417,"['dog', 'say', 'second', 'human', 'thoroughness', 'medical', 'understanding', 'research']","['say', 'dog', 'second', 'human', 'term', 'subject', 'medical', 'research']",4.599999904632568,6,5221,5268,-47,2209
3418,"['stock', 'rise', 'percent', 'close', 'friday', 'new', 'work', 'stock', 'exchange']","['share', 'jump', 'percent', 'new', 'work', 'stock', 'exchange', 'friday']",1.399999976158142,6,5138,1341,3797,14417209
3419,"['uric', 'age', 'earn', 'save', 'opportunity', 'strike', 'ninth', 'allow', 'winfield', 'single', 'norton']","['close', 'uric', 'age', 'earn', 'save', 'opportunity', 'strike', 'matter', 'face', 'ninth']",3.5999999046325684,7,5344,3883,1461,2134521
3420,"['clair', 'government', 'include', 'charge', 'madam', 'seek', 'cranium', 'tiger', 'september', 'rosier', 'set', 'case', 'military', 'action']","['britain', 'include', 'accusation', 'september', 'rosier', 'set', 'case', 'war', 'ran']",3.0,5,4877,2889,1988,3952144
3421,"['count', 'energy', 'price', 'wholesale', 'price', 'percent']","['energy', 'price', 'drop', 'percent', 'big', 'decline', 'july']",1.600000023841858,3,2743,1490,1253,1570009
3422,"['statecraft', 'schedule', 'blast', 'early', 'tomorrow', 'late', 'friday', 'jiuquan', 'launch', 'site', 'sobs', 'desert']","['statecraft', 'schedule', 'blast', 'wednesday', 'friday', 'launch', 'site', 'sobs', 'desert']",4.0,8,5399,4660,739,546121
3423,"['long', 'long', 'flat', 'australia', 'singapore', 'south', 'lose', 'percent']","['australia', 'flat', 'singapore', 'percent', 'midday', 'south', 'add', 'percent']",2.400000095367432,5,4915,2259,2656,7054336
3424,"['suv', 'mark', 'residential', 'street', 'monrovia', 'rag', 'elf', 'slogan', 'set', 'ablaze', 'house', 'tom', 'right', 'say']","['suv', 'mark', 'residential', 'street', 'monrovia', 'rag', 'elf', 'slogan', 'say', 'tom', 'right']",3.5,11,5648,3719,1929,3721041
3425,"['case', 'indiana', 'illinois', 'suspect']","['suspect', 'case', 'illinois', 'indiana']",5.0,4,4397,5728,-1331,1771561
3426,"['pill', 'polypi', 'contain', 'aspirin', 'cholestrol', 'lower', 'drug', 'blood', 'pressure', 'lower', 'drug', 'half', 'standard', 'dose', 'colic', 'acid']","['ingredient', 'polypi', 'contain', 'aspirin', 'cholestrol', 'lower', 'station', 'blood', 'pressure', 'lower', 'agent', 'half', 'dose', 'colic', 'acid']",5.0,11,5649,5729,-80,6400
3427,"['drive', 'car', 'people', 'kill', 'metre', 'away', 'say', 'sunday']","['right', 'drive', 'car', 'people', 'kill', 'metre', 'away']",4.0,6,5053,4655,398,158404
3428,"['tuesday', 'arrangement', 'hearing', 'harsh', 'plead', 'guilty', 'count', 'burial', 'service', 'fraud', 'count', 'make', 'false', 'statement']","['hearing', 'plead', 'guilty', 'burial', 'service', 'fraud', 'false', 'statement', 'charge']",3.0,8,5392,2896,2496,6230016
3429,"['revenue', 'extra', 'premium', 'huge']","['extra', 'premium', 'collect']",1.3329999446868896,2,1937,1266,671,450241
3430,"['semiconductor', 'giant', 'say', 'yesterday', 'second', 'quarter', 'profit', 'double', 'year', 'ago', 'strong', 'expect', 'demand', 'computer', 'microprocessor', 'offset', 'weakness', 'communication', 'chip', 'business']","['second', 'quarter', 'profit', 'double', 'revenue', 'grow', 'percent', 'year', 'ago', 'chip', 'make', 'giant', 'report', 'strong', 'expect', 'demand', 'personal', 'computer', 'microprocessor']",3.799999952316284,13,5717,4264,1453,2111209
3431,"['schroeder', 'cancel', 'italian', 'holiday', 'tetani', 'refuse', 'apologise', 'spur', 'come', 'berlusconi', 'compare', 'german', 'politician', 'gaze', 'concentration', 'camp', 'guard']","['tetani', 'remark', 'stoke', 'tension', 'italian', 'crime', 'minister', 'ilio', 'berlusconi', 'week', 'compare', 'german', 'member', 'european', 'parliament', 'gaze', 'concentration', 'camp', 'guard']",3.0,9,5508,2872,2636,6948496
3432,"['openmanage', 'software', 'include', 'update', 'packages', 'sms', 'help', 'automatic', 'management', 'server', 'hardware', 'application', 'operating', 'system', 'patch', 'single', 'tool']","['update', 'package', 'help', 'automatic', 'management', 'server', 'hardware', 'application', 'operating', 'system', 'patch', 'tool', 'unpleasantly', 'vague']",2.6670000553131104,11,5672,2529,3143,9878449
3433,"['sweep', 'minute', 'die', 'cold', 'moriarty', 'think']","['embankment', 'moriarty', 'think', 'sweep', 'minute', 'die', 'cold']",4.0,6,5064,4652,412,169744
3434,"['lurd', 'call', 'interim', 'government', 'employment', 'western', 'peacekeeping', 'force']","['rebel', 'call', 'employment', 'peacekeeping', 'force']",3.0,4,4402,2768,1634,2669956
3435,"['kedo', 'spokesman', 'poland', 'rico', 'say', 'executive', 'board', 'decide', 'refer', 'question', 'capital']","['executive', 'board', 'decide', 'refer', 'capital', 'organ', 'energy', 'development', 'organization', 'say']",4.0,6,5068,4651,417,173889
3436,"['benchmark', 'treasury', 'year', 'note', 'gain', 'yield', 'percent']","['benchmark', 'year', 'note', 'recently', 'yield', 'percent']",2.75,5,4901,2569,2332,5438224
3437,"['prosecutor', 'face', 'ask', 'topsy', 'report', 'seal', 'portion', 'longer', 'peterson', 'topsy', 'report', 'favorable', 'defense', 'lean', 'medium']","['ask', 'topsy', 'report', 'seal', 'portion', 'topsy', 'report', 'peterson', 'unborn', 'son', 'favorable', 'defense', 'lean', 'medium']",4.0,10,5595,4650,945,893025
3438,"['volume', 'moderate', 'million', 'share', 'million', 'point', 'tuesday']","['volume', 'come', 'million', 'share', 'million', 'point', 'wednesday']",1.5,4,4403,1445,2958,8749764
3439,"['penn', 'traffic', 'stock', 'close', 'cent', 'share', 'wednesday', 'nasdaq', 'cent']","['penn', 'traffic', 'stock', 'close', 'wednesday', 'cent', 'cent', 'percent', 'tuesday', 'close']",3.75,6,5016,4021,995,990025
3440,"['hotly', 'contest', 'legislation', 'change', 'state', 'takeover', 'law', 'help', 'michigan', 'base', 'development', 'company', 'end', 'takeover', 'clear', 'state', 'senate', 'thursday']","['legislation', 'change', 'state', 'takeover', 'law', 'help', 'bloomfield', 'hills', 'base', 'cabman', 'centers', 'end', 'billion', 'takeover', 'win', 'committee', 'approval', 'tuesday']",2.75,8,5415,2563,2852,8133904
3441,"['union', 'include', 'powerful', 'cgt', 'remain', 'opposed', 'reform', 'demand', 'government', 'begin', 'fresh', 'negotiation']","['powerful', 'cgt', 'union', 'remain', 'opposed', 'plan', 'demand', 'government', 'negotiate', 'reform']",4.0,8,5423,4690,733,537289
3442,"['family', 'own', 'cheetah', 'strip', 'club', 'begin']","['search', 'conduct', 'simultaneously', 'maid', 'strip', 'club', 'diego', 'begin']",1.5,3,2765,1446,1319,1739761
3443,"['new', 'bill', 'dedicate', 'cover', 'percent', 'drug', 'cost']","['senior', 'responsible', 'percent', 'drug', 'cost', 'pocket', 'total', 'reach']",1.7999999523162842,3,2738,1631,1107,1225449
3444,"['thousand', 'rd', 'infantry', 'troop', 'include', 'rd', 'brigade', 'combat', 'team', 'base', 'sort', 'running', 'columbus', 'begin', 'return', 'week']","['thousand', 'troop', 'division', 'rd', 'brigade', 'combat', 'team', 'base', 'sort', 'running', 'columbus', 'begin', 'return', 'week', 'flight', 'continue', 'friday']",4.0,13,5718,4649,1069,1142761
3445,"['prairie', 'dog', 'sell', 'exotic', 'pet', 'believe', 'infect', 'illinois', 'pet', 'shop', 'gambian', 'giant', 'rat', 'import', 'africa']","['prairie', 'dog', 'believe', 'infect', 'pet', 'shop', 'gambian', 'rat', 'import', 'africa']",3.5999999046325684,10,5577,3927,1650,2722500
3446,"['defense', 'appeal', 'house', 'ruling', 'trial']","['defense', 'lawyer', 'appeal', 'ruling', 'trial', 'appellate', 'court']",3.400000095367432,4,4377,3571,806,649636
3447,"['committee', 'appoint', 'defense', 'secretary', 'donald', 'rumsfeld', 'order', 'congress']","['public', 'hearing', 'second', 'panel', 'create', 'defense', 'secretary', 'donald', 'rumsfeld', 'pressure', 'congress']",2.5999999046325684,5,4916,2464,2452,6012304
3448,"['indiana', 'rank', 'mccloskey', 'die', 'sunday', 'bloomington', 'battle', 'bladder', 'cancer']","['mccloskey', 'die', 'sunday', 'afternoon', 'home', 'year', 'long', 'battle', 'bladder', 'cancer']",3.25,6,5023,3333,1690,2856100
3449,"['hospital', 'red', 'cross', 'appeal', 'blood', 'donor', 'yesterday']","['connecticut', 'hospital', 'association', 'join', 'red', 'cross', 'monday', 'call', 'blood', 'donor']",3.75,5,4943,4031,912,831744
3450,"['mexico', 'wish', 'guarantee', 'citizen', 'safety']","['mexico', 'wish', 'avoid', 'violence']",4.0,2,1946,4634,-2688,7225344
3451,"['spain', 'currently', 'hold', 'rotate', 'presidency']","['spain', 'currently', 'hold', 'presidency']",4.199999809265137,4,4362,4840,-478,228484
3452,"['treaty', 'sign']","['cf', 'treaty', 'sign']",4.199999809265137,2,1936,4839,-2903,8427409
3453,"['gorgich', 'pashtoon', 'execute', 'prison']","['gorgich', 'pashtoon', 'execute', 'traffic', 'heroin', 'sister', 'baluchestan', 'province']",3.200000047683716,3,2729,3140,-411,168921
3454,"['safe', 'bourada', 'sentence', 'year', 'prison']","['james', 'badaoui', 'sentence', 'year']",0.6000000238418579,2,1934,632,1302,1695204
3455,"['santo', 'state', 'radioactive', 'material', 'primary', 'basis', 'generation', 'crude', 'weapon', 'mass', 'destruction', 'terrorist']","['cranium', 'radioactive', 'material', 'primary', 'basis', 'generation', 'dirty', 'weapon', 'mass', 'destruction', 'terrorist']",3.5999999046325684,9,5560,3899,1661,2758921
3456,"['fulfil', 'berghella', 'state', 'digital', 'worm', 'name', 'sq', 'hell', 'particularly', 'virulent', 'implicate', 'rate', 'time', 'hour']","['fulfil', 'berghella', 'state', 'digital', 'worm', 'name', 'sq', 'hell', 'high', 'capacity', 'delicate', 'digital', 'worm', 'name', 'sq', 'hell', 'slow', 'post', 'italian', 'computer', 'network', 'make', 'computer', 'inoperable']",3.5999999046325684,8,5360,3898,1462,2137444
3457,"['sober', 'state', 'large', 'interest', 'intellectual', 'property', 'right', 'year', 'ago']","['sober', 'state', 'nation', 'strong', 'intellectual', 'property', 'right']",2.0,5,4937,1857,3080,9486400
3458,"['investigator', 'claim', 'british', 'company', 'cover']","['russian', 'investigator', 'state', 'british', 'company', 'cover']",4.400000095367432,4,4353,5085,-732,535824
3459,"['russia', 'naso', 'member', 'country', 'hold', 'meeting', 'fall', 'conventional', 'force', 'europe', 'treaty', 'cf']","['russian', 'parliament', 'vote', 'unanimously', 'suspend', 'russia', 'participation', 'conventional', 'force', 'europe', 'cf', 'treaty']",1.399999976158142,6,5108,1329,3779,14280841
3460,"['united', 'states', 'government', 'naso', 'member', 'refuse', 'ratify', 'amend', 'treaty', 'official', 'moscow', 'withdraw', 'troop', 'soviet', 'republic', 'moldavia', 'georgia']","['united', 'states', 'naso', 'member', 'refuse', 'ratify', 'amend', 'treaty', 'russia', 'completely', 'withdraw', 'moldavia', 'georgia']",4.599999904632568,11,5695,5265,430,184900
3461,"['russia', 'immediately', 'increase', 'military', 'strength', 'russian', 'border']","['russia', 'hesitate', 'increase', 'military', 'strength', 'russian', 'border', 'need', 'arise']",2.0,6,5114,1852,3262,10640644
3462,"['center', 'operational', 'august']","['center', 'formally', 'open']",2.200000047683716,1,932,2105,-1173,1375929
3463,"['brazilian', 'police', 'surround', 'slum', 'north', 'rio', 'de', 'janeiro', 'rid', 'violent', 'drug', 'trafficker']","['police', 'officer', 'surround', 'slum', 'north', 'rio', 'de', 'janeiro', 'rid', 'violent', 'drug', 'trafficker', 'seize', 'weapon', 'drug']",3.799999952316284,11,5694,4318,1376,1893376
3464,"['regional', 'international', 'non', 'proliferation', 'issue', 'address', 'dialogue', 'negotiation']","['second', 'proposal', 'regional', 'international', 'non', 'proliferation', 'issue', 'address', 'dialogue', 'negotiation']",3.5999999046325684,8,5365,3895,1470,2160900
3465,"['come', 'occur', 'afghanistan', 'attack', 'anti', 'government', 'insurgent', 'increase', 'recent', 'day']","['coming', 'occur', 'afghanistan', 'police', 'state', 'responsible']",2.5999999046325684,2,1932,2514,-582,338724
3466,"['georgian', 'government', 'webster', 'intense', 'saber', 'attack', 'follow', 'russian', 'military', 'strike', 'georgia', 'late', 'week']","['saber', 'attack', 'follow', 'russian', 'military', 'strike', 'launch', 'georgia', 'late', 'week']",4.800000190734863,9,5526,5352,174,30276
3467,"['switzerland', 'trade', 'diplomatic', 'relation', 'ran', 'criticize', 'recent', 'month', 'foreign', 'minister', 'micheline', 'calm', 'red', 'travel', 'march', 'sign', 'deal', 'ran', 'state', 'gas', 'firm']","['switzerland', 'trade', 'diplomatic', 'relation', 'islamic', 'republic', 'criticize', 'recent', 'month', 'foreign', 'minister', 'micheline', 'calm', 'red', 'travel', 'march', 'sign', 'gas', 'deal']",3.799999952316284,17,5746,4319,1427,2036329
3468,"['conventional', 'force', 'europe', 'treaty', 'limit', 'number', 'military', 'aircraft', 'tank', 'non', 'nuclear', 'heavy', 'weapon', 'europe']","['conventional', 'force', 'europe', 'treaty', 'sign', 'russian', 'naso', 'member']",2.799999952316284,4,4359,2588,1771,3136441
3469,"['african', 'union', 'propose', 'peacekeeping', 'mission', 'help', 'somalia', 'struggle', 'transitional', 'government', 'stability', 'somalia']","['african', 'union', 'propose', 'peacekeeping', 'mission', 'aid', 'struggle', 'transitional', 'government', 'stabilize', 'somalia', 'particularly', 'withdrawal', 'ethiopian', 'force']",3.5999999046325684,9,5528,3894,1634,2669956
3470,"['report', 'state', 'syrian', 'government', 'conceal', 'nuclear', 'facility', 'attack', 'site']","['expert', 'begin', 'analyze', 'report', 'state', 'syrian', 'government', 'conceal', 'nuclear', 'facility', 'attack', 'site']",4.199999809265137,9,5529,4852,677,458329
3471,"['drug', 'know', 'ice', 'shall']","['methamphetamine', 'know', 'ice']",3.400000095367432,2,1929,3618,-1689,2852721
3472,"['national', 'regional', 'international', 'effort', 'end', 'illicit', 'trade', 'small', 'arm', 'light', 'weapon']","['global', 'community', 'cooperate', 'end', 'illicit', 'trade', 'small', 'arm', 'light', 'weapon']",4.0,7,5353,4363,990,980100
3473,"['religious', 'extremist', 'continue', 'parisian', 'despite', 'banking', 'militant', 'group']","['religious', 'extremist', 'continue', 'parisian', 'despite', 'banking', 'militant', 'group', 'pakistani', 'government']",4.0,8,5377,4360,1017,1034289
3474,"['russian', 'official', 'call', 'conference', 'conventional', 'force', 'europe', 'treaty', 'discuss', 'ratification', 'amend', 'treaty']","['antonov', 'speak', 'day', 'conference', 'conventional', 'force', 'europe', 'treaty']",3.200000047683716,5,4923,3129,1794,3218436
3475,"['russian', 'president', 'sign', 'decree', 'suspend', 'russia', 'application', 'european', 'arm', 'control', 'treaty']","['president', 'vladimir', 'sign', 'decree', 'suspend', 'russia', 'participation', 'conventional', 'force', 'europe', 'treaty']",4.400000095367432,6,5127,5023,104,10816
3476,"['myanmar', 'know', 'bursa']","['myanmar', 'call', 'bursa']",5.0,2,1928,5732,-3804,14470416
3477,"['huallaga', 'locate', 'northeast', 'capital', 'limb']","['porto', 'habea', 'locate', 'km', 'northeast', 'manage', 'nicaragua']",0.0,2,1926,173,1753,3073009
3478,"['naso', 'regret', 'russia', 'decision', 'suspend', 'participation', 'cf']","['russia', 'decision', 'suspend', 'participation', 'cf', 'step', 'wrong', 'direction']",3.799999952316284,5,4922,4309,613,375769
3479,"['human', 'right', 'violation', 'myanmar', 'include', 'summary', 'execution', 'torture', 'recruitment', 'child', 'soldier']","['human', 'right', 'violation', 'include', 'summary', 'execution', 'torture', 'recruitment', 'child']",4.199999809265137,9,5538,4854,684,467856
3480,"['general', 'nikolski', 'yakov', 'state', 'telephone', 'state', 'scientific', 'center', 'apply', 'microbiology', 'reliable', 'system', 'protection', 'case', 'emergency']","['general', 'nikolski', 'yakov', 'longtime', 'director', 'state', 'scientific', 'center', 'applied', 'microbiology']",2.400000095367432,7,5348,2235,3113,9690769
3481,"['competition', 'japanese', 'german', 'country', 'contract']","['compete', 'japanese', 'company', 'shinkansen', 'german', 'company', 'ice', 'contract']",3.5999999046325684,3,2774,3881,-1107,1225449
3482,"['legislation', 'recent', 'effort', 'japan', 'ascribe', 'freedom', 'tightly', 'control', 'military', 'overturn', 'ban', 'military', 'use', 'space']","['legislation', 'recent', 'effort', 'japan', 'ascribe', 'freedom', 'tightly', 'control', 'military', 'technically', 'know', 'self', 'defense', 'force']",3.799999952316284,9,5530,4266,1264,1597696
3483,"['south', 'launch', 'new', 'bullet', 'train', 'reach']","['south', 'bullet', 'train', 'system']",2.0,3,2777,1860,917,840889
3484,"['russia', 'member', 'quarter', 'middle', 'east']","['russia', 'member', 'nag']",2.200000047683716,2,1902,2005,-103,10609
3485,"['anatole', 'sokolov', 'soviet', 'build', 'missile', 'defense', 'system', 'moscow', 'obsolete', 'efficient']","['soviet', 'build', 'missile', 'defense', 'system', 'moscow', 'obsolete', 'efficient']",4.599999904632568,8,5459,5262,197,38809
3486,"['deal', 'process', 'year']","['idea', 'investigation', 'run', 'nuclear', 'activity', 'year']",0.6000000238418579,1,828,642,186,34596
3487,"['adherence', 'non', 'proliferation', 'obligation', 'enhance', 'mutual', 'trust', 'foster', 'international', 'cooperation', 'nuclear', 'energy']","['hang', 'state', 'country', 'abide', 'non', 'proliferation', 'obligation', 'order', 'enhance', 'mutual', 'trust', 'create', 'sound', 'environment', 'international', 'cooperation', 'nuclear', 'energy']",3.200000047683716,10,5583,3164,2419,5851561
3488,"['french', 'energy', 'transport', 'company', 'sign', 'contract', 'build', 'high', 'speed', 'rail', 'link', 'shanghai']","['sign', 'contract', 'build', 'high', 'speed', 'rail', 'link', 'shanghai']",4.0,8,5469,4374,1095,1199025
3489,"['drug', 'integral', 'decade']","['drug', 'form', 'year']",2.0,1,830,1781,-951,904401
3490,"['international', 'atomic', 'energy', 'agency', 'reach', 'agreement', 'italian', 'official', 'state', 'remain', 'issue', 'ambiguity', 'ran', 'nuclear', 'program', 'activity']","['accord', 'say', 'remain', 'issue', 'ambiguity', 'ran', 'nuclear', 'program', 'activity']",3.400000095367432,7,5317,3666,1651,2725801
3491,"['police', 'apprehend', 'people', 'include', 'foreigner', 'suspicion', 'traffic', 'drug', 'pus', 'popular', 'downtown', 'area']","['police', 'apprehend', 'people', 'suspicion', 'traffic', 'drug', 'downtown', 'bar']",3.799999952316284,7,5331,4246,1085,1177225
3492,"['russia', 'ratify', 'update', 'treaty', 'united', 'states', 'naso', 'member', 'refuse', 'argue', 'moscow', 'fulfill', 'obligation', 'withdraw', 'force', 'georgia', 'moldavia', 'separatist', 'region', 'trans', 'dnieper']","['russia', 'ratify', 'amend', 'version', 'united', 'states', 'naso', 'member', 'refuse', 'russian', 'government', 'withdraw', 'troop', 'soviet', 'republic', 'moldavia', 'georgia']",4.199999809265137,10,5585,4808,777,603729
3493,"['conflicting', 'opinion', 'extent', 'damage', 'suffer', 'insurgency']","['violence', 'continue', 'despite', 'conflict', 'opinion', 'extent', 'damage', 'suffer', 'rebel', 'group']",3.200000047683716,4,4365,3161,1204,1449616
3494,"['demand', 'province', 'world', 'large', 'opium', 'produce', 'region']","['demand', 'province', 'world', 'large', 'producer', 'opium']",5.0,5,4845,5733,-888,788544
3495,"['police', 'state', 'tsar', 'wen', 'hung', 'extract', 'taiwan']","['police', 'state', 'hung', 'run']",1.7999999523162842,3,2794,1706,1088,1183744
3496,"['individual', 'arrest', 'release']","['zambian', 'arrest', 'juvenile']",1.600000023841858,1,831,1473,-642,412164
3497,"['mexican', 'president', 'elope', 'caldron', 'send', 'special', 'agent', 'soldier', 'sinaloa', 'high', 'degree', 'organized', 'crime', 'drug', 'trafficking']","['mexican', 'president', 'elope', 'caldron', 'send', 'special', 'agent', 'soldier', 'sinaloa', 'fight', 'drug', 'trafficking']",4.599999904632568,11,5683,5261,422,178084
3498,"['berlin', 'host', 'level', 'meeting', 'october', 'save', 'key', 'european', 'arm', 'control', 'treaty', 'conventional', 'force', 'europe', 'cf']","['russia', 'suspend', 'participation', 'key', 'european', 'arm', 'control', 'treaty', 'govern', 'employment', 'troop', 'europe']",1.7999999523162842,6,5101,1707,3394,11519236
3499,"['meeting', 'last', 'day']","['meeting', 'hold', 'madrid']",1.7999999523162842,1,832,1708,-876,767376
3500,"['cf', 'treaty', 'sign']","['cf', 'treaty', 'establish']",4.800000190734863,2,1873,5363,-3490,12180100
3501,"['run', 'insist', 'program', 'aim', 'solely', 'peaceful', 'pursuit', 'generation']","['run', 'insist', 'nuclear', 'program', 'peaceful', 'purpose']",4.400000095367432,4,4368,5040,-672,451584
3502,"['china', 'important', 'force', 'safeguard', 'world', 'peace']","['china', 'important', 'force', 'promote', 'world', 'development']",3.400000095367432,4,4370,3653,717,514089
3503,"['north', 'deny', 'involvement', 'nuclear', 'program', 'syria']","['north', 'deny', 'involvement', 'syrian', 'nuclear', 'project']",4.400000095367432,4,4371,5038,-667,444889
3504,"['spokesman', 'stockwell', 'day', 'immediately', 'available']","['chinese', 'authority', 'immediately', 'available', 'comment']",1.2000000476837158,2,1872,1206,666,443556
3505,"['long', 'cool', 'warn', 'interaction', 'north', 'organ', 'vessel', 'north', 'organ', 'government', 'retaliate', 'nuclear', 'missile', 'attack', 'major', 'city', 'new', 'york', 'washington']","['long', 'cool', 'state', 'north', 'retaliate', 'nuclear', 'missile', 'attack', 'major', 'city', 'new', 'york', 'washington']",3.799999952316284,12,5714,4282,1432,2050624
3506,"['run', 'prolific', 'apply', 'death', 'penalty', 'world', 'china']","['islamic', 'republic', 'prolific', 'apply', 'death', 'penalty', 'world', 'china']",3.799999952316284,6,5128,4275,853,727609
3507,"['john', 'duncan', 'great', 'britain', 'ambassador', 'multilateral', 'arm', 'control', 'disarmament']","['un', 'assembly', 'chinese', 'government', 'urge', 'increase', 'effort', 'global', 'arm', 'control', 'disarmament']",1.399999976158142,3,2664,1321,1343,1803649
3508,"['treaty', 'amend', 'collapse', 'soviet', 'union']","['treaty', 'amend', 'reflect', 'change', 'soviet', 'breakup']",4.0,3,2666,4493,-1827,3337929
3509,"['kashmir', 'divide', 'india', 'parisian']","['kashmir', 'claim', 'india', 'parisian']",4.400000095367432,3,2646,5026,-2380,5664400
3510,"['south', 'israel', 'oppose', 'proliferation', 'weapon', 'mass', 'destruction', 'arm', 'race']","['china', 'resolutely', 'oppose', 'proliferation', 'mass', 'destructive', 'weapon']",1.399999976158142,4,4373,1344,3029,9174841
3511,"['kadhafi', 'warn', 'britain', 'failure', 'compensate', 'tibia', 'nuclear', 'disarmament', 'deter', 'run', 'north', 'discard']","['western', 'country', 'failure', 'sufficiently', 'compensate', 'tibia', 'deter', 'run', 'north', 'discard']",3.400000095367432,7,5319,3624,1695,2873025
3512,"['russia', 'ratify', 'amend', 'treaty']","['russia', 'ratify', 'update', 'treaty']",3.400000095367432,3,2648,3625,-977,954529
3513,"['staff', 'specialist', 'conduct', 'research', 'training', 'saber', 'warfare', 'prepare', 'assist', 'naso', 'member', 'response', 'future', 'saber', 'attack']","['staff', 'specialist', 'conduct', 'research', 'training', 'saber', 'warfare']",3.400000095367432,7,5316,3626,1690,2856100
3514,"['jamais', 'island', 'youth', 'wing', 'stage', 'separate', 'demonstration', 'kashmir']","['jamais', 'island', 'youth', 'wing', 'demonstration', 'attack', 'ran']",3.0,5,4887,2787,2100,4410000
3515,"['run', 'prolific', 'apply', 'death', 'penalty', 'world', 'china']","['islamic', 'republic', 'prolific', 'apply', 'death', 'penalty', 'world', 'china']",3.799999952316284,6,5070,4276,794,630436
3516,"['china', 'resolutely', 'oppose', 'mean', 'delivery', 'mass', 'destructive', 'weapon']","['china', 'oppose', 'proliferation', 'weapon', 'mass', 'destruction']",4.400000095367432,4,4292,5071,-779,606841
3517,"['breakdown', 'order', 'china', 'lead', 'significant', 'global', 'turmoil']","['breakdown', 'order', 'china', 'bad', 'afghanistan', 'jugoslavia']",3.400000095367432,3,2704,3629,-925,855625
3518,"['north', 'claim', 'nuclear', 'ambition', 'currently', 'north', 'report', 'missile', 'aim', 'japan']","['north', 'boast', 'nuclear', 'ambition', 'north', 'report', 'missile', 'train']",4.0,5,4861,4469,392,153664
3519,"['abuse', 'capital']","['tskhinvali', 'capital', 'georgia']",0.800000011920929,1,833,753,80,6400
3520,"['united', 'states', 'government', 'accuse', 'italian', 'government', 'try', 'develop', 'nuclear', 'weapon', 'cover', 'civilian', 'nuclear', 'program']","['ally', 'accuse', 'run', 'attempt', 'develop', 'nuclear', 'weapon', 'guise', 'civilian', 'nuclear', 'program']",4.599999904632568,6,5112,5259,-147,21609
3521,"['tyrant', 'capital']","['abuse', 'capital']",1.0,1,842,950,-108,11664
3522,"['armed', 'clash', 'italian', 'police', 'kill', 'allege', 'drug', 'trafficker', 'arrest', 'seize', 'nearly', 'merit', 'ton', 'opium', 'morphin']","['armed', 'clash', 'southwestern', 'run', 'police', 'seize', 'nearly', 'merit', 'ton', 'ton', 'opium', 'morphin']",3.200000047683716,9,5502,3153,2349,5517801
3523,"['ran', 'nuclear', 'project', 'peaceful', 'purpose']","['run', 'insist', 'nuclear', 'program', 'peaceful', 'purpose']",3.5999999046325684,3,2701,3913,-1212,1468944
3524,"['china', 'resolutely', 'oppose', 'proliferation', 'mass', 'destructive', 'weapon']","['china', 'resolutely', 'oppose', 'mean', 'delivery', 'mass', 'destructive', 'weapon']",4.199999809265137,6,5073,4822,251,63001
3525,"['china', 'north', 'close', 'ally']","['north', 'exclusive', 'state']",1.2000000476837158,1,836,1224,-388,150544
3526,"['libyan', 'foreign', 'minister', 'abel', 'roman', 'amalgam', 'visit', 'london', 'visit', 'libyan', 'foreign', 'minister']","['amalgam', 'visit', 'london', 'libyan', 'foreign', 'minister']",4.199999809265137,6,5102,4818,284,80656
3527,"['state', 'present', 'major', 'threat', 'global', 'security']","['present', 'major', 'threat', 'global', 'security']",3.5999999046325684,5,4881,3911,970,940900
3528,"['cambodia', 'vienna', 'penalize', 'agreement', 'stop', 'asia', 'european', 'drug', 'trafficker']","['syrian', 'russian', 'official', 'sign', 'agreement', 'cooperation', 'combat', 'drug', 'trafficking']",2.0,2,1868,1878,-10,100
3529,"['activist', 'state', 'russia', 'imprison', 'people', 'evidence', 'illegal', 'activity']","['russia', 'imprison', 'people', 'evidence', 'illegal', 'activity']",4.199999809265137,6,5094,4860,234,54756
3530,"['restrain', 'extremist', 'group', 'increasingly', 'difficult', 'group', 'finance']","['bruguiere', 'restrain', 'extremist', 'group', 'particularly', 'europe', 'increasingly', 'difficult', 'group', 'finance']",3.799999952316284,6,5116,4269,847,717409
3531,"['labor', 'town', 'southwestern', 'ran']","['khoramabad', 'city', 'western', 'ran']",1.2000000476837158,1,837,1243,-406,164836
3532,"['detain', 'accuse', 'homicidal', 'criminal', 'collaboration', 'kidnapping', 'funding', 'terrorist', 'include', 'member', 'military', 'police']","['iguaran', 'state', 'detain', 'accuse', 'homicidal', 'criminal', 'collaboration', 'kidnapping', 'funding', 'terrorist']",3.25,8,5466,3342,2124,4511376
3533,"['exist', 'rod', 'produce', 'atomic', 'bomb', 'month']","['expert', 'state', 'rod', 'produce', 'atomic', 'bomb', 'month']",4.199999809265137,5,4873,4900,-27,729
3534,"['international', 'atomic', 'energy', 'agency', 'trick', 'eager', 'deal']","['international', 'atomic', 'energy', 'agency', 'plan', 'draw', 'negotiation', 'month']",2.400000095367432,4,4213,2254,1959,3837681
3535,"['myanmar', 'government', 'state', 'myanmar', 'opium', 'free']","['myanmar', 'government', 'state', 'myanmar', 'track', 'drug', 'free']",4.599999904632568,4,4214,5258,-1044,1089936
3536,"['jewish', 'american', 'group', 'anti', 'defamation', 'league', 'publish', 'page', 'advertisement', 'swiss', 'international', 'paper', 'april', 'accuse', 'switzerland', 'funding', 'terrorist', 'deal']","['anti', 'defamation', 'league', 'take', 'page', 'advertisement', 'swiss', 'international', 'newspaper', 'early', 'april', 'accuse', 'switzerland', 'funding', 'terrorist', 'deal']",4.400000095367432,13,5727,5050,677,458329
3537,"['france', 'provide', 'ricket', 'gun', 'engine']","['britain', 'provide', 'fuel', 'tank', 'gearbox']",1.7999999523162842,1,838,1674,-836,698896
3538,"['capital', 'offense', 'say', 'arabia', 'include', 'rape', 'murder', 'apostasy', 'armed', 'robbery', 'drug', 'trafficking']","['capital', 'offence', 'ran', 'include', 'murder', 'rape', 'armed', 'robbery', 'drug', 'trafficking', 'adultery']",3.200000047683716,8,5437,3215,2222,4937284
3539,"['system', 'large', 'defense', 'company']","['system', 'large', 'military']",3.400000095367432,2,1862,3639,-1777,3157729
3540,"['uvarov', 'tell', 'secretary', 'state', 'condoleezza', 'rice', 'russia', 'remain', 'open', 'dialogue']","['secretary', 'state', 'condoleezza', 'rice', 'demand', 'russia', 'withdraw', 'force']",2.799999952316284,5,4867,2639,2228,4963984
3541,"['additional', 'individual', 'entitle', 'subject', 'asset', 'freeze']","['resolution', 'include', 'broaden', 'list', 'individual', 'entitle', 'subject', 'asset', 'freeze']",3.799999952316284,5,4865,4259,606,367236
3542,"['withdrawal', 'treaty', 'allow', 'russia', 'bolster', 'force', 'near', 'russian', 'border']","['withdrawal', 'conventional', 'force', 'europe', 'treaty', 'allow', 'russia', 'bolster', 'force', 'near', 'russian', 'border']",3.400000095367432,9,5479,3636,1843,3396649
3543,"['fan', 'state', 'commission', 'primarily', 'concerned', 'term', 'future', 'investment', 'taiwan']","['fan', 'state', 'commission', 'ensure', 'commitment', 'uphold', 'investment', 'way']",1.7999999523162842,4,4218,1680,2538,6441444
3544,"['government', 'spokesman', 'mask', 'state', 'administrative', 'paper', 'order', 'government', 'south', 'africa', 'intervene', 'prevent', 'weapon', 'transport', 'territory', 'neighboring', 'padlock', 'country']","['spokesman', 'mask', 'state', 'long', 'administrative', 'paper', 'order', 'south', 'africa', 'intervene', 'prevent', 'weapon', 'transport', 'south', 'african', 'territory', 'zimbabwe']",2.799999952316284,13,5725,2640,3085,9517225
3545,"['president', 'dmitri', 'medvedev', 'statement', 'post', 'kremlin', 'webster', 'carry', 'state', 'news', 'agency']","['statement', 'post', 'kremlin', 'web', 'site', 'carry', 'state', 'news', 'agency']",3.200000047683716,7,5255,3149,2106,4435236
3546,"['turkmenistan', 'borders', 'afghanistan']","['sister', 'baluchestan', 'border', 'afghanistan', 'parisian']",1.7999999523162842,1,841,1682,-841,707281
3547,"['number', 'execution', 'increase', 'run', 'year', 'amid', 'campaign', 'aim', 'improve', 'security', 'society']","['number', 'execution', 'increase', 'dramatically', 'amid', 'campaign', 'italian', 'authority', 'state', 'aim', 'improve', 'security', 'society']",3.400000095367432,9,5484,3452,2032,4129024
3548,"['syria', 'deny', 'have', 'declare', 'nuclear', 'program']","['syria', 'deny', 'existence', 'declare', 'nuclear', 'program']",5.0,5,4862,5736,-874,763876
3549,"['amnesty', 'international', 'right', 'group', 'base', 'london']","['international', 'institute', 'strategic', 'study', 'locate', 'london']",1.399999976158142,2,1860,1351,509,259081
3550,"['number', 'tabulate', 'asp', 'count', 'comply', 'press', 'witness', 'report']","['number', 'execution', 'ran', 'calculate', 'asp', 'count', 'comply', 'press', 'report']",2.200000047683716,6,5054,2027,3027,9162729
3551,"['italian', 'government', 'italian', 'nuclear', 'program', 'remain', 'peaceful']","['italian', 'government', 'say', 'nuclear', 'program', 'peaceful']",5.0,5,4888,5738,-850,722500
3552,"['shingarev', 'say', 'difficult', 'nuclear', 'weapon', 'plutonium', 'fuel']","['donohue', 'say', 'difficult', 'manipulate', 'radioactive', 'isotope', 'leave', 'trail']",0.6000000238418579,2,1859,659,1200,1440000
3553,"['paris', 'capital', 'france']","['limb', 'capital']",0.6000000238418579,1,834,622,212,44944
3554,"['indian', 'government', 'official', 'speak', 'condition', 'anonymity']","['official', 'speak', 'condition', 'anonymity']",3.400000095367432,4,4225,3459,766,586756
3555,"['russia', 'threaten', 'time', 'withdraw', 'cf', 'odd', 'united', 'states', 'plan', 'install', 'missile', 'defense', 'shield', 'eastern']","['russia', 'repeatedly', 'threaten', 'withdrawal', 'cf', 'opposition', 'plan', 'extension', 'missile', 'defense', 'shield', 'eastern', 'europe']",4.599999904632568,8,5451,5257,194,37636
3556,"['plan', 'tunica', 'creation', 'electronic', 'database', 'facilitate', 'tax', 'collection']","['plan', 'siberia', 'mozambique', 'creation', 'electronic', 'database', 'real', 'estate']",1.7999999523162842,4,4226,1685,2541,6456681
3557,"['china', 'praise', 'international', 'community', 'effort', 'resolve', 'organ', 'peninsula', 'nuclear', 'issue']","['china', 'praise', 'especially', 'asia', 'pacific', 'state', 'effort', 'resolve', 'organ', 'peninsula', 'nuclear', 'issue']",4.199999809265137,8,5450,4878,572,327184
3558,"['russian', 'foreign', 'ministry', 'state', 'russia', 'suspend', 'dialogue']","['russian', 'official', 'state', 'russia', 'reconsider', 'suspension']",2.5999999046325684,3,3077,2384,693,480249
3559,"['arm', 'smuggler', 'drug', 'carter', 'eliminate', 'southeast', 'asia']","['arm', 'smuggler', 'drug', 'carter', 'aet', 'terrorist']",2.799999952316284,4,4228,2646,1582,2502724
3560,"['new', 'law', 'attempt', 'remove', 'legal', 'obstacle', 'build', 'advanced', 'spy', 'satellite', 'help', 'innovation', 'japan', 'space', 'industry']","['purpose', 'new', 'law', 'remove', 'legal', 'obstacle', 'build', 'advanced', 'spy', 'satellite', 'encourage', 'innovation', 'japan', 'space', 'industry']",4.800000190734863,13,5724,5360,364,132496
3561,"['hang', 'china', 'oppose', 'restrict', 'peaceful', 'use', 'nuclear', 'energy', 'non', 'nuclear', 'weapon', 'state', 'basis', 'non', 'proliferation', 'peaceful', 'use', 'nuclear', 'energy', 'crucial', 'objective']","['hang', 'state', 'china', 'oppose', 'non', 'proliferation', 'pretext', 'restrict', 'deprive', 'non', 'nuclear', 'weapon', 'state', 'right', 'peaceful', 'use', 'nuclear', 'energy']",4.400000095367432,12,5699,5045,654,427716
3562,"['non', 'proliferation', 'expert', 'international', 'institute', 'strategic', 'study', 'mark', 'fitzpatrick', 'state', 'idea', 'report', 'unusually', 'strong', 'tenor']","['senior', 'fellow', 'international', 'institute', 'strategic', 'study', 'mark', 'fitzpatrick', 'state', 'international', 'atomic', 'energy', 'agency', 'plan', 'superficial']",4.0,7,5287,4461,826,682276
3563,"['treaty', 'limit', 'number', 'aircraft', 'tank', 'non', 'nuclear', 'heavy', 'weapon', 'europe']","['conventional', 'force', 'europe', 'treaty', 'limit', 'number', 'military', 'aircraft', 'tank', 'non', 'nuclear', 'heavy', 'weapon', 'europe']",4.199999809265137,10,5593,4907,686,470596
3564,"['esthonia', 'official', 'state', 'saber', 'attack', 'cause', 'esthonia', 'government', 'webster', 'shut', 'temporarily', 'come', 'computer', 'administration', 'russia', 'include', 'office', 'president', 'vladimir']","['official', 'esthonia', 'include', 'prime', 'minister', 'andros', 'anti', 'claim', 'saber', 'attack', 'come', 'russian', 'government', 'computer', 'include', 'computer', 'office', 'russian', 'president', 'vladimir']",3.799999952316284,11,5687,4301,1386,1920996
3565,"['britain', 'strike', 'agreement', 'supply', 'say', 'arabia', 'typhoid', 'jet', 'deal', 'worth', 'estimate', 'billion', 'pound', 'billion', 'dollar']","['agree', 'supply', 'say', 'arabia', 'typhoid', 'jet', 'deal', 'worth', 'estimate', 'billion', 'pound', 'approximately', 'billion', 'dollar', 'defense', 'company', 'system']",3.200000047683716,11,5690,3155,2535,6426225
3566,"['opium', 'raw', 'ingredient', 'heroin']","['copy', 'yield', 'raw', 'ingredient', 'heroin']",3.400000095367432,3,3083,3469,-386,148996
3567,"['sung', 'law', 'refuse', 'detail', 'north', 'organ', 'nuclear', 'reactor', 'project']","['south', 'far', 'take', 'cautious', 'stance', 'issue', 'north', 'organ', 'nuclear', 'reactor', 'project']",3.0,5,5013,3032,1981,3924361
3568,"['agreement', 'aim', 'establish', 'wide', 'cooperation', 'cover', 'national', 'security', 'fight', 'global', 'terrorist']","['statement', 'british', 'ministry', 'defense', 'agreement', 'aim', 'establish', 'wide', 'cooperation', 'cover', 'national', 'security', 'fight', 'global', 'terrorist']",3.400000095367432,11,5696,3471,2225,4950625
3569,"['execute', 'ran', 'hang', 'public']","['people', 'execute', 'hang', 'public']",3.400000095367432,3,3073,3472,-399,159201
3570,"['united', 'states', 'ally', 'united', 'states', 'believe', 'run', 'pursue', 'nuclear', 'arm']","['united', 'states', 'european', 'nation', 'believe', 'ran', 'nuclear', 'project', 'purpose', 'make', 'nuclear', 'weapon']",3.799999952316284,4,4181,4302,-121,14641
3571,"['cf', 'important', 'european', 'security']","['cf', 'cornerstone', 'european', 'security']",5.0,3,3070,5748,-2678,7171684
3572,"['indian', 'troop', 'fight', 'rebel', 'kashmir', 'engage', 'massive', 'campaign', 'destroy', 'poppy', 'crop', 'region']","['indian', 'troop', 'fight', 'rebel', 'engage', 'massive', 'operation', 'destroy', 'poppy', 'crop', 'kashmir']",5.0,10,5608,5739,-131,17161
3573,"['matter', 'delicate']","['idea', 'report', 'restrict']",0.0,0,200,176,24,576
3574,"['week', 'russia', 'announce', 'suspend', 'participation', 'cf']","['naso', 'regret', 'russia', 'decision', 'suspend', 'participation', 'cf']",2.400000095367432,4,4182,2290,1892,3579664
3575,"['western', 'nation', 'naso', 'condemn', 'violence']","['western', 'nation', 'naso', 'demand', 'cease', 'fire']",3.5999999046325684,3,3068,3848,-780,608400
3576,"['indian', 'national', 'constitute', 'large', 'number', 'foreign', 'inmate', 'near', 'prison']","['drug', 'trafficker', 'foreign', 'country', 'constitute', 'large', 'percentage', 'foreign', 'inmate', 'near']",2.0,5,5011,1965,3046,9278116
3577,"['judicial', 'order', 'accuse', 'ragged', 'funding', 'terrorist']","['court', 'accuse', 'ragged', 'saddle', 'russen', 'funding', 'terrorist']",4.199999809265137,4,4184,4894,-710,504100
3578,"['myanmar', 'military', 'ruler', 'burn', 'approximately', 'million', 'dollar', 'worth', 'illegal', 'drug', 'mark', 'international', 'day', 'drug', 'abuse', 'illicit', 'trafficking']","['myanmar', 'military', 'ruler', 'incinerate', 'drug', 'mark', 'international', 'day', 'drug', 'abuse', 'illicit', 'trafficking']",3.75,10,5638,4052,1586,2515396
3579,"['italian', 'official', 'increase', 'execution', 'official', 'enforce', 'campaign', 'purportedly', 'aim', 'promote', 'virtue', 'boast', 'security', 'society']","['number', 'execution', 'increase', 'run', 'year', 'amid', 'campaign', 'aim', 'improve', 'security', 'society']",4.0,6,5100,4444,656,430336
3580,"['india', 'accuse', 'islamabad', 'funding', 'training', 'guerrilla']","['india', 'accuse', 'parisian', 'funding', 'train', 'cross', 'border', 'guerrilla']",3.0,4,4186,3016,1170,1368900
3581,"['ensue', 'battle', 'airstrike', 'kill', 'militant']","['ensue', 'battle', 'kill', 'militant']",3.5999999046325684,4,4187,3846,341,116281
3582,"['panamanian', 'foreign', 'ministry', 'communique', 'state', 'task', 'force', 'facilitate', 'technological', 'transfer', 'promote', 'biofuel', 'production', 'consumption']","['panamanian', 'foreign', 'ministry', 'communique', 'state', 'panama', 'brazil', 'sign', 'juridical', 'issue', 'treaty', 'include', 'tradition']",1.7999999523162842,5,5000,1678,3322,11035684
3583,"['vienna', 'world', 'harvest', 'drug', 'law']","['vienna', 'drug', 'law', 'world', 'strict', 'law']",4.800000190734863,4,4188,5357,-1169,1366561
3584,"['indian', 'government', 'prohibit', 'direct', 'indirect', 'export', 'import', 'item', 'material', 'good', 'technology', 'contribute', 'ran', 'enrichment', 'relate', 'processing', 'heavy', 'water', 'relate', 'activity']","['india', 'prohibit', 'direct', 'indirect', 'export', 'import', 'item', 'material', 'good', 'technology', 'contribute', 'ran', 'nuclear', 'weapon', 'delivery', 'system']",3.200000047683716,11,5689,3163,2526,6380676
3585,"['vienna', 'news', 'agency', 'report', 'ministry', 'public', 'security', 'state', 'foreigner', 'involve', 'drug', 'trafficking', 'case', 'vienna', 'come', 'law', 'cambodia', 'australia', 'china', 'united', 'states', 'taiwan']","['vienna', 'news', 'agency', 'report', 'ministry', 'public', 'security', 'state', 'police', 'admit', 'drug', 'trafficking', 'vienna', 'increase', 'action', 'prevent', 'stop', 'drug', 'trafficking', 'border', 'remain', 'limited']",3.799999952316284,10,5630,4317,1313,1723969
3586,"['saferworld', 'team', 'leader', 'transfer', 'control', 'small', 'arm', 'roy', 'sister', 'e', 'embargo', 'prohibit', 'direct', 'indirect', 'supply', 'military', 'equipment', 'use', 'myanmar']","['saferworld', 'team', 'leader', 'transfer', 'control', 'small', 'arm', 'roy', 'sister', 'state', 'e', 'embargo', 'explicitly', 'state', 'military', 'equipment', 'supply', 'directly', 'indirectly', 'use', 'myanmar']",5.0,16,5743,5740,3,9
3587,"['united', 'states', 'naso', 'member', 'refuse', 'ratify', 'amend', 'treaty']","['united', 'states', 'naso', 'member', 'refuse', 'ratify', 'update', 'cf']",3.200000047683716,6,5019,3166,1853,3433609
3588,"['cf', 'limit', 'use', 'armed', 'force', 'heavy', 'weapon', 'prescribe', 'measure', 'aim', 'confidence', 'building', 'transparent', 'cooperation', 'member', 'state']","['treaty', 'limit', 'employment', 'tank', 'troop', 'naso', 'easter', 'european', 'warsaw', 'country', 'establish', 'confidence', 'building', 'transparent', 'cooperation', 'measure', 'member']",3.799999952316284,7,5308,4304,1004,1008016
3589,"['bulgaria', 'locate', 'southwestern', 'balkan', 'peninsula']","['drug', 'traffic', 'activity', 'rampart', 'southwestern', 'balkan', 'peninsula']",1.0,3,3085,942,2143,4592449
3590,"['elbaradei', 'state', 'chance', 'build', 'security', 'middle', 'east', 'base', 'trust', 'cooperation', 'possession', 'nuclear', 'weapon']","['chance', 'build', 'security', 'middle', 'east', 'base', 'trust', 'cooperation', 'possession', 'nuclear', 'arm']",4.0,10,5624,4464,1160,1345600
3591,"['italian', 'government', 'dismiss', 'allegation', 'intelligence', 'present', 'international', 'atomic', 'energy', 'agency', 'board', 'baseless', 'intelligence', 'support', 'allegation', 'face']","['international', 'atomic', 'energy', 'agency', 'insist', 'italian', 'government', 'simple', 'denial', 'intelligence', 'present', 'international', 'atomic', 'energy', 'agency', 'board', 'good', 'allay', 'western', 'country', 'suspicion']",2.200000047683716,9,5537,1986,3551,12609601
3592,"['cf', 'treaty', 'establish']","['treat', 'originally', 'sign']",3.200000047683716,0,199,3146,-2947,8684809
3593,"['conventional', 'force', 'europe', 'treaty', 'consider', 'key', 'arm', 'control', 'treaty']","['conventional', 'force', 'europe', 'treaty', 'key', 'soviet', 'era', 'arm', 'control', 'treaty']",4.0,7,5275,4457,818,669124
3594,"['nicaragua', 'commemorate', 'anniversary', 'sandinista', 'revolution', 'top', 'dictatorship', 'anastasio', 'samoa', 'impose', 'cuban', 'style', 'dentist', 'regime']","['nicaragua', 'commemorate', 'anniversary', 'sandinista', 'revolution']",3.799999952316284,5,4968,4314,654,427716
3595,"['word', 'turkey', 'arrest', 'near', 'paris', 'suspicion', 'money', 'wandering', 'kurdistan', 'worker', 'party']","['word', 'investigation', 'france', 'suspicion', 'money', 'wandering', 'terrorist', 'organization', 'know', 'kurdistan', 'worker', 'party']",2.5999999046325684,7,5268,2377,2891,8357881
3596,"['meeting', 'last', 'day']","['meeting', 'last', 'day']",3.400000095367432,3,3086,3443,-357,127449
3597,"['villager', 'inadvertently', 'involve', 'drug', 'trafficking']","['inmate', 'serve', 'sentence', 'drug', 'trafficking']",1.399999976158142,2,1878,1276,602,362404
3598,"['russian', 'government', 'strongly', 'oppose', 'plan', 'install', 'antimissile', 'defense', 'europe', 'dismiss', 'assertion', 'interceptor', 'need', 'defend', 'threat', 'ran']","['talk', 'naso', 'headquarters', 'baluyevsky', 'repeat', 'russia', 'opposition', 'plan', 'install', 'antimissile', 'defense', 'europe', 'dismiss', 'assertion', 'interceptor', 'need', 'defend', 'potential', 'threat', 'ran']",3.200000047683716,12,5715,3135,2580,6656400
3599,"['long', 'long', 'university', 'collaborate', 'university', 'business', 'government', 'sector', 'mainland', 'china', 'coordinate', 'training', 'program', 'research', 'center', 'promote', 'high', 'teach', 'research', 'commercialization', 'technology', 'transfer']","['long', 'long', 'university', 'collaborate', 'tertiary', 'education', 'business', 'government', 'sector', 'mainland', 'china', 'direct', 'training', 'program', 'research', 'center', 'promote', 'research', 'commercialization', 'technology', 'transfer']",5.0,16,5742,5741,1,1
3600,"['chinese', 'government', 'give', 'active', 'cooperation', 'assistance', 'organization', 'prohibition', 'chemical', 'weapon', 'inspection']","['ecuadorian', 'foreign', 'ministry', 'say', 'statement', 'delegate', 'organization', 'prohibition', 'chemical', 'weapon', 'opal', 'meeting']",1.0,4,4195,938,3257,10608049
3601,"['mexican', 'government', 'adopt', 'series', 'measure', 'drug', 'trafficking', 'organize', 'crime', 'mexico']","['mexico', 'adopt', 'series', 'measure', 'drug', 'trafficking', 'organized', 'crime']",5.0,7,5276,5742,-466,217156
3602,"['statement', 'specify', 'quantity', 'warhead', 'missile', 'capable', 'carry']","['statement', 'specify', 'warhead', 'missile', 'carry']",5.0,5,4962,5743,-781,609961
3603,"['threat', 'international', 'security']","['present', 'major', 'threat', 'global', 'security']",4.199999809265137,2,1899,4721,-2822,7963684
3604,"['nicaragua', 'commemorate', 'anniversary', 'sandinista', 'revolution']","['nicaragua', 'reconcile', 'approach', 'anniversary', 'sandinista', 'revolution']",2.400000095367432,4,4197,2294,1903,3621409
3605,"['russian', 'president', 'vladimir', 'state', 'decision', 'cease', 'implementation', 'conventional', 'force', 'europe', 'treaty', 'response', 'plan', 'establish', 'missile', 'defense', 'site', 'eastern', 'europe', 'naso', 'failure', 'ratify', 'amend', 'version', 'treaty']","['russian', 'president', 'vladimir', 'state', 'decision', 'response', 'plan', 'establish', 'missile', 'defense', 'site', 'eastern', 'europe', 'naso', 'failure', 'ratify', 'amend', 'version', 'treaty']",4.199999809265137,19,5749,4724,1025,1050625
3606,"['dutch', 'national', 'research', 'institute', 'carry', 'chemical', 'weapon', 'experiment', 'dutch', 'defense', 'ministry']","['deny', 'journalist', 'learn', 'chemical', 'weapon', 'experiment', 'defense', 'ministry', 'archive']",2.5999999046325684,5,4961,2417,2544,6471936
3607,"['report', 'issue', 'security', 'software', 'vendor', 'cafe', 'say', 'government', 'affiliate', 'hawker', 'china', 'forefront', 'brewing', 'saber', 'cold', 'war']","['government', 'affiliate', 'hawker', 'china', 'forefront', 'burden', 'saber', 'cold', 'war']",3.400000095367432,8,5376,3483,1893,3583449
3608,"['treaty', 'limit', 'number', 'aircraft', 'tank', 'non', 'nuclear', 'heavy', 'weapon', 'europe', 'sign']","['treaty', 'limit', 'number', 'aircraft', 'tank', 'non', 'nuclear', 'heavy', 'weapon', 'europe']",3.5999999046325684,10,5634,3840,1794,3218436
3609,"['attack', 'originate', 'abroad']","['esthonia', 'official', 'state', 'attack', 'originate', 'russia']",1.7999999523162842,2,1879,1687,192,36864
3610,"['police', 'arrest', 'hondura', 'drug', 'trafficking', 'suspect']","['bulgaria', 'police', 'arrest', 'head', 'drug', 'trafficking', 'group']",1.399999976158142,4,4200,1280,2920,8526400
3611,"['japan', 'rise', 'occasion', 'japan', 'beat', 'term', 'military', 'power']","['ozaena', 'say', 'japan', 'rise', 'occasion', 'japan', 'beat', 'term', 'military', 'power']",3.5999999046325684,7,5278,3839,1439,2070721
3612,"['egypt', 'jordan', 'sign', 'nuclear', 'nonproliferation', 'treaty', 'long', 'call', 'middle', 'east', 'free', 'weapon', 'mass', 'destruction']","['syria', 'sign', 'nuclear', 'nonproliferation', 'treaty', 'allow', 'agency', 'expert', 'inspect', 'know', 'nuclear', 'facility']",4.0,4,4201,4414,-213,45369
3613,"['russia', 'participate', 'european', 'space', 'agency']","['france', 'leader', 'european', 'space', 'agency']",1.2000000476837158,3,3099,1237,1862,3467044
3614,"['myanmar', 'military', 'state']","['myanmar', 'military']",3.0,2,1898,3055,-1157,1338649
3615,"['man', 'hang', 'prison']","['dozen', 'criminal', 'hang', 'public']",1.7999999523162842,1,811,1710,-899,808201
3616,"['amnesty', 'international', 'report', 'comply', 'european', 'international', 'non', 'governmental', 'organization', 'saferworld', 'oppose', 'armed', 'violence']","['amnesty', 'international', 'report', 'comply', 'european', 'international', 'non', 'governmental', 'form']",3.200000047683716,7,5281,3131,2150,4622500
3617,"['institute', 'public', 'policy', 'research', 'report', 'say', 'weak', 'state', 'pose', 'threat', 'britain', 'national', 'security', 'state', 'provide', 'basis', 'terrorist']","['report', 'say', 'weak', 'state', 'pose', 'threat', 'britain', 'national', 'security', 'state', 'provide', 'basis', 'terrorist']",4.199999809265137,12,5705,4709,996,992016
3618,"['italian', 'government', 'deny', 'accusation', 'insist', 'nuclear', 'program', 'peaceful', 'purpose']","['run', 'insist', 'nuclear', 'program', 'peaceful', 'purpose']",4.0,5,4948,4418,530,280900
3619,"['proliferation', 'security', 'initiative', 'call', 'stop', 'search', 'ship', 'suspect', 'carry', 'weapon', 'mass', 'destruction']","['member', 'proliferation', 'security', 'initiative', 'consider', 'way', 'intercept', 'ship', 'aircraft', 'suspect', 'carry', 'weapon', 'mass', 'destruction']",3.200000047683716,9,5539,3133,2406,5788836
3620,"['international', 'community', 'modernize', 'seek', 'fair', 'reasonable', 'effective', 'way', 'enhance', 'nuclear', 'non', 'proliferation', 'regime', 'extensive', 'consultation']","['proposal', 'country', 'advance', 'time', 'seek', 'fair', 'reasonable', 'effective', 'way', 'enhance', 'nuclear', 'non', 'proliferation', 'regime', 'broad', 'consultation']",3.400000095367432,11,5650,3526,2124,4511376
3621,"['amnesty', 'international', 'publish', 'report', 'state', 'indian', 'project', 'sell', 'attack', 'helicopter', 'myanmar', 'threaten', 'european', 'union', 'arm', 'embargo', 'myanmar']","['amnesty', 'international', 'report', 'title', 'indian', 'helicopter', 'myanmar', 'make', 'monkey', 'e', 'arm', 'embargo']",3.799999952316284,8,5383,4322,1061,1125721
3622,"['smuggle', 'kilogram', 'pound', 'heroin']","['defendant', 'smuggle', 'kilogram', 'pound', 'heroin']",2.400000095367432,4,4234,2297,1937,3751969
3623,"['people', 'convict', 'quand', 'people', 'court', 'participate', 'drug', 'ring', 'traffic', 'heroin', 'vienna', 'china']","['court', 'official', 'state', 'people', 'people', 'convict', 'quand', 'people', 'court', 'participate', 'drug', 'ring', 'traffic', 'heroin', 'vienna', 'china']",3.400000095367432,11,5647,3543,2104,4426816
3624,"['lawyer', 'michael', 'area', 'name', 'hilton', 'reach', 'comment']","['urban', 'port', 'authority', 'police', 'explosive', 'inspector', 'reach', 'comment']",2.0,2,1895,1962,-67,4489
3625,"['country', 'oppose', 'weaponization', 'space', 'arm', 'race', 'space']","['china', 'stress', 'opposition', 'weaponization', 'arm', 'race', 'outer', 'space']",3.200000047683716,4,4236,3138,1098,1205604
3626,"['france', 'belgium', 'germany', 'sweden', 'italy', 'britain', 'provide', 'part', 'technology', 'advanced', 'light', 'helicopter']","['france', 'belgium', 'germany', 'sweden', 'italy', 'britain', 'provide', 'part', 'technology', 'advanced', 'light', 'helicopter', 'india', 'plan', 'sell', 'myanmar']",3.400000095367432,12,5708,3534,2174,4726276
3627,"['illegal', 'arm', 'trafficking', 'increase', 'sonya', 'easy', 'availability', 'neighboring', 'conflict']","['illegal', 'arm', 'trafficking', 'increase', 'sonya', 'raise', 'concern', 'security']",3.200000047683716,5,4950,3139,1811,3279721
3628,"['shanty', 'state', 'agreement', 'sign', 'defense', 'research', 'development', 'organisation', 'hindustan', 'aeronautics', 'limit', 'indian', 'air', 'force', 'upgrade', 'india', 'fleet', 'm', 'aircraft']","['shanty', 'state', 'upgrade', 'soon', 'canalise', 'defense', 'research', 'development', 'organisation', 'hindustan', 'aeronautics', 'limit', 'indian', 'air', 'force']",3.400000095367432,13,5729,3537,2192,4804864
3629,"['elbaradei', 'state', 'middle', 'east', 'peace', 'deal', 'reach', 'parallel', 'security', 'agreement', 'base', 'eradicate', 'weapon', 'mass', 'destruction', 'region']","['elbaradei', 'quote', 'say', 'peace', 'deal', 'israel', 'arab', 'neighbor', 'reach', 'parallel', 'security', 'agreement', 'base', 'eradicate', 'weapon', 'mass', 'destruction', 'region']",4.599999904632568,13,5721,5225,496,246016
3630,"['drug', 'trafficker', 'face', 'death', 'penalty', 'talk', 'law']","['afghan', 'drug', 'trafficker', 'catch', 'tajikistan']",1.600000023841858,2,1892,1589,303,91809
3631,"['international', 'atomic', 'energy', 'association', 'united', 'nations', 'watchdog']","['international', 'atomic', 'energy', 'agency', 'nuclear', 'watchdog']",5.0,4,4269,5744,-1475,2175625
3632,"['wen', 'state', 'main', 'purpose', 'germany', 'visit', 'advance', 'trade', 'economic', 'technological', 'exchange']","['wen', 'state', 'purpose', 'visit', 'germany', 'advance', 'trade', 'economic', 'technological', 'exchange']",4.800000190734863,10,5622,5472,150,22500
3633,"['united', 'states', 'official', 'know', 'far', 'north', 'nuclear', 'weapon', 'program', 'progress']","['hill', 'head', 'american', 'negotiator', 'north', 'nuclear', 'weapon', 'program']",1.2000000476837158,4,4271,1233,3038,9229444
3634,"['police', 'officer', 'kill', 'officer', 'wound']","['clash', 'seven', 'police', 'officer', 'kill', 'seriously', 'wound']",4.599999904632568,4,4272,5224,-952,906304
3635,"['defense', 'chief', 'esthonia', 'latvia', 'lithuania', 'germany', 'italy', 'spain', 'slovak', 'sign', 'agreement', 'provide', 'staff', 'funding', 'center']","['defense', 'chief', 'esthonia', 'latvia', 'lithuania', 'germany', 'italy', 'spain', 'slovak', 'sign', 'agreement']",2.799999952316284,11,5643,2621,3022,9132484
3636,"['bill', 'propose', 'new', 'law', 'allow', 'use', 'space', 'program', 'defense', 'approve', 'low', 'house', 'japan', 'government', 'week']","['bill', 'new', 'law', 'approve', 'japanese', 'government', 'low', 'house', 'week']",3.400000095367432,8,5382,3513,1869,3493161
3637,"['van', 'der', 'mere', 'sentence', 'give', 'total', 'year', 'imprisonment']","['van', 'der', 'mere', 'suspend', 'give', 'sentence', 'year', 'imprisonment']",2.5999999046325684,7,5297,2429,2868,8225424
3638,"['zahedan', 'city', 'southwestern']","['city', 'southwestern']",1.7999999523162842,2,1891,1702,189,35721
3639,"['president', 'state', 'russia', 'countermeasure']","['warn', 'russia', 'retaliatory', 'action']",4.400000095367432,1,815,5057,-4242,17994564
3640,"['china', 'far', 'balk', 'united', 'states', 'pressure', 'china', 'stop', 'search', 'north', 'organ', 'ship']","['china', 'state', 'united', 'states', 'pressure', 'china', 'stop', 'search', 'north', 'organ', 'ship', 'trigger', 'military', 'clash']",4.0,9,5516,4430,1086,1179396
3641,"['brazil', 'strategic', 'affairs', 'minister', 'robert', 'mangabeira', 'state', 'brazil', 'new', 'national', 'defense', 'plan', 'call', 'establish', 'partnership', 'country', 'include', 'russia', 'france', 'build', 'state', 'art', 'weapon', 'industry']","['state', 'brazil', 'new', 'national', 'defense', 'plan', 'call', 'establish', 'partnership', 'country', 'include', 'russia', 'france', 'build', 'state', 'art', 'weapon', 'industry']",3.799999952316284,17,5745,4255,1490,2220100
3642,"['accuse', 'charge', 'international', 'drug', 'trafficking']","['accuse', 'charge', 'money', 'wander', 'tax', 'invasion', 'corruption']",1.600000023841858,2,1888,1586,302,91204
3643,"['variant', 'advanced', 'light', 'helicopter', 'contain', 'rocket', 'launch', 'belgium', 'ricket', 'gun', 'engine', 'france', 'brake', 'system', 'italy', 'fuel', 'tank', 'gearbox', 'britain', 'self', 'protection', 'equipment', 'swedish', 'company', 'receive', 'crucial', 'design', 'development', 'engine', 'control', 'manufacture', 'german', 'company']","['arsenal', 'rocket', 'launch', 'belgium', 'ricket', 'gun', 'engine', 'france', 'brake', 'system', 'italy', 'fuel', 'tank', 'gearbox', 'britain', 'self', 'protection', 'equipment', 'swedish', 'company']",3.5999999046325684,19,5748,3876,1872,3504384
3644,"['indian', 'defense', 'ministry', 'increase', 'spending', 'defense', 'purchase']","['indian', 'defense', 'ministry', 'increase', 'defense', 'spending', 'new', 'purchase', 'percent']",3.5999999046325684,6,5029,3875,1154,1331716
3645,"['idea', 'report', 'restrict']","['tiller', 'escape']",0.0,0,197,180,17,289
3646,"['conventional', 'force', 'europe', 'treaty', 'sign', 'russian', 'naso', 'member']","['conventional', 'force', 'europe', 'treaty', 'amend']",2.200000047683716,4,4279,2089,2190,4796100
3647,"['salad', 'ilii', 'say', 'civilian', 'casualty', 'result', 'overnight', 'mortar', 'rocket', 'attack', 'happen', 'day']","['salad', 'ilii', 'state', 'civilian', 'casualty', 'result', 'overnight', 'mortar', 'rocket', 'attack', 'admit', 'hospital', 'nearly', 'day']",3.5999999046325684,10,5626,3873,1753,3073009
3648,"['south', 'african', 'government', 'maintain', 'good', 'relation', 'united', 'states', 'government']","['cf', 'issue', 'negative', 'impaction', 'russia', 'relation', 'united', 'states', 'europe']",1.2000000476837158,3,3029,1229,1800,3240000
3649,"['nuclear', 'weapon', 'system', 'high', 'level', 'readiness', 'increase', 'risk', 'weapon', 'include', 'unintentionally', 'catastrophe', 'consequence']","['resolution', 'say', 'high', 'level', 'readiness', 'increase', 'risk', 'use', 'weapon', 'unintentional', 'accidental', 'use', 'catastrophe', 'consequence']",4.199999809265137,8,5402,4738,664,440896
3650,"['state', 'essential', 'increase', 'effort', 'eliminate', 'nuclear', 'arm', 'weapon', 'mass', 'destruction']","['visit', 'new', 'zealand', 'say', 'essential', 'great', 'effort', 'eliminate', 'nuclear', 'arm', 'weapon', 'mass', 'destruction']",3.400000095367432,8,5384,3494,1890,3572100
3651,"['demand', 'province', 'world', 'large', 'producer', 'opium']","['area', 'group', 'world', 'large', 'nuclear', 'engineering', 'firm']",0.0,2,1885,182,1703,2900209
3652,"['afghanistan', 'run', 'border', 'region', 'scene', 'frequent', 'clash', 'police', 'drug', 'smuggler']","['area', 'near', 'town', 'mirjaveh', 'scene', 'frequent', 'conflict', 'italian', 'police', 'drug', 'smuggler']",3.799999952316284,5,4991,4292,699,488601
3653,"['physician', 'danilov', 'convict', 'sell', 'classified', 'information', 'space', 'technology', 'china']","['physician', 'valentine', 'danilov', 'find', 'guilty', 'sell', 'classified', 'information', 'space', 'technology', 'china']",4.400000095367432,8,5387,5063,324,104976
3654,"['myanmar', 'world', 'large', 'producer', 'illegal', 'opium', 'limit', 'financial', 'technical', 'resource', 'end', 'drug', 'trade']","['myanmar', 'world', 'large', 'producer', 'illicit', 'opium', 'accord', 'late', 'state', 'department', 'anti', 'narcotics', 'report']",3.400000095367432,5,4990,3498,1492,2226064
3655,"['abducted', 'support', 'group', 'hope', 'parliament', 'change', 'law', 'soon']","['abducted', 'support', 'group', 'use', 'survey', 'press', 'parliament', 'pass', 'new', 'law']",3.0,5,4989,2956,2033,4133089
3656,"['santo', 'stated', 'colombian', 'police', 'find', 'evidence', 'computer', 'discover', 'slain', 'rebel', 'leader', 'paul', 'eye']","['francisco', 'santo', 'state', 'colombian', 'police', 'find', 'evidence', 'computer', 'discover', 'paul', 'eye']",4.0,9,5512,4470,1042,1085764
3657,"['buy', 'spokesman', 'vietnamese', 'ministry', 'culture', 'information']","['retell', 'spokesman', 'mission', 'united', 'nations']",0.800000011920929,1,824,789,35,1225
3658,"['nieman', 'spokesman', 'germany', 'state', 'enrich', 'von', 'pierre', 'state', 'nieman', 'begin', 'talk', 'interested', 'chinese', 'party', 'sale', 'plutonium', 'processing', 'facility']","['nieman', 'spokesman', 'germany', 'state', 'enrich', 'von', 'pierre', 'state', 'gerard', 'schroeder', 'state', 'gerard', 'schroeder', 'sale', 'plutonium', 'process', 'facility', 'principle']",4.0,10,5625,4484,1141,1301881
3659,"['vienna', 'world', 'strict', 'drug', 'law']","['vienna', 'drug', 'law', 'world', 'strict', 'law']",5.0,5,4987,5745,-758,574564
3660,"['government', 'initiative', 'diary', 'ineffective']","['governance', 'institution', 'ineffective', 'long', 'time', 'somalia']",1.0,1,819,989,-170,28900
3661,"['state', 'russian', 'government', 'withdraw', 'treaty', 'altogether', 'western', 'nation', 'refuse', 'ratify', 'amend', 'treaty']","['state', 'russia', 'discard', 'treaty', 'entirely', 'western', 'nation', 'refuse', 'ratify', 'amend', 'version']",5.0,7,5262,5746,-484,234256
3662,"['russia', 'ratify', 'amend', 'version', 'treaty']","['russia', 'ratify', 'amend', 'treaty']",5.0,4,4285,5747,-1462,2137444
3663,"['discuss', 'possible', 'extension', 'mission', 'kosoy']","['discuss', 'kazakhstan', 'bid', 'hold', 'presidency']",2.200000047683716,1,820,2097,-1277,1630729
3664,"['elbaradei', 'international', 'atomic', 'energy', 'agency', 'chief']","['mohammed', 'elbarade', 'international', 'atomic', 'energy', 'agency', 'director', 'general']",4.800000190734863,4,4286,5474,-1188,1411344
3665,"['nuclear', 'nonproliferation', 'treaty', 'year', 'old']","['nuclear', 'nonproliferation', 'treaty', 'review', 'year']",1.7999999523162842,4,4287,1633,2654,7043716
3666,"['chinese', 'foreign', 'ministry', 'spokesman', 'king', 'state', 'saber', 'hacking', 'global', 'issue']","['chinese', 'foreign', 'ministry', 'spokesman', 'gang', 'ask', 'respond', 'henry', 'speech', 'china', 'military', 'development']",2.200000047683716,4,4288,2103,2185,4774225
3667,"['plant', 'construct', 'exist', 'plant', 'project', 'operational', 'year']","['plant', 'construct', 'exist', 'plant', 'supply', 'china', 'operational']",2.5999999046325684,4,4289,2442,1847,3411409
3668,"['saber', 'attack', 'consider', 'grow', 'threat', 'military', 'civilian', 'computer', 'network']","['naso', 'consider', 'saber', 'attack', 'grow', 'threat', 'military', 'civilian', 'computer', 'network']",4.400000095367432,9,5488,5031,457,208849
3669,"['india', 'blame', 'foreign', 'militant', 'propaganda', 'mislead', 'international', 'community']","['abe', 'urge', 'assertion', 'foreign', 'policy', 'japan', 'international', 'community']",1.2000000476837158,3,3036,1228,1808,3268864
3670,"['riyadh', 'base', 'nail', 'arab', 'academy', 'security', 'science', 'say', 'statement', 'run', 'week', 'workshop', 'anti', 'terrorist', 'expert']","['statement', 'nail', 'arab', 'academy', 'security', 'science', 'sponsor', 'week', 'workshop', 'anti', 'terrorist', 'expert']",4.800000190734863,11,5660,5451,209,43681
3671,"['percent', 'liberal', 'democratic', 'party', 'support', 'economic', 'sanction']","['percent', 'opposition', 'democratic', 'party', 'support', 'economic', 'sanction']",3.799999952316284,6,5048,4285,763,582169
3672,"['sharp', 'islamic', 'law']","['run', 'islamic', 'republic']",1.2000000476837158,1,822,1198,-376,141376
3673,"['number', 'suspect', 'islamic', 'militant', 'alleged', 'al', 'say', 'link', 'arrest', 'malasha', 'singapore', 'official', 'state', 'militant', 'network', 'extend', 'indonesia']","['suspect', 'islamic', 'militant', 'alleged', 'al', 'say', 'link', 'arrest', 'malasha', 'singapore']",3.0,10,5575,2932,2643,6985449
3674,"['september', 'jordan', 'sign', 'accord', 'united', 'states', 'aim', 'support', 'peaceful', 'development', 'jordan', 'nascent', 'nuclear', 'program']","['september', 'united', 'states', 'sign', 'accord', 'jordan', 'aim', 'support', 'peaceful', 'development', 'jordan', 'new', 'nuclear', 'program']",4.599999904632568,12,5701,5170,531,281961
3675,"['accord', 'statement', 'reinforce', 'military', 'potential', 'strategic', 'force', 'overcome', 'anti', 'missile', 'defense', 'system']","['accord', 'statement', 'prototype', 'rocket', 'unlike', 'tool', 'm', 'equip', 'multiple', 'independently', 'targetable', 'warhead', 'overwhelm', 'defense', 'system']",3.200000047683716,4,4237,3205,1032,1065024
3676,"['hang', 'labor', 'sister', 'baluchestan', 'province']","['zahedan', 'capital', 'sister', 'baluchestan', 'province']",0.2000000029802322,3,3038,398,2640,6969600
3677,"['run', 'lie', 'major', 'drug', 'route', 'afghanistan', 'europe', 'persian', 'gulf', 'state']","['run', 'lie', 'major', 'drug', 'trafficking', 'route', 'afghanistan', 'europe', 'persian', 'gulf', 'state']",4.800000190734863,10,5571,5452,119,14161
3678,"['post', 'australian', 'government']","['plan', 'anger', 'russian', 'government']",0.0,1,823,200,623,388129
3679,"['permanent', 'united', 'nations', 'security', 'council', 'member', 'britain', 'china', 'france', 'russia', 'united', 'states']","['member', 'britain', 'china', 'france', 'russia', 'germany', 'united', 'states']",3.5999999046325684,7,5239,3859,1380,1904400
3680,"['july', 'jordanian', 'prime', 'minister', 'maaruf', 'bandit', 'state', 'raghdad', 'russen', 'family', 'live', 'protection', 'king', 'abdullah', 'ii']","['jordanian', 'prime', 'minister', 'maaruf', 'bandit', 'say', 'july', 'raghdad', 'russen', 'family', 'live', 'protection', 'king', 'abdullah', 'ii', 'run', 'issue']",4.199999809265137,14,5735,4745,990,980100
3681,"['nieman', 'spokesman', 'germany', 'state', 'agency', 'france', 'press', 'nieman', 'confident', 'outcome', 'talk', 'sell', 'plutonium', 'process', 'facility']","['nieman', 'spokesman', 'germany', 'refrain', 'comment', 'political', 'aspect', 'sale', 'plutonium', 'processing', 'facility']",2.5999999046325684,5,4985,2396,2589,6702921
3682,"['saber', 'attack', 'occur', 'french', 'president', 'sarkozy', 'meeting', 'adlai', 'lamp', 'anger', 'chinese', 'government']","['saber', 'attack', 'occur', 'french', 'president', 'nicholas', 'sarkozy', 'meeting', 'exile', 'tibetan', 'spiritual', 'leader', 'adlai', 'lamp']",3.799999952316284,9,5550,4253,1297,1682209
3683,"['south', 'african', 'government', 'impose', 'ban', 'prohibit', 'recruitment', 'people', 'inside', 'outside', 'south', 'africa', 'mercenary', 'foreign', 'military', 'assistance']","['south', 'africa', 'foreign', 'ministry', 'state', 'south', 'africa', 'foreign', 'military', 'assistance', 'act', 'prohibit', 'recruitment', 'people', 'inside', 'outside', 'south', 'africa', 'mercenary', 'foreign', 'military', 'assistance']",3.799999952316284,11,5642,4245,1397,1951609
3684,"['ukraine', 'necessary', 'approval', 'join', 'european', 'space', 'agency', 'program']","['france', 'leader', 'european', 'space', 'agency']",1.600000023841858,3,3056,1579,1477,2181529
3685,"['north', 'organ', 'government', 'warn', 'south', 'organ', 'government', 'participate', 'proliferation', 'security', 'initiative', 'program']","['north', 'organ', 'government', 'state', 'south', 'organ', 'government', 'participate', 'proliferation', 'security', 'initiative', 'program', 'result', 'specify', 'catastrophe', 'consequence']",3.200000047683716,9,5518,3209,2309,5331481
3686,"['china', 'council', 'agriculture', 'open', 'special', 'office', 'charge', 'agricultural', 'technology', 'transfer', 'intellectual', 'property', 'right', 'management', 'consultant', 'enhance', 'development', 'china', 'knowledge', 'base', 'agriculture', 'application', 'agricultural', 'technology']","['lee', 'state', 'coat', 'spend', 'past', 'year', 'set', 'relevant', 'mechanism', 'draft', 'set', 'promotion', 'measure', 'enhance', 'development', 'china', 'knowledge', 'base', 'agriculture', 'application', 'agricultural', 'technology']",3.200000047683716,9,5520,3210,2310,5336100
3687,"['italian', 'parliamentary', 'speaker', 'gholam', 'ali', 'add', 'anel', 'visit', 'cuba']","['agreement', 'sign', 'italian', 'male', 'parliament', 'speaker', 'gholam', 'ali', 'add', 'anel', 'visit', 'cuba']",3.0,8,5373,2935,2438,5943844
3688,"['time', 'suspect', 'chinese', 'government', 'create', 'virus', 'spy', 'tibetan', 'exile', 'adlai', 'lamp']","['time', 'suspect', 'chinese', 'government', 'launch', 'attack']",2.5999999046325684,4,4240,2399,1841,3389281
3689,"['chinese', 'authority', 'immediately', 'available', 'comment']","['godzhayev', 'godzhayev', 'lawyer', 'immediately', 'available', 'comment']",1.0,3,3053,982,2071,4289041
3690,"['european', 'union', 'united', 'states', 'freeze', 'al', 'asset']","['western', 'government', 'include', 'united', 'states', 'france']",0.4000000059604645,2,1947,555,1392,1937664
3691,"['chinese', 'government', 'strengthen', 'china', 'anti', 'proliferation', 'capacity', 'recent', 'year']","['chinese', 'government', 'strictly', 'censure', 'china', 'chemical', 'import', 'export', 'accord', 'law', 'recent', 'year']",1.0,5,4966,980,3986,15888196
3692,"['group', 'represent', 'mainly', 'white', 'south', 'africans', 'call', 'afriforum', 'state', 'organize', 'protest', 'route', 'zimbabwe']","['afriforum', 'state', 'group', 'organize', 'protest', 'route', 'zimbabwe']",4.199999809265137,7,5269,4712,557,310249
3693,"['announce', 'cf', 'treaty', 'duly', 'protect', 'russia', 'security', 'interest']","['cf', 'treaty', 'duly', 'protect', 'russian', 'federation', 'security', 'interest']",3.5999999046325684,6,5021,3972,1049,1100401
3694,"['ahead', 'fight', 'tradition', 'united', 'states', 'lodge', 'formal', 'complaint', 'allege', 'british', 'police', 'connect', 'intelligence', 'report', 'implicate', 'ahead', 'terror', 'activity', 'desecrate', 'moran']","['ahead', 'lodge', 'formal', 'complaint', 'independent', 'police', 'complaint', 'commission', 'allege', 'british', 'police', 'connect', 'intelligence', 'report', 'implicate', 'ahead', 'terror', 'activity', 'desecrate', 'ahead', 'copy', 'islamic', 'holy', 'book', 'moran', 'put', 'moran', 'floor', 'search', 'ahead', 'home']",3.400000095367432,15,5739,3449,2290,5244100
3695,"['russia', 'ratify', 'amend', 'version', 'united', 'states', 'naso', 'member', 'refuse', 'russian', 'government', 'withdraw', 'troop', 'soviet', 'republic', 'moldavia', 'georgia']","['united', 'states', 'naso', 'member', 'refuse', 'ratify', 'amend', 'version', 'russia', 'withdraw', 'troop', 'soviet', 'republic', 'moldavia', 'georgia']",3.5999999046325684,15,5738,3959,1779,3164841
3696,"['purpose', 'united', 'states', 'plan', 'increase', 'pressure', 'north']","['united', 'states', 'ally', 'united', 'states', 'believe', 'run', 'pursue', 'nuclear', 'arm']",0.800000011920929,2,1949,813,1136,1290496
3697,"['tskhinvali', 'capital', 'georgia']","['paris', 'capital', 'france']",0.4000000059604645,1,843,565,278,77284
3698,"['indian', 'government', 'official', 'state', 'india', 'attach', 'presence', 'report', 'amnesty', 'international']","['indian', 'government', 'official', 'study', 'blueprint', 'state', 'science', 'old', 'date', 'functional']",1.399999976158142,4,4249,1272,2977,8862529
3699,"['china', 'cabinet', 'state', 'council', 'announce', 'amend', 'regulation', 'dual', 'use', 'nuclear', 'technology', 'prevent', 'nuclear', 'terrorist']","['amend', 'regulation', 'dual', 'use', 'nuclear', 'technology', 'prevent', 'nuclear', 'terrorist']",2.400000095367432,8,5465,2272,3193,10195249
3700,"['japanese', 'prime', 'minister', 'junichiro', 'koizumi', 'say', 'shift', 'rod', 'practice']","['japanese', 'prime', 'minister', 'junichiro', 'koizumi', 'attend', 'summit', 'north', 'north', 'organ', 'leader', 'long', 'il']",1.2000000476837158,5,5012,1171,3841,14753281
3701,"['opposition', 'japanese', 'communist', 'party', 'new', 'law', 'fear', 'lead', 'strong', 'military']","['opposition', 'japanese', 'communist', 'party', 'bill', 'propose', 'new', 'law']",3.200000047683716,6,5099,3191,1908,3640464
3702,"['see', 'official', 'state', 'standardization', 'difficult', 'different', 'country', 'political', 'system']","['official', 'state', 'task', 'difficult', 'see', 'member', 'varied', 'legal', 'political', 'system']",3.5999999046325684,6,5098,3966,1132,1281424
3703,"['run', 'sob', 'security', 'council', 'stop', 'country', 'oil', 'revenue', 'pay', 'compensation', 'victim', 'gulf', 'war', 'salary', 'united', 'nations', 'monitoring', 'purification', 'inspection', 'commission', 'inspector', 'money', 'remain', 'united', 'nation', 'oil', 'food', 'account', 'transfer', 'government', 'development', 'fund']","['ran', 'new', 'leader', 'sob', 'united', 'nations', 'security', 'council', 'stop', 'ran', 'oil', 'revenue', 'pay', 'salary', 'inspector', 'money', 'remain', 'united', 'nation', 'oil', 'food', 'account', 'transfer', 'irate', 'government']",4.0,18,5747,4367,1380,1904400
3704,"['key', 'european', 'arm', 'control', 'treaty', 'maintain']","['cf', 'treaty', 'key', 'european', 'arm', 'control', 'treaty']",2.200000047683716,5,5009,2117,2892,8363664
3705,"['golden', 'triangle', 'region', 'world', 'big', 'producer', 'opium']","['demand', 'province', 'world', 'large', 'producer', 'opium']",2.5999999046325684,3,3047,2404,643,413449
3706,"['united', 'states', 'dismiss', 'action', 'nuclear', 'blackmail']","['united', 'states', 'say', 'stand', 'nuclear', 'blackmailed', 'rule', 'negotiation']",2.200000047683716,3,3046,2124,922,850084
3707,"['meeting', 'day', 'long']","['meeting', 'last', 'day']",2.799999952316284,2,2014,2631,-617,380689
3708,"['minister', 'china', 'law', 'india', 'myanmar', 'thailand', 'address', 'crop', 'substitution', 'initiative', 'impoverished', 'ethnic', 'minority', 'rely', 'opium', 'cultivation']","['minister', 'china', 'law', 'india', 'myanmar', 'thailand', 'discuss', 'find', 'market', 'good', 'produce', 'crop', 'substitution', 'related', 'program', 'co', 'tourism', 'handicraft', 'manufacturing']",3.5999999046325684,8,5427,3960,1467,2152089
3709,"['china', 'nuclear', 'power', 'member', 'security', 'council']","['china', 'permanent', 'member', 'un', 'security']",3.0,3,3044,2968,76,5776
3710,"['north', 'organ', 'official', 'suspect', 'build', 'nuclear', 'weapon']","['north', 'currently', 'process', 'dismantle', 'nuclear', 'weapon', 'program']",2.0,3,3043,1889,1154,1331716
3711,"['australian', 'television', 'reporter', 'peter', 'lloyd', 'face', 'new', 'drug', 'charge', 'singapore']","['accord', 'court', 'document', 'july', 'australian', 'television', 'reporter', 'peter', 'lloyd', 'face', 'new', 'drug', 'charge', 'singapore']",3.400000095367432,10,5570,3505,2065,4264225
3712,"['president', 'vladimir', 'sign', 'decree', 'suspend', 'russia', 'participation', 'conventional', 'force', 'europe', 'treaty']","['russian', 'president', 'vladimir', 'sign', 'decree', 'suspend', 'russia', 'participation', 'conventional', 'force', 'europe', 'treaty', 'circumstance', 'affect', 'security', 'russian', 'federation', 'require', 'immediate', 'measure']",3.0,11,5691,2993,2698,7279204
3713,"['tradition', 'condition', 'stimulate', 'tunisian', 'prosecute', 'single', 'charge', 'falsify', 'document', 'italian', 'authority', 'provide', 'sufficient', 'evidence', 'prosecute']","['spokesman', 'swiss', 'justice', 'ministry', 'folio', 'gall', 'state', 'tradition', 'condition', 'stimulate', 'mere', 'prosecute', 'single', 'charge', 'falsify', 'document', 'italian', 'authority', 'provide', 'sufficient', 'evidence', 'prosecute']",2.5999999046325684,13,5720,2410,3310,10956100
3714,"['attack', 'believe', 'come', 'russian', 'administration', 'address', 'response', 'relation', 'soviet', 'statue', 'esthonia']","['attack', 'occur', 'dispute', 'government', 'russia', 'esthonia', 'relation', 'soviet', 'war', 'memorial']",3.0,4,4258,2996,1262,1592644
3715,"['india', 'parisian', 'remain', 'outside', 'treaty']","['israel', 'remain', 'outside', 'treaty']",2.0,3,3042,1892,1150,1322500
3716,"['china', 'member', 'ballistic', 'missile', 'club']","['russia', 'member', 'quarter', 'middle', 'east']",0.0,1,844,190,654,427716
3717,"['russia', 'pull', 'treaty', 'naso', 'ally', 'refuse', 'ratify', 'amend', 'version']","['warn', 'russia', 'withdraw', 'treaty', 'western', 'nation', 'refuse', 'ratify', 'amend', 'version']",4.400000095367432,6,5038,5109,-71,5041
3718,"['particularly', 'true', 'poor', 'country']","['particularly', 'ethiopia', 'withdraw', 'force']",0.4000000059604645,1,845,472,373,139129
3719,"['run', 'noticeably', 'increase', 'number', 'execution', 'recent', 'month', 'official', 'enforce', 'campaign', 'aim', 'promote', 'virtue', 'boast', 'security']","['italian', 'official', 'increase', 'execution', 'official', 'enforce', 'campaign', 'purportedly', 'aim', 'promote', 'virtue', 'boast', 'security', 'society']",3.5999999046325684,10,5566,3971,1595,2544025
3720,"['statement', 'issue', 'official', 'sea', 'news', 'agency', 'state', 'al', 'dosage', 'convict', 'drug', 'trafficking']","['rapid', 'identify', 'hossein', 'safarlou', 'convict', 'drug', 'trafficking']",0.6000000238418579,3,2824,617,2207,4870849
3721,"['tajikistan', 'uzbekistan', 'share', 'border', 'afghanistan', 'experience', 'maid', 'italian', 'back', 'islamic', 'militant', 'recent', 'year']","['neighbor', 'kyrgyzstan', 'experience', 'maid', 'italian', 'back', 'islamic', 'militant', 'recent', 'year']",1.7999999523162842,8,5438,1692,3746,14032516
3722,"['russia', 'say', 'system', 'clear', 'threat', 'russian', 'security']","['threat', 'international', 'security']",1.7999999523162842,2,2012,1713,299,89401
3723,"['gang', 'engage', 'illegal', 'activity', 'include', 'racketeering', 'blackmail', 'arm', 'smuggling', 'cigarette', 'smuggling', 'money', 'wander', 'allegedly', 'proceed', 'fund', 'terrorist', 'group', 'chechnya']","['dans', 'state', 'gang', 'engage', 'illegal', 'activity', 'include', 'racketeering', 'blackmail', 'arm', 'smuggling', 'cigarette', 'smuggling', 'money', 'wander']",3.0,12,5704,3003,2701,7295401
3724,"['state', 'scientific', 'center', 'applied', 'microbiology', 'kind', 'deadly', 'bacteria', 'study', 'use', 'secret', 'biological', 'weapon', 'program', 'soviet', 'union']","['state', 'scientific', 'center', 'apply', 'microbiology', 'work', 'western', 'scientist', 'convert', 'complex', 'biomedical', 'manufacturing', 'site']",3.400000095367432,4,4405,3529,876,767376
3725,"['international', 'atomic', 'energy', 'agency', 'access', 'people', 'document', 'site']","['international', 'atomic', 'energy', 'agency', 'base']",1.2000000476837158,4,4503,1169,3334,11115556
3726,"['book', 'state', 'drug', 'convey', 'completely', 'positive', 'image']","['official', 'state', 'complete', 'technology', 'transfer']",0.0,1,864,193,671,450241
3727,"['inmate', 'serve', 'sentence', 'murder']","['inmate', 'serve', 'sentence', 'drug', 'trafficking']",1.399999976158142,3,3178,1269,1909,3644281
3728,"['russia', 'fulfil', 'obligation', 'increase', 'force']","['russia', 'suspension', 'obligation', 'cf', 'treaty', 'temporary']",2.0,2,2010,1914,96,9216
3729,"['executive', 'director', 'arms', 'control', 'association', 'washington', 'day', 'kimball', 'state', 'idea', 'report', 'series', 'bad', 'sign']","['executive', 'director', 'arms', 'control', 'association', 'washington', 'day', 'kimball', 'state', 'israel', 'document', 'affect', 'debate', 'india']",3.5999999046325684,9,5553,3957,1596,2547216
3730,"['cf', 'issue', 'negative', 'impaction', 'russia', 'relation', 'united', 'states', 'europe']","['treaty', 'issue', 'cause', 'tense', 'relation', 'government', 'russia', 'europe']",4.0,4,4548,4681,-133,17689
3731,"['korobeynichev', 'laboratory', 'work', 'lawrence', 'evermore', 'national', 'laboratory']","['korobeynichev', 'laboratory', 'work', 'scientific', 'institute']",3.200000047683716,3,3175,3182,-7,49
3732,"['sugar', 'nun', 'senator']","['sugar', 'nun', 'award', 'prime', 'minister', 'medal']",1.7999999523162842,2,2008,1759,249,62001
3733,"['official', 'state', 'decision', 'treaty', 'depend', 'action', 'plan', 'deploy', 'missile', 'defense', 'system', 'poland', 'czech', 'republic']","['russian', 'military', 'official', 'state', 'decision', 'depend', 'united', 'states', 'proceed', 'plan', 'deploy', 'missile', 'defense', 'component', 'poland', 'czech', 'republic']",4.0,11,5678,4673,1005,1010025
3734,"['signing', 'agreement', 'peripheral', 'issue', 'meeting', 'chief', 'defense', 'staff', 'ally', 'country', 'naso']","['agreement', 'sign', 'regular', 'meeting', 'chief', 'defense', 'staff', 'naso', 'ally']",3.0,7,5240,2987,2253,5076009
3735,"['early', 'official', 'philippine', 'malasha', 'indonesia', 'sign', 'anti', 'terrorist', 'agreement', 'share', 'airline', 'passenger', 'list', 'intelligence']","['early', 'philippine', 'malasha', 'indonesia', 'sign', 'agreement', 'share', 'terrorist', 'intelligence']",3.5999999046325684,9,5471,3931,1540,2371600
3736,"['meeting', 'leader', 'european', 'union', 'leader', 'albany', 'bosnia', 'herzegowina', 'croat', 'macedonia', 'serbia', 'montenegro', 'leader', 'western', 'balkan', 'country', 'pledge', 'diminish', 'organize', 'crime', 'corruption', 'balkan', 'meet', 'requirement', 'european', 'union', 'membership']","['leader', 'albany', 'bosnia', 'herzegowina', 'croat', 'macedonia', 'serbia', 'montenegro', 'meet', 'time', 'european', 'union', 'leader', 'pursue', 'join', 'european', 'union']",3.200000047683716,11,5686,3185,2501,6255001
3737,"['resolution', 'require', 'united', 'nations', 'member', 'state', 'adopt', 'law', 'prevent', 'terrorist', 'black', 'musketeer', 'non', 'state', 'actor', 'manufacturing', 'acquire', 'traffic', 'nuclear', 'biological', 'chemical', 'weapon', 'material']","['resolution', 'require', 'country', 'adopt', 'law', 'prevent', 'non', 'state', 'actor', 'manufacturing', 'acquire', 'traffic', 'nuclear', 'biological', 'chemical', 'weapon', 'material', 'missile', 'system', 'deliver']",3.5999999046325684,16,5744,3932,1812,3283344
3738,"['international', 'atomic', 'energy', 'association', 'state', 'jordan', 'agree', 'additional', 'measure']","['international', 'atomic', 'energy', 'association', 'united', 'nations', 'watchdog']",2.0,4,4554,1936,2618,6853924
3739,"['concern', 'drug']",['work'],0.4000000059604645,0,195,547,-352,123904
3740,"['amnesty', 'international', 'report', 'suggest', 'belgium', 'begin', 'immediate', 'talk', 'india', 'prevent', 'future', 'sale', 'component', 'military', 'technology', 'myanmar']","['report', 'urge', 'belgium', 'begin', 'immediate', 'talk', 'india', 'order', 'prevent', 'future', 'weapon', 'sale', 'myanmar']",3.0,10,5568,2986,2582,6666724
3741,"['capital', 'offense', 'ran', 'include', 'murder', 'rape', 'armed', 'robbery', 'apostasy', 'blasphemy', 'drug', 'trafficking', 'repeat', 'sooty', 'adultery', 'restitution', 'treason', 'espionage']","['capital', 'offense', 'ran', 'include', 'murder', 'rape', 'armed', 'robbery', 'drug', 'trafficking', 'adultery']",3.0,11,5688,2979,2709,7338681
3742,"['say', 'arabia', 'absolute', 'monarchy', 'take', 'step', 'reform']","['say', 'arabia', 'absolute', 'monarchy', 'consultation', 'council', 'appoint', 'government']",3.400000095367432,4,4557,3450,1107,1225449
3743,"['spokesman', 'say', 'exchange', 'opinion', 'topical', 'international', 'regional', 'matter', 'base', 'joint', 'working', 'relationship', 'heart', 'kamynin', 'say', 'russia', 'recognize', 'participation', 'tibia', 'work', 'security', 'council']","['kamynin', 'say', 'exchange', 'opinion', 'topical', 'international', 'regional', 'matter', 'base', 'joint', 'working', 'relationship', 'heart', 'un']",3.0,13,5723,2982,2741,7513081
3744,"['amalgam', 'visit', 'london', 'libyan', 'foreign', 'minister']","['visit', 'tibia', 'russian', 'foreign', 'minister', 'announce']",2.5999999046325684,3,3172,2400,772,595984
3745,"['indian', 'pakistani', 'government', 'nearly', 'engage', 'fourth', 'conflict']","['indian', 'pakistani', 'government', 'conduct', 'nuclear', 'test']",1.7999999523162842,3,3171,1770,1401,1962801
3746,"['iguaran', 'state', 'detain', 'accuse', 'homicidal', 'criminal', 'collaboration', 'kidnapping', 'funding', 'terrorist']","['iguaran', 'state', 'detain', 'involve', 'murder', 'police', 'member', 'anti', 'kidnapping', 'group']",3.799999952316284,4,4560,4268,292,85264
3747,"['suspect', 'extremist', 'release', 'bail']","['suspect', 'extremist', 'provisional', 'release', 'bail']",2.400000095367432,4,4562,2285,2277,5184729
3748,"['czech', 'hospital', 'employee', 'charge', 'human', 'organ', 'trafficking']","['accuse', 'charge', 'international', 'drug', 'trafficking']",0.800000011920929,2,2004,817,1187,1408969
3749,"['aggravate', 'situation']","['north', 'act', 'aggravate', 'situation']",2.0,2,2003,1940,63,3969
3750,"['drug', 'lord', 'capture', 'marine', 'mexico']","['suspect', 'drug', 'lord', 'know', 'll', 'taliban', 'hold', 'mexico']",2.5999999046325684,3,3166,2428,738,544644
3751,"['dismiss', 'got', 'review', 'plea', 'vodafone', 'tax', 'case']","['dismiss', 'got', 'review', 'petition', 'vodafone', 'tax', 'verdict']",4.400000095367432,5,4872,5097,-225,50625
3752,"['explosion', 'hit', 'oil', 'pipeline', 'syria']","['explosion', 'hit', 'pipeline', 'sad', 'attack', 'city']",2.5999999046325684,3,3164,2426,738,544644
3753,"['nato', 'soldier', 'kill', 'afghan', 'attack']","['nato', 'soldier', 'kill', 'afghanistan']",3.799999952316284,3,3163,4247,-1084,1175056
3754,"['gastro', 'celebrate', 'birthday', 'monday']","['gastro', 'celebrate', 'birthday']",4.199999809265137,3,3162,4786,-1624,2637376
3755,"['israel', 'ex', 'spy', 'warn', 'messianic', 'ran', 'war']","['israel', 'ex', 'spy', 'boss', 'trust', 'leadership', 'ran', 'video']",3.0,4,4565,2999,1566,2452356
3756,"['eye', 'open', 'supreme', 'court', 'rule', 'arizona', 'immigration', 'law']","['supreme', 'court', 'issue', 'split', 'rule', 'arizona', 'immigration', 'law']",3.799999952316284,6,5111,4295,816,665856
3757,"['nato', 'trace', 'path', 'afghanistan']","['nato', 'leader', 'commit', 'afghanistan', 'transition']",3.200000047683716,2,2002,3117,-1115,1243225
3758,"['syria', 'say', 'suicide', 'bomber', 'kill', 'damascus']","['damascus', 'suicide', 'come', 'kill']",4.0,3,3159,4693,-1534,2353156
3759,"['machine', 'tendulkar', 'say', 'god', 'machine']","['machine', 'tendulkar', 'score', 'cricket', 'century']",0.800000011920929,2,2000,819,1181,1394761
3760,"['australian', 'millard', 'set', 'win', 'leadership', 'challenge']","['australian', 'defiant', 'pressure', 'leadership']",2.400000095367432,2,1999,2302,-303,91809
3761,"['drama', 'back', 'philippines', 'south', 'china', 'tea']","['drama', 'say', 'clear', 'rule', 'need', 'calm', 'south', 'china', 'tea']",2.400000095367432,4,4520,2291,2229,4968441
3762,"['teenager', 'china', 'kill', 'wound', 'knife', 'attack']","['teenager', 'kill', 'knife', 'attack']",3.200000047683716,4,4521,3113,1408,1982464
3763,"['syrian', 'rebel', 'command', 'turkey', 'syria']","['free', 'syrian', 'army', 'move', 'headquarters', 'turkey', 'syria']",3.799999952316284,3,3181,4281,-1100,1210000
3764,"['knesset', 'speaker', 'drama', 'reelection', 'bad', 'israel']","['state', 'sue', 'drama', 'administration', 'birth', 'control', 'rule']",0.4000000059604645,1,868,549,319,101761
3765,"['greece', 'bond', 'exchange', 'large', 'debt', 'restructuring', 'history']","['greece', 'secure', 'big', 'debt', 'deal', 'history']",2.799999952316284,3,3182,2579,603,363609
3766,"['ruin', 'sins', 'russian', 'presidential', 'election']","['poll', 'open', 'russian', 'presidential', 'election']",1.0,3,3202,966,2236,4999696
3767,"['indian', 'finance', 'minister', 'quit', 'run', 'president']","['julian', 'assange', 'plan', 'run', 'australian', 'senate']",0.2000000029802322,1,869,413,456,207936
3768,"['merry', 'sandusky', 'find', 'guilty', 'child', 'sex', 'abuse', 'trial']","['sandusky', 'find', 'guilty', 'child', 'sex', 'abuse', 'trial']",3.799999952316284,7,5350,4278,1072,1149184
3769,"['tibetans', 'self', 'isolate', 'western', 'china', 'report']","['tibetans', 'self', 'isolate', 'china']",2.400000095367432,4,4523,2287,2236,4999696
3770,"['white', 'house', 'damage', 'control', 'drama', 'supreme', 'court', 'remark']","['act', 'check', 'drama', 'supreme', 'court', 'remark']",3.5999999046325684,4,4524,3936,588,345744
3771,"['anna', 'warn', 'talk', 'syria', 'risk']","['ruin', 'anna', 'meet', 'syria', 'crisis']",2.0,2,1997,1946,51,2601
3772,"['quarter', 'call', 'israelis', 'palestinians', 'end', 'irritant']","['occupation', 'confiscate', 'drum', 'palestinian', 'land', 'heir', 'stir']",1.399999976158142,0,193,1268,-1075,1155625
3773,"['audit', 'permit', 'woman', 'compete', 'olympics']","['maude', 'woman', 'allow', 'compete', 'olympics']",4.800000190734863,3,3197,5454,-2257,5094049
3774,"['siberia', 'university', 'mass', 'attack', 'luman']","['siberia', 'university', 'combed', 'north']",2.200000047683716,2,2018,1984,34,1156
3775,"['china', 'cabinet', 'promise', 'boost', 'economy']","['china', 'men', 'promise', 'job', 'creation']",3.200000047683716,2,2039,3108,-1069,1142761
3776,"['tropical', 'storm', 'isaac', 'boot', 'bless', 'claim']","['tropical', 'storm', 'form', 'stay', 'open', 'atlantic']",1.0,2,2038,931,1107,1225449
3777,"['freddie', 'start', 'arrest', 'vile', 'abuse', 'probe']","['man', 'arrest', 'vile', 'sex', 'abuse', 'probe']",3.200000047683716,4,4569,3112,1457,2122849
3778,"['money', 'announce', 'paul', 'run', 'mate']","['money', 'name', 'run', 'mate']",5.0,3,3196,5725,-2529,6395841
3779,"['stock', 'rise', 'early', 'greek', 'deal', 'flatten']","['stock', 'edge', 'high', 'greek', 'debt', 'deal']",3.5999999046325684,3,3195,3952,-757,573049
3780,"['suicide', 'come', 'rock', 'elite', 'semen', 'military', 'camp']","['suicide', 'comber', 'attack', 'semen', 'military', 'post']",4.0,3,3194,4537,-1343,1803649
3781,"['nato', 'international', 'troop', 'kill', 'afghanistan']","['nato', 'troop', 'kill', 'day', 'afghanistan']",2.200000047683716,4,4533,2049,2484,6170256
3782,"['moscow', 'protest', 'demand', 'vladimir', 'ruin', 'resignation']","['moscow', 'protest', 'vladimir', 'ruin', 'small', 'quieter']",1.7999999523162842,4,4534,1733,2801,7845601
3783,"['french', 'election', 'trout', 'high', 'expect']","['french', 'presidential', 'election', 'round', 'live', 'update']",1.0,2,2037,961,1076,1157776
3784,"['australia', 'establish', 'world', 'large', 'marine', 'reserve']","['australia', 'create', 'world', 'large', 'marine', 'reserve']",4.400000095367432,5,4850,5012,-162,26244
3785,"['soldier', 'shoot', 'kill', 'afghan', 'soldier']","['british', 'soldier', 'kill', 'afghan', 'policeman']",1.600000023841858,3,3190,1526,1664,2768896
3786,"['italy', 'soldier', 'die', 'afghanistan']","['soldier', 'kill', 'afghanistan']",1.399999976158142,2,2036,1302,734,538756
3787,"['bias', 'lead', 'palestinian', 'unity', 'government']","['bias', 'propose', 'interim', 'unity', 'government']",4.0,3,3189,4573,-1384,1915456
3788,"['egypt', 'optic', 'church', 'james', 'new', 'hope']","['egypt', 'optic', 'church', 'prepares', 'choose', 'hope']",2.799999952316284,4,4539,2575,1964,3857296
3789,"['kalaw', 'officially', 'confirm', 'president', 'death']","['kalaw', 'confirm', 'president', 'mutharika', 'death']",3.5999999046325684,4,4540,3943,597,356409
3790,"['ali', 'tuareg', 'rebel', 'declare', 'independence']","['ali', 'rebel', 'declare', 'independent', 'azawad']",3.799999952316284,3,3187,4257,-1070,1144900
3791,"['dance', 'armstrong', 'strip', 'de', 'france', 'title']","['dance', 'armstrong', 'plot', 'strategy', 'loss', 'title']",1.399999976158142,3,3186,1315,1871,3500641
3792,"['egypt', 'vote', 'final', 'day', 'presidential', 'election']","['poll', 'open', 'france', 'presidential', 'election']",1.0,2,2035,894,1141,1301881
3793,"['madeleine', 'mccann', 'live']","['open', 'madeleine', 'case', 'police', 'urge']",0.6000000238418579,1,871,629,242,58564
3794,"['russie', 'suffer', 'find', 'stricken', 'asylum', 'seeker']","['mayday', 'fear', 'asylum', 'seeker']",1.399999976158142,2,2032,1301,731,534361
3795,"['isaf', 'coalition', 'troop', 'kill', 'attack', 'involve', 'afghan', 'police']","['nato', 'say', 'troop', 'kill', 'insider', 'attack', 'afghan', 'south']",3.0,4,4542,2954,1588,2521744
3796,"['security', 'council', 'unanimous', 'vote', 'syria']","['security', 'council', 'vote', 'syria', 'monitor']",3.200000047683716,4,4570,3096,1474,2172676
3797,"['human', 'kill', 'shoot', 'wisconsin', 'temple']","['human', 'kill', 'shoot', 'temple', 'wisconsin']",5.0,5,4853,5724,-871,758641
3798,"['mud', 'buy', 'motorcycle', 'maker', 'ducati']","['probe', 'motor', 'insurance', 'market']",0.6000000238418579,0,209,628,-419,175561
3799,"['china', 'news', 'agency', 'hope', 'syria', 'peace']","['china', 'state', 'news', 'agency', 'hope', 'syria', 'peace']",4.199999809265137,6,5119,4770,349,121801
3800,"['dead', 'suicide', 'attack', 'semen', 'police', 'academy']","['force', 'intensify', 'attack', 'somali', 'rebel']",0.4000000059604645,1,874,554,320,102400
3801,"['south', 'order', 'immediate', 'shutdown', 'nuclear', 'factor']","['south', 'boost', 'nuclear', 'power']",1.2000000476837158,2,2040,1157,883,779689
3802,"['ally', 'set', 'demand', 'ran', 'nuclear', 'talk']","['ran', 'will', 'accept', 'pre', 'condition', 'nuclear', 'talk']",1.600000023841858,3,3157,1546,1611,2595321
3803,"['aol', 'say', 'sell', 'patient', 'microsoft']","['aol', 'sell', 'patient', 'microsoft', 'billion']",4.800000190734863,4,4597,5455,-858,736164
3804,"['thousand', 'troop', 'march', 'jubilee']","['thousand', 'flock', 'amsterdam', 'queen']",1.2000000476837158,1,875,1155,-280,78400
3805,"['middle', 'israel', 'james', 'leader', 'convict']","['middle', 'ran', 'prisoners', 'escape', 'kirkuk']",0.800000011920929,1,876,791,85,7225
3806,"['navy', 'met', 'rashes', 'apartment', 'building']","['navy', 'met', 'rashes', 'apartment', 'clock']",4.199999809265137,4,4573,4768,-195,38025
3807,"['woman', 'die', 'abortion', 'refusal']","['woman', 'die', 'cliff', 'collapse', 'corset']",0.6000000238418579,2,2027,620,1407,1979649
3808,"['turkey', 'weigh', 'fly', 'bone', 'syria']","['turkey', 'lighten', 'coordination', 'syria']",2.200000047683716,2,2026,2037,-11,121
3809,"['death', 'toll', 'rise', 'brazzaville', 'blast']","['long', 'head', 'arms', 'depot', 'last']",3.5999999046325684,0,251,3930,-3679,13535041
3810,"['retire', 'stud']","['win', 'weakness']",1.0,0,252,927,-675,455625
3811,"['syria', 'journalist', 'rescue', 'bid', 'fail']","['journalist', 'smuggle']",0.6000000238418579,1,878,616,262,68644
3812,"['new', 'sex', 'claim', 'hit', 'secret', 'service']","['new', 'rule', 'secret', 'service']",1.7999999523162842,3,3126,1748,1378,1898884
3813,"['misha', 'basis', 'release', 'bail']","['angela', 'release', 'hospital']",0.0,1,863,169,694,481636
3814,"['person', 'kill', 'sectarian', 'clash', 'lebanon']","['kill', 'ran', 'earthquake']",0.0,1,862,168,694,481636
3815,"['pain', 'financial', 'stock', 'push', 'european', 'equity']","['british', 'christians', 'complaint', 'european', 'court']",0.0,1,662,167,495,245025
3816,"['turkey', 'raise', 'alarm', 'syrian', 'refugees']","['turkey', 'seek', 'delicate', 'syrian', 'refugee']",1.600000023841858,2,2029,1471,558,311364
3817,"['suspected', 'al', 'qaeda', 'financier', 'arrest', 'france']","['al', 'qaeda', 'suspect', 'arrest', 'pain']",1.600000023841858,3,3123,1543,1580,2496400
3818,"['damage', 'tsunami', 'quaker', 'hit', 'indonesia', 'sumatra']","['quaker', 'hit', 'indonesia', 's', 'sumatra', 'usgs']",1.600000023841858,4,4575,1517,3058,9351364
3819,"['israel', 'air', 'strike', 'kill', 'papa']","['israel', 'air', 'strike', 'kill', 'papa', 'death', 'toll']",2.200000047683716,5,4941,2062,2879,8288641
3820,"['kill', 'wound', 'wave', 'coming', 'ran']","['kill', 'wound', 'car', 'bomb', 'ran', 'kirkuk']",1.399999976158142,3,3131,1387,1744,3041536
3821,"['palestinian', 'prisoner', 'end', 'hunger', 'strike', 'deal']","['israel', 'free', 'palestinian', 'hunger', 'striker']",2.0,2,1995,1929,66,4356
3822,"['hezbollah', 'confirm', 'send', 'drone', 'down', 'israel']","['hezbollah', 'say', 'send', 'drone', 'israel']",3.400000095367432,4,4579,3597,982,964324
3823,"['rebel', 'fighter', 'capture', 'syrian', 'soldier']","['free', 'syrian', 'army', 'capture', 'syrian', 'officer']",3.200000047683716,2,1967,3084,-1117,1247689
3824,"['colorado', 'shoot', 'suspect', 'psychiatric', 'care']","['doctor', 'treat', 'aurora', 'shooting', 'suspect', 'medical', 'reprimand']",2.400000095367432,1,847,2320,-1473,2169729
3825,"['quaker', 'rock', 'indonesia', 'papa', 'usgs']","['quaker', 'rock', 'indonesia', 'papa', 'geological', 'survey']",4.800000190734863,4,4583,5456,-873,762129
3826,"['time', 'andy', 'murray', 'v', 'roger', 'severer', 'wimbledon', 'man', 'final', 'need', 'know', 'big', 'game']","['time', 'paralympic', 'opening', 'ceremony', 'need', 'know', 'big', 'curtain', 'raise']",0.4000000059604645,4,4584,560,4024,16192576
3827,"['new', 'jersey', 'school', 'dans', 'hugging']","['school', 'bank', 'hugging']",3.5999999046325684,2,1965,3969,-2004,4016016
3828,"['ran', 'islamic', 'republic', 'ran', 'step', 'relief', 'effort', 'quaker', 'kill']","['ran', 'step', 'relief', 'effort', 'quaker', 'kill']",4.599999904632568,6,5020,5192,-172,29584
3829,"['tsunami', 'warning', 'issue', 'southern', 'alaska']","['tsunami', 'warn', 'canada', 'quaker']",2.400000095367432,1,849,2226,-1377,1896129
3830,"['evidence', 'afghanistan', 'massacre', 'case']","['toll', 'afghanistan', 'hit']",0.800000011920929,1,850,802,48,2304
3831,"['wash', 'rich', 'apple', 'pay', 'dividend', 'buy', 'share']","['apple', 'pay', 'share', 'dividend', 'buy', 'stock']",3.799999952316284,5,4904,4109,795,632025
3832,"['report', 'dead', 'shoot', 'empire', 'state', 'building']","['dead', 'shoot', 'outside', 'empire', 'state', 'building']",4.599999904632568,5,4905,5191,-286,81796
3833,"['australian', 'unemployment', 'percent']","['french', 'unemployment', 'rate', 'rise', 'percent']",1.0,2,1961,906,1055,1113025
3834,"['share', 'love', 'high', 'street']","['bandy', 'strengthen', 'year', 'coast', 'street', 'shut']",0.4000000059604645,1,853,542,311,96721
3835,"['halliburton', 'income', 'rise']","['halliburton', 'profit', 'rise', 'strong', 'north', 'america', 'sale']",2.5999999046325684,2,1959,2443,-484,234256
3836,"['kill', 'shrine', 'come', 'northwest', 'pakistan']","['kill', 'drone', 'strike', 'pakistan']",0.800000011920929,2,1958,805,1153,1329409
3837,"['china', 'stock', 'close', 'mixed', 'friday']","['china', 'stock', 'open', 'lower', 'friday']",1.600000023841858,3,3113,1556,1557,2424249
3838,"['india', 'bank', 'bulk', 'text', 'riot']","['tunisia', 'lift', 'cure', 'riot']",0.800000011920929,1,856,807,49,2401
3839,"['monitor', 'reach', 'site', 'syrian', 'massacre', 'video']","['monitor', 'shoot', 'way', 'syrian', 'massacre', 'site']",2.400000095367432,4,4436,2324,2112,4460544
3840,"['yorkshire', 'soldier', 'kill', 'afghan', 'bomb', 'blast']","['soldier', 'kill', 'afghanistan', 'blast']",3.5999999046325684,3,3111,3764,-653,426409
3841,"['radical', 'islamists', 'ali', 'enlist', 'new', 'militia']","['local', 'militia', 'posters', 'islamist', 'militant', 'ali']",3.75,2,1956,4007,-2051,4206601
3842,"['olympics', 'opening', 'ceremony', 'round', 'globe']","['opening', 'ceremony', 'give', 'olympics', 'rock', 'start']",4.199999809265137,3,3133,4706,-1573,2474329
3843,"['kill', 'french', 'terror', 'raid']","['die', 'french', 'anti', 'terror', 'operation']",4.800000190734863,2,1955,5461,-3506,12292036
3844,"['apollo', 'quit', 'england', 'manager']","['apollo', 'design', 'england', 'manager']",5.0,3,3144,5706,-2562,6563844
3845,"['dead', 'ohio', 'school', 'shooting']","['dead', 'wound', 'ohio', 'school', 'shooting']",3.200000047683716,4,4439,3118,1321,1745041
3846,"['palestinians', 'kill', 'israel', 'airstrike']","['palestinians', 'kill', 'iaf', 'strike']",2.400000095367432,2,1954,2311,-357,127449
3847,"['pakistan', 'condemn', 'drone', 'strike']","['pakistan', 'convoy', 'head', 'protest', 'drone', 'strike']",3.200000047683716,3,3153,3109,44,1936
3848,"['passive', 'hurricane', 'bandy', 'bear', 'coast']","['hurricane', 'bandy', 'gain', 'speed', 'matter', 'east', 'coast']",4.0,3,3152,4623,-1471,2163841
3849,"['sarkozy', 'mile', 'complaint', 'gadhafi', 'funding', 'claim']","['sarkozy', 'sue', 'gaddafi', 'cash', 'claim', 'burst', 'campaign']",3.5999999046325684,2,1953,3769,-1816,3297856
3850,"['note', 'heads', 'wednesday', 'july']","['note', 'heads', 'wednesday']",2.0,3,3150,1925,1225,1500625
3851,"['ran', 'attack', 'el', 'iv', 'israel', 'strike']","['senior', 'clerk', 'ran', 'attack', 'el', 'iv', 'israel', 'strike']",4.400000095367432,6,5051,4980,71,5041
3852,"['gusmao', 'consolidated', 'power', 'simon', 'election']","['supreme', 'court', 'possibility', 'money', 'win', 'election']",0.0,1,857,142,715,511225
3853,"['jena', 'win', 'mexico', 'presidential', 'vote', 'exit', 'poll']","['toll', 'ruin', 'win', 'russia', 'presidential', 'vote']",0.6000000238418579,3,3148,650,2498,6240004
3854,"['syria', 'tell', 'russia', 'troop', 'pull']","['syria', 'say', 'troop', 'begin', 'pullout', 'video']",3.400000095367432,2,1951,3562,-1611,2595321
3855,"['siberia', 'plane', 'crash', 'survivor']","['chinese', 'siberia', 'plane', 'crash', 'victim']",2.5999999046325684,3,3146,2446,700,490000
3856,"['explosion', 'venezuela', 'refinery', 'hills']","['venezuela', 'mourn', 'oil', 'refine', 'blast', 'death']",2.799999952316284,1,858,2582,-1724,2972176
3857,"['strong', 'earthquake', 'hit', 'mexico']","['strong', 'earthquake', 'strike', 'near', 'acapulco']",3.5999999046325684,2,1950,3748,-1798,3232804
3858,"['russia', 'china', 'veto', 'resolution', 'syria', 'kill']","['russia', 'china', 'double', 'veto', 'syria', 'resolution']",3.799999952316284,5,4910,4256,654,427716
3859,"['pakistani', 'plane', 'clash', 'board']","['pakistani', 'lane', 'rashes', 'people', 'board']",2.5999999046325684,2,1969,2481,-512,262144
3860,"['security', 'council', 'order', 'global', 'sanction', 'haqqani', 'network', 'afghanistan']","['order', 'global', 'sanction', 'haqqani', 'network']",4.400000095367432,5,4911,4981,-70,4900
3861,"['erdogan', 'ruin', 'talk', 'raise', 'voice']","['foreign', 'militant', 'kill', 'somalia', 'strike', 'car']",0.0,0,311,143,168,28224
3862,"['maude', 'arabia', 'arrest', 'suspect', 'militant', 'al', 'qaeda', 'link']","['maude', 'arabia', 'arrest', 'suspect', 'militant', 'state', 'medium', 'report']",4.0,5,4912,4542,370,136900
3863,"['hurricane', 'bandy', 'loses', 'coast']","['hurricane', 'bandy', 'take', 'aim', 'coast']",4.800000190734863,3,3140,5463,-2323,5396329
3864,"['chicago', 'teacher', 'strike', 'action', 'student', 'good', 'ill']","['chicago', 'teacher', 'strike', 'pose', 'test', 'union']",2.200000047683716,3,3139,2054,1085,1177225
3865,"['panetta', 'say', 'afghanistan', 'role', 'shift', 'combat']","['panetta', 'afghanistan', 'tops', 'nato', 'conference', 'topics']",1.600000023841858,2,1971,1562,409,167281
3866,"['man', 'admit', 'london', 'stock', 'exchange', 'bomb', 'plot']","['man', 'admit', 'london', 'bomb', 'plot']",4.0,5,4999,4541,458,209764
3867,"['israel', 'threaten', 'action', 'papa', 'aid', 'ship']","['israel', 'attack', 'papa', 'strip', 'rocket', 'fire']",1.600000023841858,2,1972,1511,461,212521
3868,"['body', 'round', 'russian', 'met', 'crash', 'indonesia']","['body', 'find', 'russian', 'jet', 'crash', 'indonesia']",3.799999952316284,4,4450,4243,207,42849
3869,"['syria', 'urge', 'refugee', 'return']","['syria', 'tendon', 'truce', 'take', 'hold']",1.0,1,859,921,-62,3844
3870,"['soldier', 'kill', 'civilian', 'afghanistan']","['soldier', 'kill', 'afghan', 'civilian', 'shoot', 'spree']",4.199999809265137,3,3137,4790,-1653,2732409
3871,"['superb', 'murdoch', 'victim', 'cover']","['superb', 'murdoch', 'set', 'second', 'day', 'trill']",1.2000000476837158,2,1990,1182,808,652864
3872,"['track', 'drama', 'bodyguard', 'send', 'restitution', 'scandal']","['barclay', 'boss', 'fall', 'rate', 'fix', 'scandal']",0.4000000059604645,1,807,520,287,82369
3873,"['china', 'juan', 'rise', 'new', 'high', 'usd', 'wednesday']","['china', 'juan', 'advance', 'usd', 'wednesday']",3.799999952316284,4,4517,4290,227,51529
3874,"['nissan', 'sell', 'steer', 'wire', 'car']","['nissan', 'offer', 'steer', 'wire', 'system', 'infinite', 'car']",4.0,4,4451,4566,-115,13225
3875,"['tibetan', 'monk', 'die', 'set', 'fire', 'protest', 'chinese', 'rule']","['teenage', 'tibetan', 'monk', 'die', 'set', 'fire', 'china']",3.799999952316284,5,4909,4284,625,390625
3876,"['lumbar', 'costly', 'indian', 'city', 'live']","['lech', 'capital', 'bangalore', 'costly', 'indian', 'city', 'live', 'survey']",1.0,4,4453,903,3550,12602500
3877,"['quit', 'murder']","['quit', 'began', 'weigh', 'murder']",3.799999952316284,2,1987,4280,-2293,5257849
3878,"['israel', 'kill', 'james', 'commander', 'bomb', 'papa', 'target']","['israel', 'airstrike', 'kill', 'james', 'commander']",3.400000095367432,4,4454,3628,826,682276
3879,"['gusmao', 'consolidated', 'power', 'simon', 'election']","['gusmao', 'power', 'simon']",3.5999999046325684,3,3015,3812,-797,635209
3880,"['monitor', 'reach', 'site', 'syrian', 'massacre', 'video']","['monitor', 'unable', 'reach', 'site', 'syria', 'kill']",4.400000095367432,3,3014,4984,-1970,3880900
3881,"['nato', 'condemn', 'syria', 'owning', 'turkish', 'military', 'met']","['nato', 'strongly', 'condemn', 'syria', 'owning', 'turkish', 'jet']",4.800000190734863,5,4907,5471,-564,318096
3882,"['syria', 'rebel', 'attack', 'lebanese', 'post', 'near', 'border', 'army']","['turkish', 'army', 'stage', 'tank', 'exercise', 'near', 'syria', 'border']",0.800000011920929,4,4457,808,3649,13315201
3883,"['kill', 'china', 'building', 'collapse']","['kill', 'syria', 'saturday']",0.2000000029802322,1,661,373,288,82944
3884,"['syrian', 'force', 'launch', 'new', 'attack']","['syria', 'force', 'launch', 'aleppo', 'attack']",3.400000095367432,3,2892,3649,-757,573049
3885,"['kazan', 'fire', 'ricket', 'israel', 'injury']","['kazan', 'fire', 'ricket', 'cabinet', 'approve', 'reserve']",1.399999976158142,3,2891,1392,1499,2247001
3886,"['gaze', 'death', 'camp', 'guard', 'demjanjuk', 'dead']","['john', 'demjanjuk', 'convict', 'gaze', 'death', 'camp', 'guard', 'die', 'age']",4.599999904632568,5,4902,5190,-288,82944
3887,"['boris', 'johnson', 'elect', 'london', 'mayor']","['johnson', 'elect', 'london', 'mayor']",3.799999952316284,4,4432,4291,141,19881
3888,"['breivik', 'drop', 'far', 'right', 'salute', 'court']","['breivik', 'get', 'year', 'sentence']",1.0,1,606,1078,-472,222784
3889,"['second', 'teenager', 'charge', 'murder']","['brother', 'eastenders', 'actress', 'emma', 'mccluskie', 'charge', 'murder']",1.399999976158142,2,1986,1423,563,316969
3890,"['french', 'dear', 'new', 'aerial', 'miller', 'murder']","['jersey', 'murder', 'trial', 'miller', 'hear', 'voice']",0.800000011920929,2,1985,797,1188,1411344
3891,"['madoff', 'brother', 'plead', 'guilty', 'fraud']","['madoff', 'brother', 'plead', 'guilty', 'fraud']",4.199999809265137,5,4900,4780,120,14400
3892,"['holland', 'defeat', 'sarkozy', 'french', 'presidency', 'vote']","['poll', 'open', 'france', 'presidential', 'election']",1.7999999523162842,0,308,1725,-1417,2007889
3893,"['libyan', 'government', 'retake', 'tripoli', 'airport']","['libyan', 'militia', 'take', 'control', 'tripoli', 'airport']",3.200000047683716,3,2886,3082,-196,38416
3894,"['clinton', 'warn', 'sonya', 'cost', 'election', 'violence']","['clinton', 'warn', 'sonya', 'cost', 'election', 'unrest']",4.599999904632568,5,4897,5189,-292,85264
3895,"['arkansas', 'supreme', 'court', 'strike', 'execution', 'law']","['arkansas', 'justices', 'strike', 'death', 'penalty']",4.599999904632568,2,1983,5188,-3205,10272025
3896,"['africa', 'president', 'angela', 'discharge', 'hospital']","['angela', 'discharge', 'hospital']",4.199999809265137,3,2884,4726,-1842,3392964
3897,"['envoy', 'turkey', 'talk', 'syria']","['increase', 'export', 'china']",0.2000000029802322,0,307,372,-65,4225
3898,"['islamist', 'dorsi', 'sin', 'egypt', 'presidential', 'election']","['ll', 'chapter', 'run', 'presidential', 'election', 'egypt']",1.0,3,2883,1072,1811,3279721
3899,"['donna', 'summer', 'queen', 'disco']","['donna', 'summer', 'queen', 'disco', 'lie']",1.600000023841858,4,4409,1491,2918,8514724
3900,"['bangladesh', 'muslims', 'torch', 'buddhist', 'shrine', 'police']","['muslims', 'torch', 'buddhist', 'temple']",3.5999999046325684,3,2880,3786,-906,820836
3901,"['prone', 'hills', 'militant', 'pakistan']","['police', 'officer', 'kill', 'attacks', 'dagestan']",0.4000000059604645,0,306,524,-218,47524
3902,"['ali', 'future', 'interim', 'president', 'read', 'office']","['hope', 'lip', 'dissent', 'priest', 'delicacy']",0.0,0,305,155,150,22500
3903,"['kill', 'injure', 'late', 'cairo', 'clash']","['kill', 'injure', 'afghan', 'airport', 'suicide', 'blast']",1.2000000476837158,2,1977,1225,752,565504
3904,"['money', 'win', 'maine', 'republican', 'caucus']","['money', 'comeback', 'narrow', 'maine', 'caucus', 'win']",3.799999952316284,4,4413,4329,84,7056
3905,"['court', 'bahrain', 'reject', 'medius', 'rally', 'appeal']","['bahrain', 'reject', 'activist', 'appeal']",3.799999952316284,3,2876,4287,-1411,1990921
3906,"['hurricane', 'bandy', 'power', 'eastern', 'seaboard']","['hurricane', 'bandy', 'move']",3.5999999046325684,2,1976,3790,-1814,3290596
3907,"['clinton', 'call', 'friend', 'syria', 'unite']","['elastic', 'artist', 'call', 'great', 'support', 'new', 'talent']",0.0,1,439,156,283,80089
3908,"['howling', 'launch', 'adult', 'novel']","['syria', 'launch', 'ground', 'assault', 'aleppo']",0.0,1,457,157,300,90000
3909,"['algerian', 'government', 'party', 'dominate', 'election']","['algerian', 'national', 'trout', 'parliamentary', 'vote', 'reach']",2.400000095367432,1,454,2281,-1827,3337929
3910,"['security', 'official', 'kill', 'semen']","['security', 'personnel', 'kill', 'pakistan', 'raid']",0.6000000238418579,2,1973,643,1330,1768900
3911,"['stock', 'fall', 'greek', 'talk', 'lumber', 'apple', 'fall']","['stock', 'slip', 'street', 'greek', 'talk', 'drag']",3.200000047683716,3,2873,3125,-252,63504
3912,"['money', 'pick', 'vice', 'presidential', 'running', 'mate', 'source']","['money', 'tap', 'vice', 'presidential', 'running', 'mate']",5.0,5,4939,5708,-769,591361
3913,"['nato', 'stick', 'transition', 'roadway', 'afghanistan', 'rasmussen']","['nato', 'helicopter', 'make', 'hard', 'landing', 'afghanistan']",1.0,2,1856,1064,792,627264
3914,"['mubarak', 'face', 'verdict', 'murder', 'trial']","['mubarak', 'son', 'face', 'new', 'charge', 'insider', 'trading']",1.399999976158142,2,1855,1383,472,222784
3915,"['block', 'investment']","['india', 'allow', 'pakistan', 'investment']",2.0,1,405,1883,-1478,2184484
3916,"['kill', 'northwestern', 'pakistan']","['comb', 'hills', 'northwest', 'pakistan']",2.5999999046325684,1,406,2402,-1996,3984016
3917,"['aid', 'worker', 'free', 'operation', 'afghanistan']","['suicide', 'bomber', 'kill', 'mosque', 'afghanistan']",0.800000011920929,1,408,812,-404,163216
3918,"['nato', 'soldier', 'kill', 'afghanistan']","['nato', 'soldier', 'kill', 'afghan']",3.5999999046325684,3,2895,3813,-918,842724
3919,"['canal', 'tumbler', 'french', 'open', 'final']","['canal', 'seventh', 'french', 'open', 'final']",4.0,4,4422,4378,44,1936
3920,"['russian', 'report', 'fail', 'attempt', 'ruin']","['russia', 'ukraine', 'fail', 'plot', 'kill', 'ruin', 'report', 'say']",3.200000047683716,3,2896,3213,-317,100489
3921,"['ruin', 'claim', 'victory', 'russia', 'presidential', 'election']","['ruin', 'win', 'dispute', 'russian', 'presidential', 'election']",4.400000095367432,3,2916,5111,-2195,4818025
3922,"['remain', 'body', 'find', 'mexican', 'cave']","['remain', 'people', 'find', 'mexico', 'cave']",5.0,3,2915,5709,-2794,7806436
3923,"['orphan', 'alps', 'massacre', 'girl', 'return']","['alps', 'attack', 'girl', 'return']",4.0,3,2914,4376,-1462,2137444
3924,"['drama', 'team', 'raise', 'debate', 'stake']","['drama', 'take', 'offensive', 'money', 'debate']",2.799999952316284,2,1732,2630,-898,806404
3925,"['demyan', 'minister', 'kill', 'plane', 'crash']","['poland', 'honor', 'president', 'kill', 'plane', 'crash']",0.800000011920929,3,2913,831,2082,4334724
3926,"['thousand', 'gather', 'new', 'russian', 'anti', 'ruin', 'rally']","['thousand', 'gather', 'moscow', 'rival', 'ally']",2.799999952316284,2,1731,2628,-897,804609
3927,"['google', 'name', 'new', 'motorola', 'nobility', 'ceo']","['google', 'appoint', 'tennis', 'roadside', 'run', 'motorola', 'nobility']",3.799999952316284,3,2912,4242,-1330,1768900
3928,"['passive', 'hurricane', 'bandy', 'bear', 'coast']","['hurricane', 'bandy', 'take', 'aim', 'coast']",4.400000095367432,3,2911,5073,-2162,4674244
3929,"['rocket', 'hit', 'eshkol', 'injury']","['ricket', 'hit', 'eshkol', 'injure']",3.400000095367432,2,1730,3532,-1802,3247204
3930,"['thousand', 'syrian', 'refugee', 'flee', 'turkey', 'overnight']","['syrian', 'refugee', 'flee', 'turkey', 'overnight']",3.799999952316284,5,4929,4270,659,434281
3931,"['assange', 'appeal', 'tradition', 'court']","['assange', 'appeal', 'tradition', 'court']",4.0,4,4426,4388,38,1444
3932,"['strong', 'quaker', 'bolt', 'part', 'pakistan']","['strong', 'quaker', 'hit', 'eastern', 'indonesia']",2.0,2,1728,1896,-168,28224
3933,"['lebanese', 'lumen', 'clash', 'syria', 'crisis']","['syrian', 'hold', 'solution', 'syria', 'crisis']",1.0,2,1727,1100,627,393129
3934,"['mob', 'kill', 'man', 'burn', 'ran']","['pakistani', 'mob', 'hills', 'turn', 'moran']",4.0,1,414,4355,-3941,15531481
3935,"['drone', 'strike', 'kill', 'north', 'waziristan']","['drone', 'strike', 'kill', 'northwest', 'pakistan', 'official']",1.7999999523162842,3,2908,1643,1265,1600225
3936,"['salvador', 'ali', 'painting', 'snatch', 'new', 'work', 'gallery']","['salvador', 'ali', 'painting', 'snatch', 'nyc']",4.599999904632568,4,4460,5186,-726,527076
3937,"['ruin', 'claim', 'victory', 'russia', 'presidential', 'election']","['ruin', 'election', 'victory', 'russia', 'greet', 'protest']",1.7999999523162842,4,4461,1627,2834,8031556
3938,"['sarkozy', 'announce', 'election', 'bid']","['france', 'nicholas', 'sarkozy', 'make', 'reelection', 'bid', 'official']",4.199999809265137,2,1725,4753,-3028,9168784
3939,"['release', 'emergency', 'oil', 'stock']","['met', 'agree', 'emergency', 'oil', 'stocks', 'release']",4.599999904632568,3,2905,5185,-2280,5198400
3940,"['eurozone', 'unemployment', 'stay', 'record', 'percent']","['eurozone', 'unemployment', 'record', 'high', 'june']",3.0,3,2904,2957,-53,2809
3941,"['french', 'socialist', 'party', 'win', 'parliament', 'victory']","['french', 'socialists', 'win', 'absolute', 'parliament', 'majority']",3.799999952316284,3,2903,4279,-1376,1893376
3942,"['salafi', 'islamists', 'police', 'clash', 'guns', 'witness']","['second', 'islamist', 'hunger', 'striker', 'die', 'tunisian', 'prison']",0.6000000238418579,0,304,640,-336,112896
3943,"['truss', 'investigate', 'french', 'restitution', 'ring']","['dominique', 'truss', 'face', 'question', 'french', 'restitution', 'ring']",3.799999952316284,4,4462,4272,190,36100
3944,"['money', 'win', 'florida', 'republican', 'primary']","['money', 'eye', 'republican', 'primary', 'engage']",1.7999999523162842,3,2901,1653,1248,1557504
3945,"['drone', 'strike', 'kill', 'north', 'waziristan']","['suspect', 'drone', 'strike', 'kill', 'pakistan']",2.5999999046325684,3,2900,2440,460,211600
3946,"['traffic', 'accidents', 'leave', 'head', 'china']","['traffic', 'accident', 'leave', 'dead', 'china']",2.400000095367432,3,2899,2283,616,379456
3947,"['head', 'cia', 'design', 'affair']","['reckon', 'capriati']",0.0,0,303,159,144,20736
3948,"['france', 'truss', 'charge', 'involvement', 'restitution', 'vice', 'ring']","['truss', 'charge', 'restitution', 'vice', 'ring']",4.0,5,4924,4481,443,196249
3949,"['bony', 'report', 'record', 'annual', 'loss']","['bony', 'forecast', 'record', 'annual', 'loss']",3.5999999046325684,4,4493,3797,696,484416
3950,"['kill', 'papa', 'israel', 'airstrike']","['act', 'airline', 'strike']",0.4000000059604645,0,301,531,-230,52900
3951,"['kill', 'attack', 'deadly', 'ran', 'day']","['kill', 'ran', 'attacks', 'ahead', 'ramadan']",1.399999976158142,2,1719,1384,335,112225
3952,"['barclay', 'hit', 'fresh', 'investigation']","['barclay', 'hit', 'fresh', 'probe']",4.400000095367432,3,2858,5062,-2204,4857616
3953,"['close', 'embassy', 'syria']","['closed', 'road', 'armenia']",0.4000000059604645,0,300,532,-232,53824
3954,"['heap', 'new', 'sanction', 'syria']","['impose', 'new', 'sanction', 'syrian', 'regime']",4.400000095367432,2,1717,5059,-3342,11168964
3955,"['russians', 'rally', 'ruin', 'rule']","['ten', 'thousand', 'rally', 'ruin', 'rule']",3.400000095367432,3,2842,3493,-651,423801
3956,"['bahrain', 'grand', 'underway', 'amid', 'protest']","['bahrain', 'race', 'go', 'ahead', 'amid', 'unrest']",4.0,2,1716,4513,-2797,7823209
3957,"['china', 'stock', 'open', 'flat', 'monday']","['chinese', 'stock', 'open', 'mixed', 'wednesday']",1.399999976158142,2,1735,1386,349,121801
3958,"['beryl', 'grow', 'say', 'benign', 'brain', 'tumor']","['beryl', 'grow', 'benign', 'brain', 'humor']",4.599999904632568,4,4495,5184,-689,474721
3959,"['afghan', 'parliament', 'approve', 'security']","['afghan', 'parliament', 'approve', 'partnership']",3.799999952316284,3,2839,4283,-1444,2085136
3960,"['german', 'tourist', 'pilot', 'kill', 'sonya', 'air', 'crash']","['senator', 'reid', 'involve', 'begin', 'car', 'crash', 'cnn']",0.6000000238418579,1,441,636,-195,38025
3961,"['israel', 'palestinian', 'negotiator', 'quietly', 'meet']","['israel', 'palestinian', 'negotiator', 'meet', 'jordan']",3.5999999046325684,4,4496,3796,700,490000
3962,"['astronaut', 'veil', 'armstrong', 'dead']","['astronaut', 'veil', 'armstrong', 'die']",3.5999999046325684,3,2836,3795,-959,919681
3963,"['amnesty', 'syria', 'rebel', 'commit', 'abuse']","['amnesty', 'investigator', 'syria', 'rebel', 'commit', 'abuse']",4.199999809265137,5,4890,4784,106,11236
3964,"['pitt', 'money', 'win', 'republican', 'primary', 'indiana']","['money', 'win', 'florida', 'republican', 'primary']",1.600000023841858,4,4498,1475,3023,9138529
3965,"['german', 'right', 'activist', 'lauck', 'elect', 'president']","['joachim', 'lauck', 'elect', 'german', 'president']",4.0,4,4500,4497,3,9
3966,"['south', 'africa', 'start', 'investigation', 'violence']","['south', 'africa', 'host', 'peace', 'talk', 'standoff']",2.400000095367432,2,1736,2299,-563,316969
3967,"['dead', 'injure', 'china', 'accident']","['dead', 'miss', 'india', 'boat', 'accident']",0.4000000059604645,2,1737,537,1200,1440000
3968,"['antrum', 'romping', 'minnesota', 'victory']","['antrum', 'win', 'kansas', 'caucus']",1.0,1,496,1025,-529,279841
3969,"['space', 'legend', 'veil', 'armstrong', 'die']","['man', 'moon', 'veil', 'armstrong', 'die']",4.0,3,2834,4423,-1589,2524921
3970,"['turkey', 'weigh', 'fly', 'bone', 'syria']","['turkey', 'weigh', 'fly', 'bone', 'syria']",4.800000190734863,5,4854,5466,-612,374544
3971,"['arrest', 'double', 'murder']","['man', 'arrest', 'police', 'drug', 'raid']",0.800000011920929,1,505,818,-313,97969
3972,"['florida', 'county', 'extend', 'early', 'voting']","['democrats', 'want', 'extend', 'early', 'voting', 'hour']",2.799999952316284,3,2832,2620,212,44944
3973,"['warship', 'set', 'sail', 'falkland']","['british', 'warship', 'get', 'nail', 'falkland']",3.799999952316284,2,1755,4308,-2553,6517809
3974,"['newcastle', 'liverpool', 'watch', 'report', 'picture', 'video', 'highlight']","['qpr', 'west', 'watch', 'report', 'picture', 'video', 'highlight']",1.0,5,4851,1023,3828,14653584
3975,"['palestinian', 'prisoner', 'end', 'hunger', 'strike']","['progress', 'report', 'palestinian', 'prisoner', 'hunger', 'strike', 'talk']",2.799999952316284,4,4490,2644,1846,3407716
3976,"['police', 'kill', 'german', 'hostage', 'take', 'incident']","['palestinians', 'kill', 'idf', 'strike', 'northern', 'strip']",1.0,1,510,1022,-512,262144
3977,"['egypt', 'let', 'mubarak', 'presidential', 'race']","['egypt', 'confirm', 'mubarak', 'presidency', 'race']",4.25,3,2830,4910,-2080,4326400
3978,"['syrian', 'journalist', 'kill', 'capital']","['marines', 'kill', 'base', 'attack']",0.6000000238418579,1,515,634,-119,14161
3979,"['gop', 'candidate', 'money', 'arm', 'syrian', 'rebel']","['help', 'arm', 'syria', 'rebel']",2.400000095367432,2,1753,2295,-542,293764
3980,"['observer', 'patrol', 'arrive', 'syria', 'massacre', 'site']","['observer', 'reach', 'syria', 'massacre', 'village']",4.400000095367432,3,2827,5044,-2217,4915089
3981,"['american', 'airline', 'pilots', 'agree', 'new', 'contract']","['money', 'pledge', 'stand', 'israel', 'ran', 'threat']",0.0,0,298,244,54,2916
3982,"['greek', 'announce', 'new', 'election']","['greek', 'call', 'general', 'election']",2.799999952316284,2,1751,2637,-886,784996
3983,"['government', 'canada', 'supports', 'montreal', 'women', 'leading', 'change']","['government', 'canada', 'supports', 'women', 'safety', 'begin']",1.600000023841858,4,4463,1492,2971,8826841
3984,"['problem', 'mulayam', 'form', 'congress']","['problem', 'mulayam', 'form', 'digvijay']",3.200000047683716,3,2847,3130,-283,80089
3985,"['bradley', 'triumph', 'limestone', 'jury', 'fade']","['bahrain', 'court', 'uphold', 'sentence', 'uprise', 'leader']",0.0,0,296,248,48,2304
3986,"['lane', 'crash', 'kill']","['lane', 'crash', 'international', 'medium', 'report']",2.200000047683716,2,1749,1973,-224,50176
3987,"['troop', 'kill', 'afghan', 'bomb', 'attack']","['nato', 'troop', 'kill', 'afghanistan']",1.7999999523162842,2,1747,1669,78,6084
3988,"['syria', 'force', 'launch', 'aleppo', 'attack']","['syrian', 'force', 'kill', 'ahead', 'anna', 'peace', 'mission']",1.600000023841858,1,522,1509,-987,974169
3989,"['money', 'drama', 'fight', 'edge', 'dedicate']","['drama', 'money', 'compete', 'undecided', 'stoke', 'base']",1.0,2,1745,1003,742,550564
3990,"['bbc', 'director', 'general', 'design', 'shod', 'journalism']","['bbc', 'director', 'general', 'designs', 'amid', 'newsnight', 'scandal']",3.5999999046325684,3,2866,3782,-916,839056
3991,"['sick', 'antrum', 'win', 'kansas', 'caucus']","['sick', 'antrum', 'note', 'victory', 'kansas', 'caucus']",4.800000190734863,4,4467,5470,-1003,1006009
3992,"['islamist', 'lead', 'egypt', 'optic', 'church', 'name', 'new', 'pope']","['egyptian', 'christians', 'choose', 'new', 'pope']",3.200000047683716,2,1743,3167,-1424,2027776
3993,"['pledge', 'rebuild', 'haiti', 'meet']","['pledge', 'rebuild', 'haiti', 'met']",5.0,3,2864,5710,-2846,8099716
3994,"['chinese', 'stock', 'close', 'high', 'thursday']","['chinese', 'stock', 'open', 'mixed', 'wednesday']",1.0,2,1740,1001,739,546121
3995,"['greece', 'vote', 'budget', 'protest', 'gather']","['greece', 'vote', 'budget']",3.5999999046325684,3,2862,3781,-919,844561
3996,"['cautiously', 'welcome', 'ran', 'proposal', 'start', 'nuclear', 'talks']","['welcome', 'ran', 'offer', 'start', 'nuclear', 'talk']",4.0,4,4468,4440,28,784
3997,"['clinton', 'warn', 'sonya', 'cost', 'election', 'violence']","['clinton', 'warn', 'sonya', 'repeat', 'vote', 'chaos']",2.799999952316284,3,2861,2650,211,44521
3998,"['anti', 'american', 'protests', 'film', 'expand', 'early', 'country']","['anti', 'american', 'fury', 'sweep', 'middle', 'film']",3.799999952316284,3,2860,4321,-1461,2134521
3999,"['journalist', 'hail', 'london', 'olympics', 'opening']","['israel', 'delegation', 'marche', 'olympics', 'open']",1.0,1,464,999,-535,286225
4000,"['stock', 'open', 'low']","['tokyo', 'stock', 'open', 'low']",1.5,3,2859,1431,1428,2039184
4001,"['wikileaks', 'begin', 'publish', 'million', 'syria', 'email']","['wikileaks', 'release', 'drive', 'syria', 'documents']",3.400000095367432,2,1739,3451,-1712,2930944
4002,"['palestinians', 'papa', 'militant', 'kill', 'israel', 'airstrike', 'coastal', 'strip']","['official', 'papa', 'man', 'kill', 'israel', 'airstrike']",3.0,4,4487,3013,1474,2172676
4003,"['ali', 'president', 'hands', 'resignation']","['ali', 'president', 'normally', 'design']",4.599999904632568,2,1715,5183,-3468,12027024
4004,"['kill', 'siberia', 'suicide', 'comber', 'attack']","['kill', 'siberia', 'cattle', 'market', 'attack']",1.399999976158142,3,2857,1380,1477,2181529
4005,"['factbox', 'security', 'development', 'ran', 'february']","['factbox', 'security', 'development', 'pakistan', 'march']",1.600000023841858,3,2856,1506,1350,1822500
4006,"['hrw', 'jordan', 'base', 'palestinians', 'syria']","['jordan', 'base', 'palestinians', 'syria']",4.199999809265137,4,4478,4908,-430,184900
4007,"['israel', 'arm', 'export', 'world', 'report']","['israel', 'arm', 'export', 'importer']",3.799999952316284,3,2854,4328,-1474,2172676
4008,"['egyptians', 'vote', 'new', 'president']","['somali', 'elect', 'new', 'president']",0.800000011920929,2,1714,756,958,917764
4009,"['severer', 'sin', 'th', 'wimbledon', 'title']","['severer', 'capture', 'th', 'wimbledon', 'title']",5.0,4,4480,5711,-1231,1515361
4010,"['say', 'leader', 'call', 'kidnap', 'westerners', 'egypt']","['ll', 'said', 'leader', 'urge', 'kidnapping', 'westerners']",3.5999999046325684,2,1713,3824,-2111,4456321
4011,"['china', 'stock', 'close', 'mixed', 'friday']","['chinese', 'stock', 'close', 'high', 'midday', 'friday']",2.5999999046325684,3,2852,2380,472,222784
4012,"['kill', 'bus', 'crash']","['kill', 'crash', 'india']",1.600000023841858,2,1690,1472,218,47524
4013,"['ruin', 'swear', 'russian', 'president']","['ruin', 'swear', 'russia', 'president', 'year']",4.0,3,2851,4436,-1585,2512225
4014,"['china', 'trade', 'return', 'surplus', 'march']","['sense', 'calm', 'return', 'south', 'el', 'iv']",0.0,1,467,254,213,45369
4015,"['highlight', 'vice', 'presidential', 'debate']","['thing', 'watch', 'presidential', 'debate']",2.200000047683716,2,1687,2130,-443,196249
4016,"['episode', 'nightline', 'katie', 'holmes', 'tom', 'bruise', 'divorce']","['custody', 'image', 'stake', 'bruise', 'holmes', 'divorce']",1.399999976158142,3,2849,1416,1433,2053489
4017,"['syrian', 'regime', 'deny', 'role', 'massacre']","['syria', 'blame', 'rebel', 'massacre']",3.0,1,472,3040,-2568,6594624
4018,"['south', 'sudan', 'accuse', 'sudan', 'coming', 'ahead', 'talk']","['sudan', 'accuse', 'sudan', 'come', 'blow', 'talk']",4.400000095367432,3,2894,5029,-2135,4558225
4019,"['line', 'kill', 'gun', 'attack', 'pakistan']","['million', 'citizen', 'unofficial', 'salary', 'ukraine']",0.0,0,314,257,57,3249
4020,"['syria', 'demand', 'guarantee', 'rebel', 'peace', 'plan', 'doom']","['syria', 'demand', 'write', 'guarantee', 'troop', 'pullback']",3.200000047683716,3,2919,3150,-231,53361
4021,"['inn', 'terminal', 'rope', 'evacuation']","['inn', 'terminal', 'opens', 'bag', 'causes', 'evacuation']",3.799999952316284,3,2989,4262,-1273,1620529
4022,"['wolf', 'westwood', 'take', 'lead', 'cuba', 'desert', 'classic']","['westwood', 'cuba', 'desert', 'classic']",4.0,4,4486,4435,51,2601
4023,"['sudan', 'locks', 'youtube', 'anti', 'slam', 'film']","['pakistan', 'order', 'youtube', 'halt', 'anti', 'slam', 'film']",2.799999952316284,4,4485,2643,1842,3392964
4024,"['poll', 'open', 'russian', 'presidential', 'election']","['poll', 'close', 'senegal', 'presidential', 'election']",1.399999976158142,3,2920,1404,1516,2298256
4025,"['leave', 'cuba', 'radiotherapy']","['set', 'radiotherapy', 'cuba']",4.400000095367432,2,1684,5121,-3437,11812969
4026,"['romanian', 'president', 'declare', 'victory']","['chinese', 'president', 'conclude', 'state', 'visit', 'denmark']",0.6000000238418579,1,473,649,-176,30976
4027,"['russians', 'rally', 'support', 'orthodox', 'church', 'hussy', 'riot', 'controversy']","['russian', 'orthodox', 'church', 'ally', 'faithful', 'criticism']",3.5999999046325684,2,1682,3818,-2136,4562496
4028,"['clinton', 'land', 'india', 'breathe', 'life', 'tie']","['clinton', 'warn', 'undermining', 'grameen', 'bank']",1.399999976158142,1,483,1424,-941,885481
4029,"['ali', 'interim', 'leader', 'take', 'office']","['ali', 'interim', 'president', 'wear', 'office']",4.199999809265137,3,2986,4892,-1906,3632836
4030,"['ruin', 'declares', 'victory', 'russian', 'presidential', 'note']","['ruin', 'win', 'russia', 'presidential', 'election']",3.799999952316284,2,1680,4248,-2568,6594624
4031,"['renew', 'condemnation', 'syria', 'violence']","['close', 'embassy', 'damascus', 'syria', 'violence']",1.600000023841858,2,1679,1495,184,33856
4032,"['flap', 'sanction', 'sad', 'family']","['sanction', 'sad', 'wife', 'mortar', 'hit']",3.400000095367432,2,1678,3650,-1972,3888784
4033,"['air', 'force', 'instructor', 'face', 'sentencing', 'gape']","['woman', 'testify', 'air', 'force', 'instructor', 'sentencing']",1.7999999523162842,4,4473,1668,2805,7868025
4034,"['strike', 'miner', 'kill']","['strike', 'miner', 'kill', 'south', 'africa']",3.799999952316284,3,2982,4241,-1259,1585081
4035,"['iron', 'intercept', 'ricket']","['iron', 'intercept', 'ricket', 'fire', 'beersheba']",2.5999999046325684,3,2981,2501,480,230400
4036,"['ali', 'islamists', 'destroy', 'timbuktu', 'shrine']","['ali', 'islamists', 'destroy', 'holy', 'timbuktu', 'site']",4.5,4,4466,5144,-678,459684
4037,"['china', 'stock', 'end', 'high', 'pmi', 'midday']","['chinese', 'stock', 'open', 'high', 'thursday']",1.7999999523162842,2,1677,1666,11,121
4038,"['scientist', 'resurrect', 'flower', 'prehistoric', 'need']","['intend', 'trim', 'red', 'ink', 'lower', 'forecast', 'year']",0.0,0,316,260,56,3136
4039,"['convict', 'vatican', 'lead', 'case']","['butler', 'try', 'vatileaks', 'case']",2.5999999046325684,1,487,2497,-2010,4040100
4040,"['money', 'paul', 'vie', 'maine', 'caucus', 'win']","['money', 'narrow', 'maine', 'caucus', 'win']",2.799999952316284,4,4514,2617,1897,3598609
4041,"['sectarian', 'clash', 'rock', 'lebanese', 'city', 'tripoli']","['sectarian', 'clash', 'rock', 'lebanese', 'city', 'kill']",3.799999952316284,5,4878,4288,590,348100
4042,"['eusol', 'blast', 'argentina', 'nationalization', 'ypf']","['eusol', 'blast', 'argentina', 'oil', 'nationalization']",3.400000095367432,4,4512,3634,878,770884
4043,"['dead', 'injure', 'argentina', 'train', 'crash']","['fear', 'dead', 'buenos', 'fires', 'train', 'crash']",1.399999976158142,3,2988,1405,1583,2505889
4044,"['hung', 'address', 'british']","['bursa', 'hung', 'address', 'parliament', 'june', 'visit']",4.0,2,1675,4472,-2797,7823209
4045,"['sheriff', 'recover', 'steal', 'car', 'year', 'later']","['man', 'recover', 'car', 'year', 'theft']",4.0,3,2976,4475,-1499,2247001
4046,"['google', 'ceo', 'say', 'android', 'important', 'critical']","['carry', 'age', 'say', 'android', 'important', 'critical']",4.0,4,4511,4476,35,1225
4047,"['ran', 'cut', 'oil', 'export', 'state']","['ran', 'ready', 'ban', 'oil', 'export', 'state']",3.5999999046325684,4,4510,3810,700,490000
4048,"['factory', 'fire', 'pakistan']","['head', 'pakistan', 'sunlight']",0.800000011920929,1,460,781,-321,103041
4049,"['australian', 'plane', 'miss', 'indonesia']","['cranial', 'painter', 'mansoureh', 'hosseini', 'die']",0.0,0,334,237,97,9409
4050,"['money', 'vow', 'restore', 'promise', 'america']","['money', 'promises', 'restore', 'america']",3.799999952316284,3,2975,4274,-1299,1687401
4051,"['antrum', 'year', 'old', 'daughter', 'hospitalize']","['bony', 'director', 'hospitalize']",0.6000000238418579,1,488,625,-137,18769
4052,"['angela', 'release', 'hospital']","['israel', 'president', 'release', 'hospital']",1.2000000476837158,2,1670,1176,494,244036
4053,"['trade', 'set', 'join', 'bjp']","['trade', 'likely', 'join', 'bjp', 'high', 'decide']",3.799999952316284,3,2972,4273,-1301,1692601
4054,"['hezbollah', 'nasrallah', 'warn', 'anti', 'slam', 'film']","['hezbollah', 'call', 'anti', 'slam', 'film', 'protest']",2.799999952316284,4,4505,2608,1897,3598609
4055,"['canal', 'top', 'djokovic', 'th', 'french', 'open', 'title']","['tennis', 'canal', 'defeat', 'djokovic', 'carlo', 'title']",3.200000047683716,3,2971,3156,-185,34225
4056,"['childcare', 'cost', 'rise', 'nearly']","['childcare', 'cost', 'year']",3.0,2,1712,2777,-1065,1134225
4057,"['drama', 'urge', 'decisive', 'action', 'europe', 'debt', 'crisis']","['drama', 'urge', 'europe', 'act', 'quickly', 'crisis']",3.400000095367432,4,4515,3651,864,746496
4058,"['beef', 'burgher', 'mix', 'recall', 'salmonella', 'concern']","['powder', 'recall', 'salmonella', 'concern']",1.0,3,2969,1040,1929,3721041
4059,"['drama', 'money', 'prepare', 'debate']","['drama', 'money', 'prepare', 'debate']",4.199999809265137,4,4499,4799,-300,90000
4060,"['significant', 'gas', 'find', 'offshore', 'sonya']","['aide', 'kill', 'late', 'land', 'clash', 'sonya']",0.800000011920929,1,484,778,-294,86436
4061,"['red', 'cross', 'worker', 'kill', 'pakistan']","['kidnap', 'aid', 'worker', 'kill', 'pakistan']",2.200000047683716,3,2968,2086,882,777924
4062,"['ricket', 'fire', 'papa', 'southern', 'israel', 'hurt']","['men', 'ricket', 'papa', 'land', 'southern', 'israel', 'hurt']",3.400000095367432,5,4864,3676,1188,1411344
4063,"['soldier', 'kill', 'shoot', 'incident', 'afghanistan']","['nato', 'soldier', 'kill', 'afghanistan']",1.600000023841858,3,2977,1466,1511,2283121
4064,"['poll', 'close', 'egyptian', 'presidential', 'election']","['dress', 'release', 'cement', 'presidential', 'election']",0.800000011920929,2,1711,774,937,877969
4065,"['police', 'link', 'vile', 'claim']","['bbc', 'face', 'question', 'pull', 'vile', 'case']",1.2000000476837158,1,482,1177,-695,483025
4066,"['eurozone', 'unemployment', 'stay', 'record', 'percent']","['eurozone', 'unemployment', 'hit', 'record', 'high']",3.400000095367432,3,3001,3664,-663,439569
4067,"['james', 'murdoch', 'quit', 'bskyb']","['james', 'murdoch', 'quit', 'role', 'bskyb']",4.199999809265137,4,4429,4832,-403,162409
4068,"['ironic', 'science', 'fiction', 'writer', 'bradbury', 'die']","['science', 'fiction', 'legend', 'bradbury', 'dead']",4.800000190734863,3,3011,5457,-2446,5982916
4069,"['egypt', 'presidential', 'election']","['presidential', 'election']",0.6000000238418579,2,1710,619,1091,1190281
4070,"['french', 'soldier', 'kill', 'afghan', 'suicide', 'blast']","['foreign', 'soldier', 'kill', 'afghan', 'east']",3.400000095367432,3,3010,3655,-645,416025
4071,"['observer', 'find', 'trace', 'syrian', 'massacre']","['team', 'investigate', 'syrian', 'massacre']",4.0,2,1708,4386,-2678,7171684
4072,"['poll', 'majority', 'prejudice', 'black']","['toll', 'majority', 'harbor', 'prejudice', 'lacks']",3.5999999046325684,2,1706,3780,-2074,4301476
4073,"['source', 'redskin', 'trade', 'pick']","['redskin', 'trade', 'pick']",4.199999809265137,3,3008,4859,-1851,3426201
4074,"['china', 'say', 'defense', 'budget', 'rise']","['china', 'defence', 'spending', 'rise']",4.0,2,1705,4373,-2668,7118224
4075,"['string', 'ran', 'blast', 'kill']","['strong', 'italy', 'hills']",0.0,0,332,204,128,16384
4076,"['ecuador', 'president', 'cornea', 'say', 'decision', 'assange', 'asylum']","['ecuador', 'decide', 'assange', 'asylum']",3.799999952316284,3,3005,4311,-1306,1705636
4077,"['offer', 'mild', 'pakistan', 'militant']","['offer', 'million', 'pakistani', 'militant', 'chief']",3.799999952316284,2,1702,4312,-2610,6812100
4078,"['nato', 'troop', 'kill', 'afghanistan', 'ied', 'attack']","['nato', 'troop', 'kill', 'afghanistan']",3.799999952316284,4,4458,4313,145,21025
4079,"['laden', 'give', 'fail']","['laden', 'movie', 'fill', 'india']",0.800000011920929,1,478,773,-295,87025
4080,"['egyptians', 'vote', 'landmark', 'presidential', 'election']","['egyptians', 'poll', 'historic', 'election']",4.0,2,1700,4394,-2694,7257636
4081,"['jetblue', 'pilot', 'disrupt', 'flight', 'declare', 'insane', 'guilty']","['jetblue', 'pilot', 'cause', 'disruption', 'flight', 'guilty']",3.799999952316284,4,4456,4327,129,16641
4082,"['tsunami', 'warning', 'need', 'panic']","['tsunami', 'warn', 'eh', 'quaker']",2.200000047683716,1,477,2118,-1641,2692881
4083,"['hands', 'wagram', 'prison', 'afghan', 'authority']","['transfer', 'wagram', 'prison', 'afghan', 'control']",4.800000190734863,3,3012,5448,-2436,5934096
4084,"['enemy', 'aunt', 'distance', 'adviser', 'overstep', 'mark']","['enemy', 'aunt', 'cling', 'pad', 'quit', 'news', 'email']",2.0,2,1698,1847,-149,22201
4085,"['drama', 'praise', 'america', 'trade', 'tie']","['drama', 'secret', 'service', 'agent', 'send', 'home']",0.4000000059604645,1,476,466,10,100
4086,"['blitzbokke', 'dust', 'iii']","['blitzbokke', 'beat']",2.0,1,475,1849,-1374,1887876
4087,"['drama', 'money', 'focus', 'swing', 'state']","['team', 'anna', 'decide', 'consist', 'state', 'poll']",0.4000000059604645,1,474,471,3,9
4088,"['grenade', 'attack', 'kill', 'injury']","['ex', 'attack', 'woman', 'investigate']",0.2000000029802322,1,471,414,57,3249
4089,"['score', 'body', 'find', 'syria']","['right', 'body', 'find', 'ship']",1.399999976158142,2,1694,1394,300,90000
4090,"['shorter', 'charge', 'murder', 'black']","['thought', 'race', 'relation', 'black', 'president']",0.800000011920929,1,470,804,-334,111556
4091,"['bonny', 'bairstow', 'join', 'organ', 'shine', 'england', 'lumbar']","['bairstow', 'hit', 'ton', 'india', 'tour', 'match']",1.7999999523162842,1,469,1696,-1227,1505529
4092,"['wind', 'farm', 'developer', 'use', 'camera', 'trick', 'turbine', 'look', 'small']","['mind', 'farm', 'developer', 'trick', 'turbine', 'look', 'small']",4.400000095367432,6,5150,5076,74,5476
4093,"['drone', 'kill', 'militant', 'pakistan', 'official']","['missile', 'kill', 'pakistan', 'official']",2.400000095367432,3,2996,2230,766,586756
4094,"['siberia', 'iberian', 'troop', 'swarm', 'kill', 'student', 'massacre']","['siberia', 'police', 'arrest', 'college', 'massacre']",2.5999999046325684,2,1748,2490,-742,550564
4095,"['nerves', 'calmed', 'markets', 'jump', 'relief', 'spanish', 'bank', 'bailout']","['focus', 'shifts', 'greece', 'pain', 'secure', 'bank', 'bailout']",2.200000047683716,2,1760,2115,-355,126025
4096,"['heavy', 'fighting', 'report', 'syria', 'aleppo']","['heavy', 'fighting', 'report', 'damascus']",1.399999976158142,3,2995,1397,1598,2553604
4097,"['france', 'say', 'greece', 'credibility', 'eurozone']","['france', 'holland', 'back', 'greece', 'urge', 'incredible', 'reform']",1.7999999523162842,2,1762,1691,71,5041
4098,"['avenger', 'set', 'box', 'office', 'record']","['hunger', 'james', 'break', 'box', 'office', 'record']",1.2000000476837158,3,2993,1179,1814,3290596
4099,"['french', 'soldier', 'report', 'kill', 'afghanistan']","['british', 'soldier', 'kill', 'afghanistan']",1.0,3,2992,1036,1956,3825936
4100,"['spanish', 'ballot', 'dilemma', 'get', 'acute']","['spanish', 'dilemma', 'get', 'acute']",3.400000095367432,4,4442,3579,863,744769
4101,"['nato', 'soldier', 'die', 'afghanistan']","['soldier', 'wound', 'afghanistan']",0.6000000238418579,2,1828,651,1177,1385329
4102,"['chinese', 'stock', 'open', 'low', 'wednesday']","['china', 'stock', 'open', 'lower', 'friday']",2.400000095367432,2,1826,2228,-402,161604
4103,"['palestinian', 'leadership', 'condemn', 'israel', 'bias']","['palestinian', 'leadership', 'back', 'path', 'james', 'oh', 'deal']",1.0,2,1825,1046,779,606841
4104,"['pitt', 'money', 'win', 'maryland', 'gop', 'primary']","['money', 'win', 'maryland', 'republican', 'primary']",4.800000190734863,4,4438,5447,-1009,1018081
4105,"['find', 'car', 'year', 'steal']","['texas', 'man', 'find', 'car', 'year', 'steal']",3.5999999046325684,4,4437,3752,685,469225
4106,"['sylvester', 'stallone', 'son', 'find', 'dead', 'hollywood']","['sylvester', 's', 'son', 'age', 'stallone', 'find', 'dead', 'vol']",3.400000095367432,5,4970,3577,1393,1940449
4107,"['nato', 'aid', 'worker', 'rescue', 'afghan', 'insurgent']","['aid', 'worker', 'free', 'operation', 'afghanistan']",2.799999952316284,2,1824,2591,-767,588289
4108,"['russia', 'jail', 'hussy', 'riot', 'protest', 'bunk', 'year']","['russian', 'court', 'rule', 'hussy', 'riot', 'trial']",1.7999999523162842,2,1823,1635,188,35344
4109,"['israel', 'bar', 'german', 'writer', 'grass', 'visit', 'poem']","['israel', 'bar', 'german', 'author', 'grass', 'poem']",4.400000095367432,5,4965,5089,-124,15376
4110,"['note', 'heads', 'august']","['note', 'heads', 'wednesday', 'july']",1.7999999523162842,2,1822,1630,192,36864
4111,"['nato', 'troop', 'detain', 'shooting', 'afghan', 'civilian']","['say', 'sadden', 'shoot', 'afghan', 'civilian']",2.400000095367432,2,1821,2243,-422,178084
4112,"['holland', 'win', 'french', 'presidential', 'election']","['simon', 'vote', 'presidential', 'election']",1.600000023841858,2,1820,1460,360,129600
4113,"['military', 'syria', 'chemical', 'stock', 'threaten', 'israel']","['russia', 'tell', 'syria', 'chemical', 'arm', 'threat', 'unacceptable']",1.7999999523162842,2,1819,1661,158,24964
4114,"['pitch', 'upgrade', 'word', 'investment', 'grade']","['pitch', 'restore', 'word', 'credit', 'investment', 'grade']",3.5999999046325684,4,4518,3753,765,585225
4115,"['syria', 'peace', 'plan', 'condition', 'unacceptable', 'opposition', 'say']","['syria', 'peace', 'dash', 'deadline', 'pass']",2.0,2,1818,1845,-27,729
4116,"['lash', 'greeks', 'protest', 'cutback']","['lash', 'erupt', 'greek', 'vote', 'year']",2.400000095367432,1,463,2262,-1799,3236401
4117,"['dead', 'hurt', 'miss', 'wo', 'not', 'land', 'avalanche']","['dead', 'miss', 'wo', 'not', 'land', 'avalanche']",2.400000095367432,6,5164,2260,2904,8433216
4118,"['taliban', 'pose', 'attractive', 'woman', 'facebook', 'spy']","['taliban', 'soldier', 'lose', 'pretty', 'woman', 'facebook', 'troop', 'secret']",4.599999904632568,3,2932,5180,-2248,5053504
4119,"['china', 'activist', 'land']","['chinese', 'activist', 'renew', 'fight', 'injustice']",1.2000000476837158,1,492,1181,-689,474721
4120,"['city', 'room', 'empire', 'state', 'building', 'shooting']","['dead', 'shoot', 'outside', 'empire', 'state', 'building']",3.200000047683716,3,2930,3212,-282,79524
4121,"['ashamed', 'dorsi', 'swear', 'egyptian', 'president']","['bursa', 'swear', 'egyptian', 'president']",4.400000095367432,3,2929,5095,-2166,4691556
4122,"['attack', 'dato', 'base', 'afghanistan', 'kill']","['worker', 'free', 'afghanistan', 'raid']",1.0,1,520,1050,-530,280900
4123,"['semen', 'suicide', 'prone', 'attack']","['pate', 'ran', 'attack', 'kill']",1.0,1,518,1053,-535,286225
4124,"['horse', 'move', 'olympic', 'bid', 'fail']","['horse', 'finish', 'th', 'miss', 'sixth', 'olympics']",3.0,1,514,2888,-2374,5635876
4125,"['pakistan', 'begin', 'desolation', 'bin', 'laden', 'compound']","['pakistan', 'demolish', 'bin', 'laden', 'hideous']",2.799999952316284,3,2927,2594,333,110889
4126,"['sudan', 'blame', 'israel', 'khartoum', 'arm', 'fire']","['sudan', 'accuse', 'israel', 'airstrike', 'arm', 'factory']",3.5999999046325684,3,2926,3768,-842,708964
4127,"['house', 'senate', 'deal', 'reach', 'patrol', 'tax', 'measure']","['negotiator', 'reach', 'deal', 'congress', 'patrol', 'tax', 'cut', 'bill']",3.799999952316284,4,4581,4299,282,79524
4128,"['tropical', 'storm', 'isaac', 'drench', 'haiti', 'side', 'cuba']","['tropical', 'storm', 'isaac', 'threaten', 'dam']",1.399999976158142,3,2924,1402,1522,2316484
4129,"['foreign', 'pro', 'palestinian', 'activist', 'seek', 'enter', 'west', 'bank']","['pro', 'palestinians', 'seek', 'enter', 'israel', 'allenby']",2.200000047683716,3,2923,2119,804,646416
4130,"['world', 'stock', 'rise', 'hope', 'stimulus']","['stock', 'rise', 'hope', 'red', 'stimulus']",3.0,4,4578,2881,1697,2879809
4131,"['widal', 'dead', 'legendary', 'author', 'playwright', 'politician', 'die']","['widal', 'celebrate', 'author', 'playwright', 'die']",4.0,4,4576,4647,-71,5041
4132,"['world', 'stock', 'fall', 'greek', 'debt', 'deal', 'deadline']","['asia', 'stock', 'fall', 'ahead', 'greek', 'debt', 'deal', 'deadline']",2.400000095367432,6,5218,2256,2962,8773444
4133,"['south', 'africa', 'police', 'shoot', 'dead', 'miner']","['south', 'africa', 'police', 'kill', 'miner']",4.199999809265137,4,4595,4848,-253,64009
4134,"['isaac', 'drench', 'haiti', 'head', 'cuba', 'florida']","['isaac', 'year', 'haiti', 'homeless', 'quaker', 'population']",2.400000095367432,2,1811,2253,-442,195364
4135,"['britain', 'reach', 'syria', 'opposition']","['care', 'syrian', 'people']",1.2000000476837158,0,330,1183,-853,727609
4136,"['drama', 'relax', 'importation', 'rule', 'young', 'immigrant']","['relax', 'importation', 'rule', 'young', 'people', 'napolitano']",4.0,4,4601,4636,-35,1225
4137,"['microsoft', 'surface', 'big', 'bet', 'future', 'analysis']","['microsoft', 'surface', 'tablet', 'promising', 'question', 'remain']",3.799999952316284,2,1829,4296,-2467,6086089
4138,"['white', 'ulcer', 'girlfriend', 'get', 'year']","['lobster', 'white', 'ulcer', 'girlfriend', 'get', 'year']",3.5999999046325684,5,4952,3763,1189,1413721
4139,"['mauritanian', 'president', 'shoot', 'army', 'unit']","['mauritanian', 'president', 'shoot']",3.799999952316284,3,2962,4293,-1331,1771561
4140,"['set', 'fire', 'breivik', 'trial']","['set', 'self', 'fire', 'outside', 'breivik', 'trial']",4.599999904632568,4,4538,5178,-640,409600
4141,"['drone', 'strike', 'kill', 'northwest', 'pakistan']","['drone', 'pakistan', 'kill', 'suspect', 'militant']",3.799999952316284,3,2961,4289,-1328,1763584
4142,"['marines', 'leave', 'okinawa']","['marines', 'okinawa', 'statement']",5.0,2,1830,5715,-3885,15093225
4143,"['boy', 'r', 'wife', 'fee', 'faraway', 'program']","['pal', 'lower', 'fee', 'holiday', 'faraway', 'program']",1.7999999523162842,3,2960,1652,1308,1710864
4144,"['ran', 'expand', 'nuclear', 'enrichment', 'activity', 'iaea', 'report']","['ran', 'step', 'sensitive', 'nuclear', 'work', 'iaea']",3.0,3,2959,2922,37,1369
4145,"['donna', 'summer', 'queen', 'disco', 'die']","['donna', 'summer', 'queen', 'disco']",3.0,4,4537,2920,1617,2614689
4146,"['iraqi', 'attacks', 'general', 'police']","['attack', 'ran', 'kill', 'general']",4.0,1,512,4675,-4163,17330569
4147,"['dead', 'northwest', 'ran', 'quaker']","['dead', 'injure', 'northwest', 'ran', 'earthquake']",2.5999999046325684,3,2958,2489,469,219961
4148,"['brazil', 'pop', 'star', 'priest', 'get', 'mammoth', 'new', 'stage']","['brazil', 'star', 'priest', 'get', 'mammoth', 'new', 'stage']",5.0,7,5266,5716,-450,202500
4149,"['washington', 'charge', 'dedicate', 'fraud', 'weep']","['washington', 'court', 'upholds', 'noting', 'rights', 'act', 'alabama', 'case']",0.6000000238418579,1,511,646,-135,18225
4150,"['ruin', 'claim', 'victory', 'russia', 'presidential', 'election']","['ruin', 'claim', 'victory', 'presidential', 'vote']",4.199999809265137,4,4541,4866,-325,105625
4151,"['clinton', 'ready', 'fight', 'drama']","['clinton', 'tough', 'act', 'drama', 'follow']",1.0,2,1852,1041,811,657721
4152,"['money', 'announce', 'paul', 'run', 'mate']","['money', 'choose', 'gop', 'running', 'mate']",4.400000095367432,2,1851,5021,-3170,10048900
4153,"['european', 'market', 'rise', 'greek', 'ballot', 'hope']","['european', 'ministers', 'noise', 'approve', 'greek', 'rescue']",2.200000047683716,2,1850,2135,-285,81225
4154,"['edwards', 'acquit', 'count', 'mistrial']","['edwards', 'find', 'guilty', 'count', 'mistrial']",4.599999904632568,3,2955,5177,-2222,4937284
4155,"['ukrainian', 'weightlifter', 'get', 'year', 'ban']","['ukraine', 'korobka', 'get', 'year', 'ban']",4.199999809265137,3,2964,4861,-1897,3598609
4156,"['human', 'fill', 'school', 'massacre']","['miller', 'fill', 'france', 'school', 'shooting']",3.0,2,1849,2910,-1061,1125721
4157,"['long', 'long', 'stock', 'close']","['long', 'long', 'stock', 'open', 'high']",1.600000023841858,2,1848,1593,255,65025
4158,"['suicide', 'bomber', 'attack', 'algerian', 'security', 'base']","['suicide', 'bomber', 'target', 'iberian', 'church']",0.800000011920929,2,1847,842,1005,1010025
4159,"['thailand', 'iranians', 'plan', 'attack', 'israelis']","['malaysia', 'extradite', 'cranial', 'attack', 'israelis']",1.0,2,1845,1009,836,698896
4160,"['israel', 'military', 'court', 'reject', 'appeal', 'palestinian', 'hunger', 'striker']","['israel', 'reach', 'deal', 'palestinian', 'hunger', 'striker']",1.2000000476837158,4,4526,1184,3342,11168964
4161,"['avenger', 'set', 'box', 'office', 'record']","['hunger', 'james', 'set', 'box', 'office', 'record']",1.600000023841858,4,4525,1572,2953,8720209
4162,"['ruin', 'sins', 'russian', 'presidential', 'election']","['ruin', 'win', 'russia', 'presidential', 'election']",4.199999809265137,3,2949,4856,-1907,3636649
4163,"['ruin', 'cast', 'ballot', 'russians', 'vote']","['ruin', 'win', 'russia', 'presidential', 'election']",1.399999976158142,1,508,1418,-910,828100
4164,"['chief', 'kinds', 'voice', 'remain', 'cautious', 'china']","['insight', 'chief', 'find', 'voice', 'remain', 'cautious', 'china']",4.800000190734863,5,4996,5426,-430,184900
4165,"['libyans', 'begin', 'hand', 'weapon']","['libyans', 'transfer', 'weapon', 'army']",3.200000047683716,2,1844,3126,-1282,1643524
4166,"['british', 'archbishop', 'canterbury', 'change', 'career', 'cambridge']","['archbishop', 'canterbury', 'step', 'amid', 'rift']",2.400000095367432,2,1843,2250,-407,165649
4167,"['punjab', 'nail', 'detail', 'near', 'rohtak', 'injure']","['punjab', 'nail', 'detail', 'near', 'rohtak', 'haryana', 'injure']",4.199999809265137,6,5217,4810,407,165649
4168,"['george', 'zimmerman', 'charge', 'kill', 'trayvon', 'martin']","['george', 'zimmerman', 'charge', 'trayvon', 'martin', 'case', 'official', 'say']",4.0,5,4988,4559,429,184041
4169,"['indian', 'moist', 'rebel', 'offer', 'talk', 'free', 'italian', 'hostage']","['india', 'moist', 'rebel', 'talk', 'free', 'italians']",3.799999952316284,4,4544,4286,258,66564
4170,"['report', 'dead', 'shoot', 'empire', 'state', 'building']","['city', 'room', 'empire', 'state', 'building', 'shooting']",2.799999952316284,3,2946,2601,345,119025
4171,"['dead', 'pakistan', 'suicide', 'blast']","['dead', 'pakistan', 'factory', 'blaze']",1.0,2,1841,996,845,714025
4172,"['penn', 'state', 'football', 'player', 'react', 'sanction']","['penn', 'state', 'football', 'slam', 'ncaa', 'sanction']",2.400000095367432,4,4545,2248,2297,5276209
4173,"['israel', 'release', 'try', 'palestinian', 'prolong', 'hunger', 'strike']","['israel', 'minister', 'want', 'palestinian', 'leader', 'outer']",0.5,2,1840,596,1244,1547536
4174,"['report', 'say', 'side', 'syria', 'abuse', 'right']","['nato', 'leader', 'play', 'risk', 'turkey', 'syria', 'clash']",1.0,1,503,997,-494,244036
4175,"['girl', 'accuse', 'burn', 'moran', 'go', 'hiding']","['girl', 'accuse', 'burn', 'moran', 'fail']",3.200000047683716,4,4297,3090,1207,1456849
4176,"['france', 'warn', 'syria', 'chemical', 'weapon', 'use']","['concern', 'possible', 'syria', 'chemical', 'weapon']",2.200000047683716,3,3616,2011,1605,2576025
4177,"['life', 'threaten', 'widest', 'storm', 'fear']","['life', 'threaten', 'storms', 'feared', 'widest']",4.400000095367432,3,3610,5002,-1392,1937664
4178,"['chicago', 'teacher', 'strike', 'year', 'end', 'framework', 'agreement', 'place']","['general', 'strike', 'end', 'histadrut', 'treasury', 'reach', 'agreement']",0.800000011920929,3,2944,846,2098,4401604
4179,"['indonesian', 'president', 'visit']","['indonesian', 'president', 'visit', 'australia']",1.399999976158142,3,2945,1395,1550,2402500
4180,"['storm', 'delay', 'start', 'republican', 'convention']","['storm', 'lash', 'florida', 'delay', 'republican', 'convention']",4.400000095367432,4,3892,5003,-1111,1234321
4181,"['dato', 'kill', 'afghanistan', 'helicopter', 'crash', 'military']","['kill', 'afghan', 'bomb', 'attack', 'official']",0.800000011920929,1,501,861,-360,129600
4182,"['president', 'hills', 'quit', 'lecturer']","['president', 'john', 'evans', 'tea', 'hills', 'design', 'germany']",2.5999999046325684,2,1837,2492,-655,429025
4183,"['diam', 'seat', 'win', 'nba', 'final']","['diam', 'seat', 'clinch', 'nba', 'championship']",5.0,3,2947,5717,-2770,7672900
4184,"['japan', 'close', 'nuclear', 'reactor']","['japan', 'switch', 'nuclear', 'power', 'plant', 'weekend']",4.199999809265137,2,1836,4827,-2991,8946081
4185,"['ryanair', 'new', 'bid', 'sinus']","['ryanair', 'chief', 'nail', 'report', 'finding']",1.2000000476837158,1,499,1186,-687,471969
4186,"['russian', 'air', 'force', 'celebrate', 'anniversary']","['russian', 'air', 'force', 'anniversary']",4.400000095367432,4,3896,5011,-1115,1243225
4187,"['nato', 'troop', 'kill', 'afghanistan']","['nato', 'soldier', 'kill', 'afghanistan']",2.200000047683716,3,2950,1993,957,915849
4188,"['super', 'tuesday', 'pitt', 'money']","['money', 'lead', 'antrum', 'gop', 'super', 'tuesday', 'contest']",1.600000023841858,3,2951,1512,1439,2070721
4189,"['ruin', 'swear', 'russian', 'growth', 'filter']","['ruin', 'swear', 'russia', 'president', 'year']",2.400000095367432,2,1834,2247,-413,170569
4190,"['rule', 'daiichi', 'stop', 'lung', 'cancer', 'trial', 'share', 'tank']","['rule', 'stock', 'plunge', 'lung', 'cancer', 'study', 'shell']",3.400000095367432,3,2956,3462,-506,256036
4191,"['teenager', 'father', 'kill', 'crash']","['kill', 'horror', 'crash', 'name']",1.600000023841858,2,1833,1559,274,75076
4192,"['magnitude', 'quaker', 'strike', 'indonesia']","['magnitude', 'quaker', 'hit', 'papa', 'indonesia', 'usgs']",4.199999809265137,3,2957,4820,-1863,3470769
4193,"['americans', 'kill', 'afghan', 'unrest', 'enters', 'fifth']","['american', 'officers', 'murdered', 'afghan', 'unrest', 'continue']",4.199999809265137,2,1809,4819,-3010,9060100
4194,"['official', 'money', 'secret', 'service', 'protection']","['drama', 'address', 'secret', 'service', 'scandal']",0.6000000238418579,2,1842,637,1205,1452025
4195,"['japan', 'call', 'quick', 'tsunami', 'waste', 'processing']","['japan', 'mark', 'year', 'quaker', 'tsunami', 'disaster']",1.0,2,1808,1089,719,516961
4196,"['syrian', 'fighter', 'pilot', 'defect', 'jordan']","['syrian', 'defect', 'jordan']",1.399999976158142,3,2943,1407,1536,2359296
4197,"['syrian', 'arab', 'republic', 'syrian', 'arab', 'republic', 'syrian', 'refugees', 'june']","['syrian', 'arab', 'republic', 'kill', 'syria', 'ahead', 'anna', 'return']",1.2000000476837158,3,2942,1187,1755,3080025
4198,"['suicide', 'bomber', 'kill', 'afghanistan']","['suicide', 'bomber', 'kill', 'siberia', 'church']",1.2000000476837158,3,2941,1188,1753,3073009
4199,"['airline', 'cancel', 'flytilla', 'activist', 'ticket']","['airline', 'cancers', 'flytilla', 'rickets', 'israel', 'objection']",3.200000047683716,2,1781,3115,-1334,1779556
4200,"['pain', 'ask', 'bank', 'rescue']","['spaniard', 'trial', 'cuban', 'dissent', 'death']",0.2000000029802322,0,335,404,-69,4761
4201,"['murky', 'water', 'south', 'china', 'tea']","['peace', 'lie', 'south', 'china', 'tea']",1.399999976158142,3,2921,1377,1544,2383936
4202,"['ri', 'vanka', 'seek', 'day', 'revival', 'pakistan']","['senior', 'journalist', 'kill', 'pakistan']",0.6000000238418579,1,495,639,-144,20736
4203,"['space', 'dock', 'international', 'space', 'station', 'public', 'travel']","['space', 'dragon', 'locks', 'international', 'space', 'station']",3.799999952316284,3,2925,4298,-1373,1885129
4204,"['million', 'puppet', 'march', 'defend', 'drama', 'backing', 'pbs']","['million', 'puppet', 'march', 'plan', 'defend', 'backing', 'pbs']",4.0,6,5224,4617,607,368449
4205,"['syrian', 'opposition', 'reconciliation', 'talk']","['syrian', 'opposition', 'council', 'establish', 'envoy', 'france']",1.399999976158142,2,1779,1393,386,148996
4206,"['sense', 'point', 'budget', 'blue']","['money', 'will', 'volunteer', 'budget', 'difference']",1.0,1,494,1062,-568,322624
4207,"['facebook', 'boot', 'size', 'ipo', 'raise']","['facebook', 'boot', 'size', 'ipo', 'percent']",3.5999999046325684,4,3877,3792,85,7225
4208,"['ran', 'parliament', 'questions', 'dismissive', 'ahmadinejad']","['ran', 'parliament', 'question', 'president', 'ahmadinejad']",4.0,3,2935,4621,-1686,2842596
4209,"['semen', 'suicide', 'attack', 'kill', 'soldier', 'official']","['afghan', 'suicide', 'car', 'bomb', 'kill', 'seven', 'official']",1.600000023841858,3,2939,1584,1355,1836025
4210,"['presidential', 'vote', 'polarise', 'egyptians']","['gop', 'presidential', 'hopeful', 'clash', 'southern', 'race']",0.800000011920929,1,491,843,-352,123904
4211,"['soldier', 'kill', 'afghanistan']","['nato', 'soldier', 'kill', 'afghanistan']",1.7999999523162842,3,2953,1729,1224,1498176
4212,"['police', 'raise', 'death', 'toll', 'bus', 'accident']","['money', 'king', 'death', 'rule', 'accidental']",0.4000000059604645,1,404,509,-105,11025
4213,"['foreign', 'soldier', 'kill', 'afghan', 'east']","['british', 'soldier', 'kill', 'afghan', 'insider', 'attack']",0.800000011920929,3,2967,873,2094,4384836
4214,"['red', 'cross', 'worker', 'kill', 'pakistan']","['british', 'red', 'cross', 'doctor', 'kidnap', 'pakistan', 'find', 'behead']",3.5999999046325684,3,2994,3799,-805,648025
4215,"['afghan', 'goat', 'sign', 'deal', 'controversial', 'night', 'raid']","['afghan', 'sign', 'deal', 'night', 'maid']",3.799999952316284,4,3900,4307,-407,165649
4216,"['china', 'accident', 'kill']","['china', 'truck', 'accident', 'kill']",1.600000023841858,3,2997,1582,1415,2002225
4217,"['australia', 'ellipse', 'england', 'indies']","['australian', 'defiant', 'pressure', 'leadership']",0.4000000059604645,0,324,512,-188,35344
4218,"['protest', 'hussy', 'riot', 'verdict']","['hussy', 'riot', 'verdict', 'greet', 'defiance']",3.400000095367432,3,3000,3491,-491,241081
4219,"['secret', 'service', 'see', 'big', 'scandal', 'prostitute']","['secret', 'service', 'sex', 'scandal', 'regret']",2.200000047683716,3,3003,2015,988,976144
4220,"['wait', 'activist', 'storm', 'syrian', 'embassy', 'injure']","['activist', 'storm', 'syria', 'embassy', 'wait']",3.400000095367432,4,3947,3523,424,179776
4221,"['detail', 'hung', 'visit', 'ireland']","['rapturous', 'welcome', 'hung', 'historic', 'trip']",3.400000095367432,1,422,3522,-3100,9610000
4222,"['key', 'say', 'marie', 'visit', 'lost', 'opportunity']","['key', 'want', 'waitangi', 'marie', 'visit', 'stay']",2.200000047683716,3,3007,2017,990,980100
4223,"['norway', 'mark', 'anniversary', 'massacre']","['norway', 'marks', 'anniversary', 'breivik', 'massacre']",3.799999952316284,3,3009,4305,-1296,1679616
4224,"['woman', 'kill', 'fall', 'debris']","['ally', 'decline']",0.0,0,323,222,101,10201
4225,"['share', 'interest', 'rate', 'cut']","['rba', 'deliver', 'rate', 'cut']",1.0,2,1772,1084,688,473344
4226,"['germany', 'warn', 'greece', 'money', 'reform']","['zone', 'greece', 'rescue', 'reform']",2.5999999046325684,2,1770,2478,-708,501264
4227,"['drama', 'meet', 'family', 'shoot', 'victim']","['drama', 'meet', 'batman', 'gun', 'victim']",3.200000047683716,3,2991,3092,-101,10201
4228,"['drama', 'widen', 'lead', 'money', 'despite', 'job', 'datum', 'letters', 'psoas', 'poll']","['money', 'take', 'lead', 'drama', 'convention', 'bounce', 'letters', 'psoas', 'poll']",1.0,6,5169,923,4246,18028516
4229,"['kill', 'injure', 'toronto', 'shooting']","['dead', 'injure', 'inland', 'shooting']",1.399999976158142,2,1768,1425,343,117649
4230,"['hope', 'butler', 'see', 'aide', 'arrest', 'vatican', 'lead']","['hope', 'butler', 'arrest', 'scandal', 'vatican', 'lead']",3.400000095367432,5,4868,3436,1432,2050624
4231,"['anti', 'ruin', 'protest', 'form', 'human', 'chain', 'moscow']","['anti', 'ruin', 'protest', 'form', 'human', 'chain']",3.799999952316284,6,5183,4325,858,736164
4232,"['washington', 'acts', 'congress', 'cell']","['george', 'washington', 'copy', 'constitution', 'cell']",2.5999999046325684,2,1767,2456,-689,474721
4233,"['maker', 'fire', 'coach', 'like', 'grown', 'start']","['maker', 'fire', 'like', 'grown', 'start']",4.400000095367432,5,4871,4972,-101,10201
4234,"['canadian', 'muslims', 'issue', 'fate', 'honor', 'kill']","['canadian', 'mass', 'issue', 'fate', 'honour', 'killing']",3.400000095367432,3,2970,3442,-472,222784
4235,"['syria', 'resolution']","['assembly', 'note', 'syria', 'resolution']",3.5999999046325684,2,1766,3805,-2039,4157521
4236,"['soldier', 'recall', 'massacre']","['soldier', 'recall', 'massacre']",4.400000095367432,3,2973,4971,-1998,3992004
4237,"['tibia', 'name', 'new', 'cabinet', 'protest', 'original']","['libyan', 'assembly', 'reject', 'new', 'cabinet', 'dismiss']",1.2000000476837158,2,1765,1189,576,331776
4238,"['foreign', 'soldier', 'kill', 'afghan', 'east']","['french', 'soldier', 'report', 'kill', 'afghanistan']",3.799999952316284,2,1763,4252,-2489,6195121
4239,"['syrian', 'force', 'storm', 'central', 'town']","['syrian', 'force', 'bombard', 'russia', 'warn', 'civil', 'war']",2.5,2,1783,2336,-553,305809
4240,"['oak', 'dead', 'anti', 'slam', 'film', 'protest']","['injure', 'anti', 'slam', 'film', 'protest', 'islamabad', 'pakistan']",2.200000047683716,4,3918,2060,1858,3452164
4241,"['cause', 'whitney', 'houston', 'death', 'week']","['investigator', 'seek', 'answer', 'whitney', 'houston', 'death']",1.7999999523162842,3,2979,1736,1243,1545049
4242,"['n', 'warn', 'retaliation', 'south', 'drill']","['north', 'warn', 'retaliation', 'soul', 'naval', 'drill', 'plan']",3.5999999046325684,3,2980,3828,-848,719104
4243,"['pale', 'masses', 'new', 'work', 'giants', 'super', 'bowl']","['lesser', 'evil', 'triumph', 'super', 'bowl']",1.399999976158142,2,1784,1408,376,141376
4244,"['dead', 'new', 'israel', 'strike', 'papa']","['kill', 'new', 'israel', 'strike', 'papa', 'medius']",3.5999999046325684,4,3923,3829,94,8836
4245,"['germany', 'likely', 'dress', 'russia', 'syrian', 'crisis']","['russia', 'think', 'syria', 'brief', 'guide']",1.0,1,407,909,-502,252004
4246,"['seriously', 'injure', 'motorway', 'crash']","['injure', 'motorway', 'crash']",3.5999999046325684,3,2983,3816,-833,693889
4247,"['aid', 'chief', 'amos', 'enter', 'papa', 'mr', 'red', 'crescent']","['syria', 'besiege', 'papa', 'mr', 'desert', 'red', 'cross', 'say']",2.0,3,2985,1804,1181,1394761
4248,"['dozen', 'kill', 'iberian', 'riot']","['dozen', 'kill', 'demyan', 'clash']",1.0,2,1805,913,892,795664
4249,"['profile', 'egypt', 'main', 'presidential', 'candidate']","['second', 'day', 'egyptian', 'presidential', 'election']",1.2000000476837158,1,426,1190,-764,583696
4250,"['actor', 'gazzara', 'dead']","['actor', 'men', 'gazzara', 'die']",4.400000095367432,2,1802,4978,-3176,10086976
4251,"['british', 'gold', 'rush', 'silence', 'grape', 'cost']","['british', 'soldier', 'kill', 'afghan', 'insider', 'attack']",0.6000000238418579,1,456,652,-196,38416
4252,"['avalanche', 'bury', 'pakistani', 'soldier']","['avalanche', 'bury', 'pakistani', 'soldier']",4.599999904632568,4,3932,5175,-1243,1545049
4253,"['inflation', 'fall', 'month', 'low', 'analysis']","['inflation', 'fall', 'month', 'low']",4.599999904632568,4,3934,5174,-1240,1537600
4254,"['woman', 'will', 'cut', 'planned', 'parenthood', 'funding']","['susan', 'g', 'women', 'u', 'turn', 'planned', 'parenthood', 'funding', 'cut']",3.0,4,3936,2849,1087,1181569
4255,"['amp', 'old', 'august']","['old', 'july']",2.200000047683716,1,455,2029,-1574,2477476
4256,"['ran', 'say', 'nuclear', 'talk', 'continue']","['ran', 'say', 'nuclear', 'talk', 'constructive']",2.799999952316284,4,3839,2604,1235,1525225
4257,"['agribusiness', 'cow', 'disease', 'find', 'california']","['usda', 'confirm', 'case', 'disease', 'california']",4.199999809265137,2,1800,4875,-3075,9455625
4258,"['cell', 'gulf', 'mexico', 'asset', 'bill']","['cell', 'gulf', 'mexico', 'asset', 'plains']",3.5999999046325684,4,3837,3759,78,6084
4259,"['potential', 'jimmy', 'vile', 'victim', 'police']","['potential', 'vile', 'abuse', 'victim', 'emerge']",3.5999999046325684,3,2853,3756,-903,815409
4260,"['armstrong', 'step', 'livestrong']","['armstrong', 'stand', 'livestrong']",4.599999904632568,2,1798,5173,-3375,11390625
4261,"['drone', 'strike', 'kill', 'militant', 'pakistan']","['drone', 'strike', 'kill', 'suspect', 'militant', 'semen']",1.7999999523162842,4,3849,1717,2132,4545424
4262,"['syrian', 'get', 'will', 'not', 'stop', 'attack']","['syrian', 'opposition', 'report', 'massacre']",1.0,1,452,918,-466,217156
4263,"['chinese', 'stock', 'close', 'high', 'midday', 'friday']","['chinese', 'stock', 'high', 'midday', 'friday']",4.599999904632568,5,4837,5172,-335,112225
4264,"['myanmar', 'opposition', 'claim', 'win']","['voter', 'myanmar', 'hopeful', 'party', 'claim', 'win']",3.200000047683716,3,2869,3298,-429,184041
4265,"['drama', 'poll', 'rating', 'drop', 'boost', 'republican', 'rival']","['drama', 'big', 'hispanic', 'win', 'worry', 'republicans']",1.0,1,451,928,-477,227529
4266,"['soldier', 'wound', 'afghanistan']","['foreign', 'soldier', 'kill', 'afghan', 'east']",1.2000000476837158,1,450,1191,-741,549081
4267,"['new', 'syria', 'opposition', 'chief', 'want', 'string', 'aid']","['syria', 'opposition', 'unite', 'israel', 'fire', 'warn', 'shot']",1.0,2,1793,892,901,811801
4268,"['south', 'africa', 'clash', 'kill']","['south', 'africa', 'train', 'crash', 'kill']",0.800000011920929,3,2867,852,2015,4060225
4269,"['syrian', 'force', 'bombard', 'russia', 'warn', 'civil', 'war']","['syrian', 'force', 'bombard', 'uvarov', 'arrive', 'talk']",2.5999999046325684,3,2848,2408,440,193600
4270,"['egypt', 'presidential', 'election', 'result', 'delay']","['egyptian', 'election', 'result', 'delay']",4.199999809265137,3,2846,4879,-2033,4133089
4271,"['headline', 'pass', 'new', 'ran', 'sanction']","['moves', 'close', 'new', 'ran', 'actions']",1.600000023841858,2,1791,1532,259,67081
4272,"['arrest', 'russian', 'killer', 'deny', 'tie', 'hussy', 'riot']","['dozen', 'arrest', 'russian', 'tower', 'protest']",0.800000011920929,2,1790,855,935,874225
4273,"['norway', 'memorial', 'honour', 'massacre', 'victim']","['norway', 'mark', 'anniversary', 'massacre']",2.799999952316284,2,1789,2602,-813,660969
4274,"['afghanistan', 'general', 'link', 'petraeus', 'scandal']","['senior', 'general', 'link', 'petraeus', 'scandal']",3.799999952316284,4,3833,4107,-274,75076
4275,"['chinese', 'stock', 'fall', 'rrr', 'cut']","['chinese', 'stock', 'gain', 'midday', 'monday']",2.0,2,1788,1787,1,1
4276,"['chorea', 'make', 'significant', 'nuclear', 'reactor', 'progress', 'iaea']","['vow', 'expand', 'nuclear', 'deter']",2.799999952316284,1,447,2619,-2172,4717584
4277,"['maldive', 'president', 'quit', 'police', 'mutiny', 'protest']","['maldive', 'president', 'quit', 'week', 'protest']",3.400000095367432,4,3850,3652,198,39204
4278,"['nato', 'strike', 'kill', 'civilian', 'afghanistan']","['nato', 'soldier', 'kill', 'afghanistan']",0.800000011920929,3,2835,856,1979,3916441
4279,"['ll', 'said', 'say', 'capture', 'cement', 'soldier', 'bryan', 'battle']","['ll', 'qaeda', 'clash', 'blast', 'kill', 'soldier', 'semen']",1.399999976158142,2,1786,1399,387,149769
4280,"['navy', 'jet', 'clash', 'apartment', 'pilot', 'erect']","['navy', 'met', 'rashes', 'virginia', 'apartment', 'building']",3.400000095367432,2,1668,3473,-1805,3258025
4281,"['china', 'stock', 'open', 'high', 'wednesday']","['stock', 'open', 'higher', 'despite', 'gdp', 'miss']",0.800000011920929,2,1787,857,930,864900
4282,"['idf', 'deploy', 'iron', 'central', 'israel']","['major', 'snowstorm', 'barrel', 'central', 'plains']",0.0,1,444,228,216,46656
4283,"['kill', 'prone', 'strike', 'pakistan']","['prone', 'strike', 'hills', 'pakistan']",3.0,3,2837,2828,9,81
4284,"['hold', 'chicago', 'car', 'bomb', 'plot']","['chicago', 'arrest', 'chicago', 'car', 'bomb', 'plot']",3.400000095367432,4,3966,3525,441,194481
4285,"['david', 'rathband', 'twin', 'brother', 'fear', 'beset', 'mate']","['david', 'miliband', 'brother', 'return', 'old', 'labour']",0.2000000029802322,2,1797,432,1365,1863225
4286,"['syrian', 'force', 'retaken', 'aleppo']","['syrian', 'regime', 'lids', 'city', 'aleppo']",4.400000095367432,2,1801,4998,-3197,10220809
4287,"['member', 'parliamentary', 'trade', 'team', 'leave', 'india']","['commerce', 'secretary', 'leave', 'absence']",0.0,1,440,230,210,44100
4288,"['street', 'opens', 'power']","['street', 'end', 'fix']",2.0,1,437,1776,-1339,1792921
4289,"['europe', 'share', 'bounce', 'china', 'stimulus', 'see']","['oil', 'price', 'rise', 'hope', 'stimulus']",0.800000011920929,1,435,864,-429,184041
4290,"['stock', 'index', 'future', 'point', 'lower', 'start']","['stock', 'index', 'future', 'signal', 'early', 'loss']",4.400000095367432,3,2917,4966,-2049,4198401
4291,"['charge', 'hurt', 'attack']","['charge', 'murder', 'flat']",1.399999976158142,1,434,1398,-964,929296
4292,"['foka', 'apology', 'face', 'ad']","['wife', 'rider', 'oak', 'aid']",0.0,0,295,231,64,4096
4293,"['drone', 'strike', 'kill', 'militant', 'pakistan']","['prone', 'strike', 'kill', 'suspect', 'militant', 'pakistan']",3.0,4,4110,2837,1273,1620529
4294,"['syria', 'rebel', 'leave', 'besiege']","['syrian', 'rebel', 'retreat', 'besiege', 'district']",4.400000095367432,2,1771,5004,-3233,10452289
4295,"['order', 'non', 'essential', 'staff', 'leave', 'sudan', 'tunisia']","['order', 'non', 'essential', 'staff', 'leave', 'tunisia', 'sudan']",4.0,7,5356,4619,737,543169
4296,"['egypt', 'mubarak', 'critical']","['egypt', 'mubarak', 'critical', 'condition']",4.599999904632568,3,2910,5197,-2287,5230369
4297,"['sad', 'say', 'mercenary', 'syria', 'unrest']","['sad', 'accuses', 'duel', 'syrian', 'uprising']",3.3333332538604736,1,431,3421,-2990,8940100
4298,"['japan', 'dissolve', 'low', 'house', 'election']","['ran', 'world', 'power', 'set', 'nuclear', 'talk']",0.0,0,293,232,61,3721
4299,"['kill', 'new', 'israel', 'strike', 'papa', 'medius']","['die', 'strike', 'papa', 'militant', 'carriage', 'israel']",2.0,3,2906,1794,1112,1236544
4300,"['navy', 'jet', 'clash', 'virginia', 'building', 'injure']","['navy', 'jet', 'clash', 'virginia', 'hurt']",3.200000047683716,4,4117,3256,861,741321
4301,"['nato', 'soldier', 'kill', 'afghanistan']","['british', 'soldier', 'kill', 'southern', 'afghanistan']",3.200000047683716,3,2882,3253,-371,137641
4302,"['pain', 'bless', 'rate', 'hit', 'new', 'high']","['pain', 'bless', 'claim', 'hit', 'new', 'high']",4.199999809265137,5,4935,4882,53,2809
4303,"['turkey', 'scramble', 'jet', 'near', 'border']","['turkey', 'scramble', 'jet', 'syrian', 'border']",3.5999999046325684,4,4118,3746,372,138384
4304,"['die', 'syria', 'violence', 'monitor', 'land']","['year', 'ban', 'contador']",0.0,0,272,233,39,1521
4305,"['civilian', 'detector', 'kill', 'syria', 'say', 'ngo']","['syria', 'luman', 'kill', 'syrian', 'officer', 'ngo']",1.0,3,2875,945,1930,3724900
4306,"['taiwan', 'rattle', 'strong', 'earthquake']","['china', 'rock', 'twin', 'earthquake']",1.2000000476837158,1,524,1194,-670,448900
4307,"['bank', 'england', 'paul', 'pucker', 'paint', 'labor', 'mess']","['bank', 'england', 'deputy', 'deny', 'order', 'rate', 'rigging']",2.799999952316284,2,1835,2606,-771,594441
4308,"['red', 'cross', 'say', 'negotiate', 'halt', 'fighting', 'syria', 'aid']","['red', 'cross', 'negotiate', 'syria', 'ceasefire', 'bring', 'aid']",4.400000095367432,5,4918,4970,-52,2704
4309,"['syrian', 'force', 'shoot', 'civilian', 'bus']","['syrian', 'force', 'rebel', 'clash', 'near', 'turkey']",0.800000011920929,2,1839,839,1000,1000000
4310,"['german', 'parliament', 'overwhelmingly', 'back', 'greek', 'rescue', 'deal']","['german', 'parliament', 'endorse', 'greek', 'ballot']",4.400000095367432,3,2881,4968,-2087,4355569
4311,"['coming', 'clash', 'continue', 'syria']","['coming', 'clash', 'syria', 'opposition', 'seek', 'arm']",3.400000095367432,3,2885,3563,-678,459684
4312,"['bursa', 'reform', 'bring', 'easing', 'sanction']","['bursa', 'activist', 'slow', 'ease', 'sanction']",2.400000095367432,2,1853,2211,-358,128164
4313,"['say', 'bolt', 'win', 'm', 'reaction']","['facebook', 'mobile', 'gain', 'drive', 'revenue', 'growth', 'reaction']",0.2000000029802322,1,624,409,215,46225
4314,"['dozen', 'dead', 'taliban', 'resort', 'attack']","['india', 'police', 'iranians', 'embassy', 'attack']",0.4000000059604645,1,623,487,136,18496
4315,"['heavy', 'fighting', 'rock', 'eastern', 'syria', 'ahead', 'poll']","['heavy', 'fighting', 'rock', 'eastern', 'syria', 'resident']",3.799999952316284,5,4903,4104,799,638401
4316,"['china', 'juan', 'weaken', 'usd', 'monday']","['china', 'juan', 'retreat', 'usd', 'thursday']",2.799999952316284,3,2918,2609,309,95481
4317,"['dead', 'christian', 'school', 'shooting']","['wound', 'ohio', 'school', 'shooting']",1.399999976158142,2,1831,1390,441,194481
4318,"['indonesia', 'anti', 'terror', 'squad', 'kill', 'suspect', 'militant']","['indonesia', 'police', 'shoot', 'dead', 'suspect', 'militant', 'ali']",3.200000047683716,3,3013,3231,-218,47524
4319,"['election', 'pitt', 'money', 'concede', 'defeat', 'track', 'drama', 'win', 'second', 'term']","['money', 'concede', 'election', 'drama', 'phone']",4.0,4,4096,4605,-509,259081
4320,"['armenians', 'vote', 'parliamentary', 'election']","['armenia', 'parliamentary', 'vote', 'test', 'president']",3.200000047683716,2,1810,3241,-1431,2047761
4321,"['machine', 'tendulkar', 'swear', 'indian', 'senator']","['machine', 'tendulkar', 'say', 'got', 'bungalow']",1.600000023841858,2,1812,1551,261,68121
4322,"['navy', 'met', 'rashes', 'apartment', 'building']","['navy', 'met', 'rashes', 'virginia', 'apartment', 'building']",3.5999999046325684,5,4914,3771,1143,1306449
4323,"['money', 'win', 'big', 'huerta', 'rico', 'primary']","['money', 'win', 'illinois', 'primary']",1.5,3,3135,1443,1692,2862864
4324,"['yahoo', 'google', 'layer', 'ceo', 'report']","['yahoo', 'name', 'google', 'layer', 'ceo']",4.199999809265137,4,4087,4815,-728,529984
4325,"['soldier', 'accuse', 'afghan', 'massacre', 'fire', 'prominent', 'criminal', 'lawyer']","['soldier', 'accuse', 'kill', 'afghan', 'civilian', 'identify']",2.0,3,3138,1790,1348,1817104
4326,"['magnitude', 'quaker', 'hit', 'northern', 'italy', 'usgs']","['magnitude', 'quaker', 'hit', 'funds', 'trait', 'indonesia', 'usgs']",1.600000023841858,4,4091,1549,2542,6461764
4327,"['officially', 'designate', 'haqqani', 'network', 'terrorist']","['designate', 'haqqani', 'network', 'terrorist']",4.400000095367432,4,4092,4974,-882,777924
4328,"['motor', 'facing', 'button', 'fat', 'year', 'practice']","['button', 'boat', 'good', 'time', 'practice']",3.0,2,1813,2916,-1103,1216609
4329,"['danger', 'vote', 'division']","['danger', 'vote', 'division']",4.800000190734863,3,3142,5427,-2285,5221225
4330,"['newark', 'mayor', 'save', 'neighbor', 'fire']","['newark', 'mayor', 'rescue', 'neighbor', 'burn', 'house']",4.199999809265137,3,3143,4821,-1678,2815684
4331,"['protest', 'bahrain']","['day', 'rage', 'bahrain']",2.25,1,622,2160,-1538,2365444
4332,"['new', 'work', 'stock', 'exchange', 'open', 'wednesday']","['dealbook', 'stock', 'exchange', 'prepare', 'open']",3.0,3,3155,2899,256,65536
4333,"['mortar', 'fire', 'kill']","['offensive', 'kill']",2.5999999046325684,1,621,2445,-1824,3326976
4334,"['hundred', 'honor', 'student', 'kill', 'ohio', 'shooting']","['funeral', 'set', 'ohio', 'shoot', 'victim']",2.0,1,620,1872,-1252,1567504
4335,"['bomb', 'southern', 'thailand', 'kill', 'wind']","['bomb', 'thailand', 'kill', 'wind']",3.0,4,4164,2875,1289,1661521
4336,"['lawmaker', 'step', 'new', 'ran', 'sanction']","['somalia', 'lawmaker', 'vote', 'new', 'president']",0.2000000029802322,2,1815,418,1397,1951609
4337,"['track', 'drama', 'admit', 'nuclear', 'weapon', 'need']","['french', 'german', 'want', 'die', 'weapon', 'hand']",0.4000000059604645,1,619,491,128,16384
4338,"['ricket', 'hit', 'eshkol', 'region', 'injury']","['ricket', 'minute', 'eshkol', 'regional', 'council']",1.7999999523162842,2,1817,1752,65,4225
4339,"['betrayed', 'disabled', 'worker', 'protest', 'employ', 'closure']","['mark', 'protest', 'austerity', 'cut']",0.6000000238418579,1,618,623,-5,25
4340,"['long', 'rebel', 'kill', 'park', 'ranger']","['rebel', 'kill', 'park', 'ranger', 'eastern', 'long']",4.0,5,4899,4538,361,130321
4341,"['line', 'pakistani', 'troop', 'kill', 'militant', 'ambush']","['trade', 'pakistan', 'india', 'agree', 'step', 'ahead']",0.800000011920929,0,266,883,-617,380689
4342,"['dead', 'egypt', 'soccer', 'violence']","['die', 'egyptian', 'soccer', 'pitch', 'invasion']",3.200000047683716,1,615,3293,-2678,7171684
4343,"['unrest', 'tense', 'siberia', 'leave', 'dead']","['southwest', 'china', 'quaker', 'kill']",0.2000000029802322,0,264,422,-158,24964
4344,"['hurricane', 'bandy', 'make', 'windfall', 'southwestern', 'jamaica', 'nhc']","['hurricane', 'bandy', 'reach', 'jamaica']",3.0,3,3118,2818,300,90000
4345,"['remark', 'crime', 'minister', 'elkeib', 'meeting']","['remark', 'foreign', 'minister', 'koichiro', 'emma']",1.5,2,1701,1440,261,68121
4346,"['patrick', 'talk', 'china', 'firm', 'african', 'asset']","['drama', 'aide', 'hold', 'talk', 'china', 'syria', 'veto']",1.2000000476837158,2,1707,1195,512,262144
4347,"['attacker', 'strategy']","['sonya', 'attacker', 'strategy']",3.0,2,1709,2886,-1177,1385329
4348,"['weak', 'earning', 'drag', 'stock', 'low']","['weak', 'earning', 'drag', 'stock', 'lower', 'street']",3.799999952316284,4,4153,4079,74,5476
4349,"['quaker', 'strike', 'solomon', 'islands']","['magnitude', 'quaker', 'strike', 'solomon', 'islands', 'usgs']",3.200000047683716,4,4152,3323,829,687241
4350,"['liquid', 'ammonia', 'leak', 'kill', 'shanghai']","['liquid', 'ammonia', 'leak', 'kill', 'shanghai']",4.599999904632568,5,4932,5198,-266,70756
4351,"['friend', 'syria', 'recognize', 'opposition', 'coalition', 'legitimate', 'representative', 'syrian', 'people']","['friends', 'syria', 'recognise', 'opposition', 'sole', 'representative']",4.0,3,3122,4532,-1410,1988100
4352,"['rein', 'stay', 'nyc', 'mayor', 'race', 'amid', 'new', 'setting', 'scandal']","['rein', 'shrug', 'late', 'online', 'sex', 'scandal']",3.0,2,1691,2891,-1200,1440000
4353,"['death', 'toll', 'rise', 'russia', 'plane', 'crash']","['death', 'toll', 'rise', 'italy', 'coach', 'crash']",0.0,4,4132,135,3997,15976009
4354,"['indian', 'medium', 'commonwealth', 'summit']","['indian', 'snub', 'commonwealth', 'summit']",2.799999952316284,3,3129,2598,531,281961
4355,"['syria', 'military', 'police', 'chief', 'defect', 'opposition']","['syria', 'military', 'police', 'chief', 'defect', 'rebel']",5.0,5,4928,5722,-794,630436
4356,"['dreamliner', 'catch', 'fire', 'stock', 'take', 'beating']","['stock', 'tumbler', 'fire', 'dreamliner']",4.599999904632568,3,3130,5221,-2091,4372281
4357,"['cette', 'cooper', 'back', 'gay', 'marriage', 'bill']","['white', 'house', 'back', 'gay', 'marriage']",2.5999999046325684,3,3132,2472,660,435600
4358,"['kill', 'belgian', 'coach', 'crash']","['teenager', 'dead', 'belgian', 'bus', 'crash']",3.799999952316284,2,1671,4082,-2411,5812921
4359,"['luman', 'abduct', 'seven', 'foreign', 'worker', 'siberia']","['foreign', 'worker', 'kidnap', 'siberia']",3.400000095367432,3,3158,3557,-399,159201
4360,"['swiss', 'tourist', 'gang', 'rapid', 'india']","['swiss', 'tourist', 'gang', 'rapid', 'india', 'police']",5.0,5,4857,5723,-866,749956
4361,"['palestinians', 'clash', 'israel', 'force', 'west', 'bank', 'jerusalem']","['palestinians', 'clash', 'security', 'force', 'bank']",4.199999809265137,4,4139,4811,-672,451584
4362,"['israel', 'plane', 'strike', 'inside', 'syria']","['israel', 'launch', 'airstrike', 'syria']",4.599999904632568,2,1674,5220,-3546,12574116
4363,"['iranians', 'note', 'presidential', 'election']","['deity', 'sins', 'ali', 'presidential', 'election']",0.4000000059604645,2,1683,567,1116,1245456
4364,"['kill', 'new', 'darfur', 'trial', 'clash']","['head', 'new', 'darfur', 'trial', 'clash']",2.799999952316284,4,4145,2595,1550,2402500
4365,"['protest', 'drone', 'strike', 'oak', 'postpone']","['kill', 'drone', 'strike', 'pakistan']",1.399999976158142,2,1742,1419,323,104329
4366,"['kill', 'bus', 'accident', 'pakistan']","['kill', 'road', 'accident', 'pakistan']",3.200000047683716,3,3191,3228,-37,1369
4367,"['warn', 'set', 'high', 'bar', 'change']","['warn', 'set', 'high', 'bar', 'change', 'bank', 'england']",5.0,5,4848,5657,-809,654481
4368,"['arrest', 'deadly', 'bangladesh', 'building', 'collapse']","['arrest', 'bangladesh', 'building', 'toll', 'rise']",2.400000095367432,3,3193,2190,1003,1006009
4369,"['suicide', 'bomber', 'kill', 'base', 'afghanistan']","['suicide', 'comber', 'attack', 'base', 'afghanistan']",2.799999952316284,3,3203,2592,611,373321
4370,"['afghan', 'flock', 'college', 'taliban', 'loom']","['afghan', 'district', 'governor', 'defect', 'taliban']",0.6000000238418579,2,1746,661,1085,1177225
4371,"['north', 'postpone', 'family', 'unions', 'south']","['north', 'postpone', 'family', 'union', 'south']",5.0,4,4044,5702,-1658,2748964
4372,"['apple', 'revenue', 'miss', 'shine', 'disappoint']","['trade', 'agency', 'rule', 'samsung', 'bank', 'shine', 'import']",0.6000000238418579,1,607,712,-105,11025
4373,"['luman', 'kill', 'foreign', 'tourist', 'northern', 'pakistan']","['luman', 'kill', 'foreign', 'limber', 'pakistan']",3.400000095367432,4,3993,3564,429,184041
4374,"['david', 'beckham', 'announce', 'retirement', 'soccer']","['david', 'beckham', 'retire', 'football']",4.400000095367432,2,1754,4994,-3240,10497600
4375,"['watt', 'smith', 'leave', 'doctor', 'year']","['watt', 'smith', 'quit', 'bbc', 'doctor']",4.0,3,3200,4569,-1369,1874161
4376,"['generation', 'divide', 'gay', 'marriage']","['summit', 'end', 'divide', 'syria']",0.0,1,525,100,425,180625
4377,"['kill', 'ran', 'car', 'coming']","['kill', 'ran', 'bomb', 'attack']",1.600000023841858,2,1756,1536,220,48400
4378,"['meet', 'fire', 'national', 'lies', 'injuries']","['set', 'ablaze', 'national', 'die']",5.0,1,605,5608,-5003,25030009
4379,"['taliban', 'attack', 'kill', 'civilian', 'afghanistan']","['series', 'attack', 'kill', 'police', 'afghanistan']",1.399999976158142,3,3168,1409,1759,3094081
4380,"['egypt', 'minister', 'survive', 'assassination', 'attempt']","['syrian', 'prime', 'minister', 'survive', 'assassination', 'attempt']",1.600000023841858,4,3999,1560,2439,5948721
4381,"['x', 'lady', 'barbara', 'rush', 'leave', 'texas', 'hospital']","['lady', 'barbara', 'rush', 'leave', 'hospital']",4.599999904632568,5,4874,5217,-343,117649
4382,"['schumacher', 'coma', 'ski', 'accident']","['michael', 'schumacher', 'coma', 'fighting', 'life', 'follow', 'skin', 'accident']",4.0,3,3161,4563,-1402,1965604
4383,"['kill', 'chinese', 'police', 'station', 'attack']","['kill', 'china', 'police', 'station', 'attack']",5.0,4,4002,5587,-1585,2512225
4384,"['bradley', 'cooper', 'beams', 'talk', 'fill', 'dance', 'armstrong', 'topic']","['bradley', 'cooper', 'talk', 'play', 'dance', 'armstrong', 'topic']",4.0,6,5109,4561,548,300304
4385,"['airline', 'clash', 'russia', 'kill']","['airline', 'clash', 'russian', 'city', 'kazan', 'kill']",3.799999952316284,3,3165,4100,-935,874225
4386,"['minister', 'determine', 'resolve', 'horseman', 'scandal']","['minister', 'hold', 'crisis', 'talk', 'horse', 'meat', 'scandal']",4.400000095367432,2,1718,4996,-3278,10745284
4387,"['opposition', 'party', 'boycott', 'general', 'election']","['opposition', 'announce', 'election', 'boycott']",4.800000190734863,3,3170,5440,-2270,5152900
4388,"['bangladesh', 'building', 'collapse', 'death', 'toll', 'hit', 'army']","['bangladesh', 'building', 'collapse', 'death', 'toll', 'pass']",2.5999999046325684,5,4870,2457,2413,5822569
4389,"['pagan', 'eddy', 'shift', 'hospital', 'power', 'crisis', 'continue', 'seemandhra']","['telangana', 'pagan', 'spend', 'thursday', 'hospital', 'blackest', 'continue', 'seemandhra']",4.199999809265137,4,4010,4809,-799,638401
4390,"['central', 'african', 'republic', 'president', 'overthrow', 'rebel']","['central', 'african', 'republic', 'president', 'step']",2.5999999046325684,4,4011,2458,1553,2411809
4391,"['brazil', 'tie', 'england', 'maracana', 'open']","['brazil', 'hold', 'england', 'maracana', 'open']",5.0,4,4012,5588,-1576,2483776
4392,"['california', 'wildlife', 'line', 'firefighter', 'labor', 'limit', 'damage', 'video']","['california', 'wildlife', 'grow', 'official', 'fire', 'crew', 'make', 'progress']",3.799999952316284,2,1721,4096,-2375,5640625
4393,"['george', 'rush', 'warn', 'bitter', 'immigration', 'debate']","['george', 'w', 'rush', 'weigh', 'immigration', 'debate']",3.0,4,4013,2804,1209,1461681
4394,"['angela', 'hospitalize', 'respond', 'treatment']","['angela', 'hospitalise', 'stop', 'talk']",3.400000095367432,1,604,3566,-2962,8773444
4395,"['russia', 'condemn', 'north', 'organ', 'nuclear', 'test']","['south', 'confirm', 'north', 'conduct', 'controversial', 'nuclear', 'test']",1.2000000476837158,3,3173,1197,1976,3904576
4396,"['hundred', 'bangladesh', 'clothe', 'factory', 'worker', 'ill']","['hundred', 'fall', 'sick', 'bangladesh', 'factory']",4.400000095367432,3,3174,5001,-1827,3337929
4397,"['semen', 'suicide', 'come', 'kill', 'soldier']","['female', 'suicide', 'bomber', 'kill', 'russian', 'station']",2.0,2,1729,1864,-135,18225
4398,"['wrap', 'russian', 'coal', 'blast']","['man', 'kill', 'russia', 'coal', 'blast']",2.799999952316284,2,1734,2590,-856,732736
4399,"['protest', 'break', 'army', 'headquarters']","['protest', 'storm', 'army', 'headquarter']",4.599999904632568,2,1994,5216,-3222,10381284
4400,"['israel', 'conduct', 'airstrike', 'syria']","['israel', 'launch', 'new', 'airstrike', 'syria']",4.400000095367432,3,3176,5019,-1843,3396649
4401,"['police', 'fire', 'tear', 'gas', 'disperse', 'protest', 'gun']","['police', 'fire', 'tear', 'gas', 'protest', 'cairo']",2.200000047683716,5,5002,2071,2931,8590761
4402,"['egypt', 'main', 'opposition', 'reject', 'president', 'dialogue']","['egypt', 'opposition', 'mill', 'response', 'dorsi', 'dialogue']",3.799999952316284,3,3177,4089,-912,831744
4403,"['tokyo', 'host', 'olympic', 'james']","['rest', 'feature', 'tokyo', 'olympics']",1.399999976158142,1,601,1375,-774,599076
4404,"['rousing', 'start']","['rousing', 'start']",4.599999904632568,2,1975,5215,-3240,10497600
4405,"['gastro', 'assume', 'celac', 'presidency']","['cuba', 'gastro', 'celac', 'presidency']",5.0,3,3109,5589,-2480,6150400
4406,"['magnitude', 'earthquake', 'hit', 'new', 'zealand']","['magnitude', 'earthquake', 'shake', 'ran']",0.2000000029802322,2,1984,416,1568,2458624
4407,"['dozen', 'fear', 'wrap', 'india', 'building', 'collapse']","['rescuer', 'race', 'find', 'wrap', 'india', 'building', 'collapse']",3.0,4,3969,2810,1159,1343281
4408,"['daily', 'dress', 'grieving', 'south', 'sudan']","['daily', 'dress', 'grieving', 'syria']",1.2000000476837158,3,3108,1174,1934,3740356
4409,"['islamists', 'attack', 'north', 'ali', 'city', 'suicide', 'coming']","['islamist', 'attack', 'italian', 'troop']",3.200000047683716,1,600,3249,-2649,7017201
4410,"['britain', 'set', 'report', 'bu', 'canada']","['britain', 'lose', 'bid', 'report', 'radical', 'clerk', 'bu', 'canada']",2.200000047683716,4,3973,2074,1899,3606201
4411,"['french', 'parliament', 'back', 'reform', 'law', 'restitution']","['russian', 'parliament', 'consider', 'ban', 'adoption']",0.800000011920929,1,599,868,-269,72361
4412,"['shot', 'explosion', 'hear', 'continue', 'protest', 'bangkok']","['gunshot', 'explosion', 'rock', 'protest', 'day', 'ahead', 'poll']",2.5999999046325684,2,1988,2519,-531,281961
4413,"['israel', 'military', 'focus', 'northern', 'border']","['egypt', 'military', 'take', 'control', 'slim', 'brotherhood', 'supporter']",1.600000023841858,1,598,1535,-937,877969
4414,"['north', 'block', 'kaesong', 'access']","['north', 'vow', 'start', 'nuclear', 'facility']",1.0,1,597,944,-347,120409
4415,"['fan', 'sentence', 'year', 'prison']","['cry', 'gastro', 'sentence', 'year', 'prison']",0.4000000059604645,3,3045,486,2559,6548481
4416,"['senate', 'approve', 'fiscal', 'cliff', 'deal']","['official', 'real', 'reach', 'fiscal', 'cliff']",3.400000095367432,2,1952,3675,-1723,2968729
4417,"['zimmerman', 'stop', 'speeding', 'texas', 'release', 'warning']","['zimmerman', 'pull', 'texas', 'speed', 'give', 'warn']",5.0,2,1957,5591,-3634,13205956
4418,"['ran', 'rouhani', 'warn', 'talibanisation', 'syria']","['russia', 'china', 'concerned', 'israel', 'airstrikes', 'syria']",1.399999976158142,1,595,1348,-753,567009
4419,"['syria', 'deny', 'report', 'deadly', 'damascus', 'nerve', 'gas', 'attack']","['ally', 'help', 'repel', 'cranial', 'computer', 'attack']",0.0,1,609,36,573,328329
4420,"['china', 'stock', 'close', 'high', 'economic', 'meeting']","['china', 'stock', 'close', 'high', 'wednesday']",3.400000095367432,4,3984,3671,313,97969
4421,"['russia', 'unveil', 'billion', 'oil', 'link', 'pacific']","['russia', 'unveil', 'oil', 'link', 'pacific']",3.400000095367432,5,4998,3619,1379,1901641
4422,"['police', 'kill', 'german', 'find', 'dead', 'solo', 'home']","['dead', 'police', 'standoff', 'german', 'barricade', 'home']",2.0,4,3985,1791,2194,4813636
4423,"['gabbana', 'convict', 'tax', 'invasion']","['gabbana', 'lined', 'italian', 'tax', 'case']",3.0,2,1960,2779,-819,670761
4424,"['magnitude', 'quaker', 'hit', 'pakistan', 'cenc']","['magnitude', 'earthquake', 'hit', 'pakistan']",3.799999952316284,3,3059,4072,-1013,1026169
4425,"['osteoid', 'lip', 'earth', 'satellite']","['osteoid', 'pass', 'earth', 'fly']",4.400000095367432,2,1962,4964,-3002,9012004
4426,"['right', 'ali', 'effects', 'islamist', 'tactics']","['train', 'ali', 'army', 'fight', 'northern', 'islamist', 'militant']",2.0,2,1963,1796,167,27889
4427,"['santa', 'trace', 'compete', 'christmas']","['pain', 'turn', 'clock', 'vista']",0.0,0,259,37,222,49284
4428,"['ships', 'brain', 'syrian', 'chemical', 'weapons', 'transport']","['syria', 'roads', 'chemical', 'weapons', 'bombs', 'wait', 'sad', 'order']",2.5999999046325684,2,2028,2498,-470,220900
4429,"['kill', 'wound', 'attack', 'ran']","['kill', 'wound', 'fresh', 'attack', 'ran']",2.200000047683716,4,4017,1987,2030,4120900
4430,"['trust', 'syria', 'hand', 'chemical', 'weapon']","['say', 'syria', 'satin', 'gas', 'chemical', 'weapon']",1.0,3,3051,991,2060,4243600
4431,"['mexican', 'singer', 'penn', 'river', 'believe', 'kill', 'plane', 'crash']","['penn', 'river', 'mexican', 'music', 'star', 'die', 'plane', 'crash']",3.400000095367432,5,4964,3531,1433,2053489
4432,"['bangladesh', 'court', 'sentence', 'lawmaker', 'death', 'war', 'crime']","['british', 'push', 'ri', 'vanka', 'war', 'crime']",1.7999999523162842,2,1998,1677,321,103041
4433,"['mugabe', 'declare', 'winner', 'dispute', 'election']","['zimbabwe', 'mugabe', 'declare', 'winner', 'disputed', 'vote']",4.0,3,3054,4694,-1640,2689600
4434,"['death', 'toll', 'limb', 'indonesia', 'boat', 'sink']","['indonesia', 'death', 'toll', 'rise', 'indonesia', 'boat', 'capsule']",3.5999999046325684,4,4047,3822,225,50625
4435,"['egyptian', 'court', 'bank', 'slim', 'brotherhood']","['egypt', 'court', 'bank', 'slim', 'brotherhood', 'activity']",3.799999952316284,4,4048,4099,-51,2601
4436,"['rouhani', 'lead', 'ran', 'presidential', 'vote', 'preliminary', 'result']","['rouhani', 'lead', 'initial', 'ran', 'count']",4.199999809265137,3,3055,4842,-1787,3193369
4437,"['police', 'attack', 'belfast', 'flag', 'protest']","['politician', 'flag', 'violence', 'talk']",0.6000000238418579,1,646,718,-72,5184
4438,"['propose', 'final', 'talk', 'kaesong']","['north', 'propose', 'high', 'level', 'talk']",1.0,2,2007,981,1026,1052676
4439,"['india', 'gang', 'rape', 'victim', 'struggle', 'odd']","['indian', 'rape', 'victim', 'die', 'singapore', 'hospital']",1.7999999523162842,2,2011,1679,332,110224
4440,"['luman', 'kill', 'foreign', 'tourist', 'pakistani']","['lumen', 'foreign', 'tourist', 'pakistan']",2.799999952316284,2,2015,2641,-626,391876
4441,"['statement', 'spokesperson', 'high', 'representative', 'catherine', 'seton', 'late', 'state', 'attack', 'ran']","['statement', 'spokesperson', 'high', 'representative', 'catherine', 'seton', 'resumption', 'execution', 'ran']",3.200000047683716,7,5292,3267,2025,4100625
4442,"['egypt', 'increase', 'security', 'pro', 'dorsi', 'protest']","['egypt', 'race', 'massive', 'protest']",3.0,2,1948,3045,-1097,1203409
4443,"['yacimovich', 'urge', 'cabinet', 'approve', 'palestinian', 'prisoner', 'release']","['israel', 'agree', 'free', 'palestinian', 'prisoner']",2.0,2,1881,1800,81,6561
4444,"['palestinians', 'build', 'west', 'bank', 'tent', 'protest']","['palestinians', 'vote', 'symbolic', 'historic']",0.4000000059604645,1,648,483,165,27225
4445,"['bangladesh', 'building', 'collapse', 'death', 'toll', 'hit']","['bangladesh', 'building', 'collapse', 'death', 'toll', 'limb']",3.5999999046325684,5,4976,3825,1151,1324801
4446,"['israel', 'envoy', 'summon', 'settlement', 'plan']","['britain', 'summon', 'israel', 'envoy', 'settlement']",2.5,4,4054,2354,1700,2890000
4447,"['dead', 'injure', 'nevada', 'middle', 'school', 'shooting']","['nevada', 'dead', 'hurt', 'middle', 'school', 'shooting']",5.0,5,4832,5592,-760,577600
4448,"['james', 'mixed', 'sex', 'school', 'ban', 'take', 'effect']","['james', 'mix', 'sex', 'school', 'ban']",4.199999809265137,4,4055,4846,-791,625681
4449,"['arrest', 'police', 'officer', 'shoot', 'need']","['navy', 'panel', 'urge', 'outer', 'officer', 'face', 'death']",0.4000000059604645,1,649,481,168,28224
4450,"['ukrainian', 'crime', 'minister', 'design', 'amid', 'protest']","['turkish', 'crime', 'minister', 'signal', 'return', 'handle', 'protest']",0.6000000238418579,3,3037,677,2360,5569600
4451,"['drama', 'focus', 'economy', 'state', 'union']","['factbox', 'look', 'drama', 'state', 'union', 'speech']",2.200000047683716,3,3035,2045,990,980100
4452,"['google', 'launch', 'internet', 'beam', 'balloon']","['google', 'play', 'international', 'tax', 'game']",1.0,1,651,974,-323,104329
4453,"['ran', 'back', 'egypt', 'crackdown', 'dorsi', 'supporter']","['ran', 'back', 'egypt', 'crackdown', 'ashamed', 'dorsi', 'supporter']",4.800000190734863,6,5060,5434,-374,139876
4454,"['russia', 'give', 'initial', 'american', 'adoption', 'ban']","['russia', 'give', 'initial', 'approval', 'adoption', 'ban']",3.799999952316284,5,4981,4108,873,762129
4455,"['convict', 'kosovo', 'organ', 'trafficking', 'case']","['kosovo', 'jail', 'time', 'organ', 'trafficking', 'case']",2.799999952316284,4,4060,2647,1413,1996569
4456,"['hrithik', 'shan', 'wife', 'sussanne', 'way']","['hrithik', 'shan', 'sussanne', 'divorce']",4.400000095367432,3,3017,5024,-2007,4028049
4457,"['human', 'head', 'florida', 'apartment', 'shooting']","['human', 'dead', 'apartment', 'shootout']",5.0,2,1896,5593,-3697,13667809
4458,"['drama', 'land', 'progress', 'gay', 'right', 'inaugural', 'address']","['thousand', 'protest', 'gay', 'marriage', 'france']",1.0,1,653,930,-277,76729
4459,"['coming', 'kill', 'ran']","['war', 'bomb', 'kill', 'ran']",2.200000047683716,2,1857,2026,-169,28561
4460,"['shock', 'drama', 'put', 'syria', 'strike', 'hold']","['drama', 'put', 'syria', 'strike', 'hold']",4.599999904632568,5,4997,5212,-215,46225
4461,"['israel', 'strike', 'syria', 'tension', 'rise', 'weapon']","['air', 'strike', 'wind', 'civilian', 'syria', 'vera']",1.7999999523162842,2,1858,1681,177,31329
4462,"['luman', 'kill', 'people', 'northwest', 'pakistan']","['militant', 'kill', 'soldier', 'northwest', 'pakistan']",2.5999999046325684,3,3021,2386,635,403225
4463,"['francisco', 'plane', 'crash', 'glance']","['dead', 'hurt', 'francisco', 'air', 'crash']",1.2000000476837158,2,1864,1151,713,508369
4464,"['arrest', 'deadly', 'bangladesh', 'building', 'collapse']","['worker', 'protest', 'bangladesh', 'building', 'collapse']",2.200000047683716,3,3023,1975,1048,1098304
4465,"['cruise', 'passenger', 'hit', 'noroviru']","['kiss', 'cruise', 'passenger', 'nsw']",0.0,2,1867,41,1826,3334276
4466,"['murder', 'claim', 'diana', 'death', 'new', 'information', 'pass', 'police', 'relate', 'death', 'princess', 'diana', 'lodi', 'gazed', 'think', 'include', 'allegation', 'murder']","['diana', 'gazed', 'death', 'receive', 'new', 'death', 'princess', 'diana', 'lodi', 'll', 'gazed', 'look', 'police', 'receive', 'information']",3.5,8,5389,3702,1687,2845969
4467,"['dowden', 'ask', 'stay', 'russia']","['dowden', 'release', 'russia', 'video']",1.399999976158142,2,1869,1291,578,334084
4468,"['chinese', 'share', 'close', 'low', 'wednesday']","['chinese', 'share', 'close', 'high', 'friday']",2.200000047683716,3,3026,1991,1035,1071225
4469,"['stomach', 'bug', 'cause', 'ail', 'canal', 'miss', 'australian', 'open']","['tafa', 'canal', 'miss', 'australian', 'open']",3.400000095367432,4,4068,3482,586,343396
4470,"['narendra', 'lodi', 'pledge', 'tough', 'stand', 'pakistan']","['india', 'lodi', 'promise', 'tough', 'stance', 'pakistan']",4.800000190734863,3,3027,5430,-2403,5774409
4471,"['egyptian', 'court', 'consider', 'mubarak', 'release']","['egypt', 'court', 'order', 'release', 'mubarak']",3.400000095367432,3,3028,3516,-488,238144
4472,"['boy', 'scouts', 'delay', 'decision', 'admit', 'day']","['boy', 'scouts', 'america', 'delay', 'vote', 'lift', 'ban', 'day']",5.0,4,4070,5598,-1528,2334784
4473,"['car', 'bomb', 'kill', 'southern', 'ran']","['war', 'come', 'kill', 'northern', 'ran']",1.399999976158142,2,1870,1292,578,334084
4474,"['der', 'loot', 'carry', 'prison']","['moran', 'loots', 'plan', 'met', 'carried', 'peru', 'prison']",4.0,1,655,4658,-4003,16024009
4475,"['tokyo', 'stock', 'close']","['tokyo', 'stock', 'close']",3.0,3,3031,3059,-28,784
4476,"['china', 'stock', 'index', 'future', 'close', 'high']","['china', 'stock', 'index', 'future', 'close', 'low']",2.200000047683716,5,4992,2114,2878,8282884
4477,"['picture', 'day', 'august']","['picture', 'day', 'april']",2.799999952316284,2,1901,2636,-735,540225
4478,"['palestinians', 'hit', 'israel', 'fire', 'papa']","['palestinians', 'kill', 'israel', 'air', 'strike', 'papa']",2.799999952316284,3,3033,2626,407,165649
4479,"['hesse', 'jackson', 'wife', 'plead', 'guilty', 'fraud']","['hesse', 'jackson', 'life', 'lead', 'guilty', 'fraud']",4.599999904632568,4,4022,5209,-1187,1408969
4480,"['usa', 'expel', 'venezuela', 'diplomat', 'row']","['expel', 'venezuelan', 'diplomat']",4.400000095367432,2,1930,5091,-3161,9991921
4481,"['bbc', 'veteran', 'admit', 'child', 'sex', 'abuse']","['stuart', 'admit', 'ex', 'assault', 'child']",3.400000095367432,2,1938,3536,-1598,2553604
4482,"['kill', 'injure', 'south', 'china', 'road', 'accident']","['kill', 'injure', 'philippine', 'road', 'accident']",0.6000000238418579,4,4025,671,3354,11249316
4483,"['ryanair', 'report', 'record', 'profit', 'warn', 'growth', 'likely', 'slow', 'year']","['taste', 'ryanair', 'report', 'rise', 'annual', 'profit', 'warn', 'slow', 'growth', 'year']",3.400000095367432,7,5310,3514,1796,3225616
4484,"['stock', 'watch', 'close', 'monday']","['stock', 'watch', 'close', 'thursday']",3.0,3,3048,2951,97,9409
4485,"['anniversary', 'jfk', 'death', 'remember']","['anniversary', 'jfk', 'death', 'dallas', 'hold', 'memorial']",4.0,3,3060,4656,-1596,2547216
4486,"['magnitude', 'earthquake', 'hit', 'taiwan']","['magnitude', 'earthquake', 'hit', 'pakistan']",1.2000000476837158,3,3061,1152,1909,3644281
4487,"['look', 'help', 'lids', 'talk', 'boston', 'marathon', 'news']","['report', 'explosion', 'finish', 'line', 'boston', 'marathon']",0.800000011920929,2,1940,866,1074,1153476
4488,"['lech', 'sector', 'seat', 'google', 'ibm', 'strong', 'earning']","['google', 'share', 'soar', 'past', 'strong', 'earning']",2.5999999046325684,3,3062,2435,627,393129
4489,"['profile', 'sonya', 'presidential', 'candidate']","['italian', 'journalist', 'pick', 'presidential', 'candidate']",1.0,2,1925,901,1024,1048576
4490,"['israel', 'free', 'palestinian', 'prisoner']","['committee', 'approve', 'release', 'palestinian', 'prisoner']",3.400000095367432,2,1924,3507,-1583,2505889
4491,"['philadelphia', 'building', 'collapse', 'people', 'wrap']","['philadelphia', 'building', 'collapse', 'report', 'people', 'wrap']",4.0,5,4974,4635,339,114921
4492,"['drama', 'meet', 'angela', 'family']","['drama', 'meet', 'yuma', 'pay', 'tribute', 'angela']",3.0,3,3089,2961,128,16384
4493,"['senate', 'set', 'gun', 'control', 'debate']","['senate', 'set', 'vote', 'gun', 'control', 'bill']",3.400000095367432,4,4028,3509,519,269361
4494,"['war', 'come', 'kill', 'damascus']","['war', 'coming', 'kill', 'civilian', 'iraqi', 'capital']",1.399999976158142,2,1904,1294,610,372100
4495,"['friends', 'syria', 'oh', 'talk', 'arm', 'rebel']","['syria', 'talk', 'agree', 'military', 'aid', 'rebel']",2.5999999046325684,3,3090,2441,649,421201
4496,"['syria', 'condemn', 'israel', 'air', 'strike']","['series', 'deadly', 'attack', 'strike', 'ran']",2.0,1,659,1910,-1251,1565001
4497,"['egypt', 'leader', 'impose', 'state', 'emergency', 'city']","['egypt', 'president', 'declare', 'state', 'emergency', 'city']",5.0,4,4030,5599,-1569,2461761
4498,"['abvp', 'protest', 'clash', 'police', 'altar', 'altar', 'throw', 'stone']","['protester', 'clash', 'police', 'altar', 'altar', 'people', 'detain']",2.799999952316284,3,3091,2624,467,218089
4499,"['turkish', 'urge', 'end', 'protest', 'istanbul']","['turkish', 'police', 'fire', 'tear', 'protest', 'istanbul']",2.799999952316284,3,3093,2625,468,219024
4500,"['man', 'charge', 'terrorist', 'offence']","['maude', 'bear', 'iberian', 'charge', 'terrorist', 'new', 'work']",1.7999999523162842,2,1405,1628,-223,49729
4501,"['receive', 'noble', 'peace', 'prize']","['receives', 'noble', 'peace', 'prize']",3.5999999046325684,3,3094,3801,-707,499849
4502,"['start', 'german', 'bull', 'run', 'festival', 'briefly', 'delay', 'view', 'obstruct', 'casque', 'flag']","['german', 'bull', 'run', 'festival', 'start']",2.5999999046325684,5,4955,2397,2558,6543364
4503,"['foreigner', 'kill', 'paul', 'suicide', 'attack']","['briton', 'dead', 'paul', 'suicide', 'attack']",2.799999952316284,3,3095,2629,466,217156
4504,"['lapd', 'officer', 'seek', 'divine', 'saying']","['cia', 'officer', 'sentence', 'month', 'prison', 'leak']",0.0,1,644,44,600,360000
4505,"['tokyo', 'share', 'close', 'low']","['singapore', 'stock', 'close', 'low']",0.800000011920929,2,1473,844,629,395641
4506,"['pakistan', 'court', 'demand', 'blasphemy', 'damage', 'answer']","['pakistan', 'report', 'reveal', 'alarming', 'level', 'drug', 'use']",0.6000000238418579,1,643,685,-42,1764
4507,"['mcafee', 'loud', 'base', 'networked', 'firewall', 'specialist', 'stonesoft', 'm', 'wash']","['mcafee', 'acquire', 'farewell', 'stonesoft', 'million']",3.799999952316284,2,1436,4202,-2766,7650756
4508,"['magnitude', 'quaker', 'strike']","['magnitude', 'earthquake', 'strike', 'philippines']",1.0,2,1430,907,523,273529
4509,"['bangladesh', 'opposition', 'leader', 'sentence', 'death', 'war', 'crimes']","['bangladesh', 'fugitive', 'sentence', 'death', 'war', 'crimes', 'tribunal']",3.5999999046325684,5,4958,3802,1156,1336336
4510,"['alleged', 'cop', 'killer', 'die', 'shot', 'head']","['alleged', 'cop', 'killer', 'die', 'gunshot']",4.199999809265137,4,4041,4834,-793,628849
4511,"['war', 'bomb', 'swedish', 'consult', 'tibia', 'benghazi', 'casualty']","['war', 'comb', 'swedish', 'consulate', 'benghazi', 'hurt']",4.800000190734863,3,3100,5442,-2342,5484964
4512,"['musharraf', 'arrest', 'pal', 'masjid', 'case']","['musharraf', 'arrest', 'pakistan']",3.0,2,1424,2991,-1567,2455489
4513,"['ran', 'hope', 'nuclear', 'talk', 'yield', 'roadway']","['ran', 'nuclear', 'talks', 'geneva', 'spur', 'high', 'hopes']",4.400000095367432,2,1451,5078,-3627,13155129
4514,"['militant', 'kill', 'afghan', 'maid', 'official']","['militant', 'kill', 'afghan', 'maid', 'ministry']",2.799999952316284,4,3863,2632,1231,1515361
4515,"['north', 'reportedly', 'test', 'fire', 'short', 'range', 'missile']","['north', 'launch', 'short', 'range', 'missile']",4.0,4,4042,4522,-480,230400
4516,"['protest', 'obstruct', 'vote', 'dead', 'violence']","['protest', 'block', 'polling', 'station', 'bangkok']",2.799999952316284,1,641,2633,-1992,3968064
4517,"['venezuela', 'hugo', 'die', 'cancer']","['hugo', 'venezuelan', 'official', 'unity']",1.7999999523162842,1,639,1662,-1023,1046529
4518,"['north', 'test', 'bring', 'close', 'nuclear', 'power', 'status']","['nato', 'say', 'north', 'nuclear', 'test', 'grave', 'threat', 'world', 'peace']",2.200000047683716,3,3102,1996,1106,1223236
4519,"['north', 'conduct', 'nuclear', 'test']","['north', 'confirm', 'nuclear', 'west']",4.599999904632568,2,1425,5208,-3783,14311089
4520,"['indian', 'stock', 'open', 'flat']","['indian', 'stock', 'open', 'low']",3.5999999046325684,3,3104,3788,-684,467856
4521,"['macau', 'gambling', 'revenue', 'record']","['macau', 'gambling', 'revenue', 'hit', 'record']",5.0,4,4029,5600,-1571,2468041
4522,"['israelis', 'palestinians', 'resume', 'talk']","['israelis', 'palestinians', 'begin', 'talk']",3.799999952316284,3,3105,4198,-1093,1194649
4523,"['elson', 'angela', 'memorial', 'service']","['elson', 'angela', 'die', 'coverage']",2.400000095367432,2,1428,2202,-774,599076
4524,"['county', 'prepares', 'ex', 'carriages', 'hearing']","['county', 'official', 'way', 'sex', 'marriage']",3.799999952316284,1,637,4197,-3560,12673600
4525,"['air', 'force', 'helicopter', 'crew', 'member', 'kill', 'crash']","['air', 'force', 'helicopter', 'crew', 'kill', 'british', 'crash']",4.0,6,5044,4359,685,469225
4526,"['tokyo', 'host', 'olympic', 'james']","['tokyo', 'win', 'race', 'host', 'olympics']",4.199999809265137,2,1435,4867,-3432,11778624
4527,"['malaysia', 'detail', 'australian', 'senator', 'airport']","['malaysia', 'detail', 'australian', 'lawmaker', 'airport']",4.0,4,4024,4349,-325,105625
4528,"['south', 'day', 'north', 'tired', 'missiles']","['north', 'launch', 'short', 'range', 'missile']",2.200000047683716,1,636,2002,-1366,1865956
4529,"['britain', 'shut', 'plant', 'horse', 'meat', 'scandal', 'reach', 'france']","['minister', 'determine', 'resolve', 'horseman', 'scandal']",3.0,1,635,2972,-2337,5461569
4530,"['warn', 'syria', 'chemical', 'weapon']","['concern', 'grow', 'syria', 'chemical', 'weapon']",3.200000047683716,3,3072,3330,-258,66564
4531,"['kill', 'bus', 'crash', 'italy']","['kill', 'bus', 'accident', 'pakistan']",1.2000000476837158,2,1485,1153,332,110224
4532,"['china', 'juan', 'strengthen', 'usd']","['chinese', 'juan', 'weaken', 'usd']",3.0,2,1464,2981,-1517,2301289
4533,"['recognize', 'syrian', 'opposition']","['russia', 'invite', 'syrian', 'opposition', 'talk']",2.0,2,1465,1937,-472,222784
4534,"['egypt', 'vote', 'new', 'constitution']","['egyptians', 'note', 'new', 'constitution']",4.800000190734863,2,1476,5418,-3942,15539364
4535,"['preston', 'england', 'legend', 'tom', 'dinner', 'die']","['england', 'great', 'tom', 'dinner', 'die']",4.400000095367432,4,4069,5118,-1049,1100401
4536,"['war', 'bomb', 'kill', 'wound', 'benghazi']","['war', 'bomb', 'hit', 'libyan', 'foreign', 'ministry', 'benghazi']",3.0,3,3065,3009,56,3136
4537,"['roadside', 'bomb', 'kill', 'afghanistan']","['roadside', 'bomb', 'kill', 'policeman', 'afghanistan']",3.400000095367432,4,4066,3637,429,184041
4538,"['ri', 'vanka', 'family', 'note', 'greater', 'autonomy']","['syria', 'talk', 'cameron', 'ruin']",0.4000000059604645,0,273,495,-222,49284
4539,"['french', 'lead', 'troop', 'close', 'timbuktu']","['french', 'lead', 'troop', 'control', 'access', 'timbuktu']",3.5999999046325684,4,4064,3809,255,65025
4540,"['dato', 'airstrike', 'kill', 'afghan', 'kiss']","['dato', 'soldier', 'die', 'afghanistan']",1.2000000476837158,1,633,1154,-521,271441
4541,"['lumen', 'foreign', 'tourist', 'pakistan']","['luman', 'kill', 'foreign', 'limber', 'pakistan']",4.0,2,1380,4403,-3023,9138529
4542,"['n', 'halt', 'work', 'joint', 'industrial', 'zone']","['north', 'block', 'access', 'joint', 'industrial', 'zone']",4.0,3,3067,4404,-1337,1787569
4543,"['delhi', 'sang', 'gape', 'suspect', 'beaten', 'poisoned']","['delhi', 'gang', 'rape', 'verdict', 'defer']",1.7999999523162842,1,631,1731,-1100,1210000
4544,"['france', 'pledge', 'military', 'aid', 'ali']","['french', 'support', 'military', 'operation', 'ali']",1.399999976158142,2,1415,1298,117,13689
4545,"['egyptians', 'vote', 'division', 'constitution']","['egyptians', 'vote', 'constitution', 'change']",4.0,3,3071,4408,-1337,1787569
4546,"['reid', 'city', 'tremendous', 'progress', 'debt', 'ceiling', 'talk']","['senate', 'leader', 'appear', 'close', 'debt', 'ceiling', 'deal']",2.799999952316284,2,1412,2654,-1242,1542564
4547,"['magnitude', 'quaker', 'bolt', 'sarangani']","['magnitude', 'earthquake', 'bolt', 'china']",2.0,2,1411,1948,-537,288369
4548,"['dead', 'hurt', 'car', 'chaos']","['dead', 'hurt', 'cotabato', 'blast']",1.2000000476837158,2,1409,1156,253,64009
4549,"['chairman', 'easyjet', 'step']","['chairman', 'british', 'fill', 'airline', 'easyjet', 'step']",4.199999809265137,3,3074,4869,-1795,3222025
4550,"['drama', 'renew', 'offer', 'cut', 'social', 'safety', 'net', 'big', 'budget', 'deal', 'aide']","['japan', 'urge', 'quickly', 'handle', 'budget', 'deadlock']",0.800000011920929,1,629,871,-242,58564
4551,"['suicide', 'somber', 'hills', 'afghan', 'province', 'council']","['suicide', 'somber', 'hills', 'afghanistan']",2.400000095367432,3,3075,2207,868,753424
4552,"['committee', 'year', 'final', 'big', 'immigration', 'decision']","['senate', 'judiciary', 'committee', 'near', 'final', 'big', 'decision', 'shape', 'immigration', 'bill']",3.400000095367432,5,5005,3678,1327,1760929
4553,"['troop', 'kill', 'afghan', 'insider', 'attack']","['nato', 'troop', 'kill', 'afghan', 'insider', 'attack']",3.799999952316284,5,5003,4192,811,657721
4554,"['arrest', 'suspicion', 'manslaughter', 'dog', 'kill', 'daughter']","['arrest', 'suspicion', 'murder', 'stab', 'suffolk']",1.7999999523162842,2,1401,1734,-333,110889
4555,"['dead', 'miss', 'canada', 'train', 'disaster']","['miss', 'canadian', 'train', 'wreck']",3.200000047683716,2,1398,3289,-1891,3575881
4556,"['tunisian', 'opposition', 'politician', 'shoot', 'dead']","['tunisia', 'opposition', 'leader', 'slay', 'protest', 'erupt']",3.0,1,594,2960,-2366,5597956
4557,"['press', 'need', 'major', 'boost', 'syrian', 'aid']","['chief', 'press', 'major', 'boost', 'syrian', 'aid']",4.800000190734863,5,5001,5364,-363,131769
4558,"['stock', 'soar', 'lead']","['stock', 'slump', 'street']",1.600000023841858,1,593,1548,-955,912025
4559,"['george', 'zimmerman', 'find', 'guilty', 'trayvon', 'martin', 'murder']","['protest', 'appeal', 'calm', 'zimmerman', 'acquit', 'trayvon', 'martin', 'murder']",2.5999999046325684,4,3987,2513,1474,2172676
4560,"['whistleblower', 'edward', 'dowden', 'fly', 'moscow']","['nsa', 'whistleblower', 'edward', 'dowden', 'leave', 'long', 'long', 'flight', 'moscow']",3.5999999046325684,4,3986,3774,212,44944
4561,"['kill', 'wound', 'bomb', 'attack', 'northern', 'ran']","['kill', 'wound', 'clash', 'northern', 'lebanon']",0.6000000238418579,3,3078,694,2384,5683456
4562,"['consider', 'reveal', 'election', 'secret']","['eye', 'caprices', 'venezuela', 'election', 'met']",1.2000000476837158,1,592,1158,-566,320356
4563,"['royal', 'sorrow', 'nurse', 'death']","['radio', 'prankster', 'tear', 'nurse', 'death']",2.799999952316284,2,1419,2577,-1158,1340964
4564,"['n', 'say', 'delay', 'controversial', 'rocket', 'launch']","['look', 'set', 'delay', 'controversial', 'rocket', 'launch']",4.199999809265137,4,3979,4853,-874,763876
4565,"['critical', 'rates', 'memoir', 'rock', 'drama', 'administration']","['rate', 'blast', 'rock', 'drama', 'administration']",4.0,3,3080,4381,-1301,1692601
4566,"['jeff', 'bezos', 'get', 'million', 'reviving', 'washington']","['jeff', 'bezos', 'days', 'million', 'washington']",4.199999809265137,4,3989,4833,-844,712336
4567,"['brooks', 'plead', 'guilty', 'hack', 'charge']","['brooks', 'plead', 'guilty', 'phone', 'hacking', 'hearing']",3.799999952316284,3,3082,4191,-1109,1229881
4568,"['urge', 'send', 'shilling', 'message', 'north', 'elite']","['urge', 'uncle', 'send', 'shilling', 'message', 'north', 'elite']",4.0,6,5063,4387,676,456976
4569,"['south', 'africans', 'mark', 'ail', 'angela', 'birthday']","['south', 'africa', 'elson', 'angela', 'hospital']",1.399999976158142,2,1378,1300,78,6084
4570,"['drama', 'declare', 'health', 'care', 'law', 'work']","['drama', 'pledge', 'new', 'health', 'care', 'law', 'work']",3.0,5,4863,3021,1842,3392964
4571,"['heavy', 'rain', 'raise', 'threat', 'christmas', 'flooding']","['fresh', 'rain', 'bring', 'flooding']",3.0,2,1460,3012,-1552,2408704
4572,"['thousand', 'protest', 'gay', 'marriage']","['thousand', 'protest', 'gay', 'marriage', 'paris']",3.5999999046325684,4,3975,3762,213,45369
4573,"['taiwan', 'gang', 'leader', 'name', 'airport', 'year']","['labia', 'arrest', 'ex', 'leader', 'oil', 'deal']",0.4000000059604645,1,555,507,48,2304
4574,"['ran', 'duke', 'talk', 'begin', 'amid', 'hope', 'progress']","['ran', 'nuclear', 'talk', 'start', 'geneva']",3.0,2,1608,3043,-1435,2059225
4575,"['political', 'protest', 'paralyse', 'minister']","['protest', 'besiege', 'minister']",4.199999809265137,2,1612,4831,-3219,10361961
4576,"['amazon', 'bezos', 'buy', 'washington', 'million']","['amazon', 'bezos', 'busy', 'washington', 'm']",4.599999904632568,3,2667,5202,-2535,6426225
4577,"['drama', 'economic', 'tour', 'suffer', 'low', 'expectation']","['drama', 'encourage', 'boy', 'scouts', 'end', 'ban', 'day']",1.7999999523162842,1,554,1753,-1199,1437601
4578,"['israel', 'vow', 'deny', 'hezbollah', 'air', 'strike']","['war', 'bomb', 'kill', 'hezbollah', 'beirut', 'action', 'minister']",0.6000000238418579,1,553,662,-109,11881
4579,"['france', 'welcomes', 'russia', 'real', 'syria']","['arab', 'league', 'welcome', 'russian', 'deal', 'syria']",2.400000095367432,1,552,2186,-1634,2669956
4580,"['french', 'soldier', 'central', 'african', 'republic']","['run', 'battle', 'central', 'african', 'capital', 'create', 'fresh', 'panic']",2.0,2,1623,1931,-308,94864
4581,"['resolution', 'order', 'syria', 'chemical', 'arm', 'destroy']","['germany', 'ready', 'help', 'syria', 'chemical', 'mission']",1.0,2,1588,1085,503,253009
4582,"['exclusive', 'update', 'egypt', 'pro', 'bursa', 'alliance', 'signal', 'flexibility', 'talk']","['exclusive', 'update', 'egypt', 'pro', 'bursa', 'alliance', 'signal', 'flexibility', 'talk']",4.599999904632568,9,5497,5200,297,88209
4583,"['david', 'beckham', 'retire', 'end', 'season']","['david', 'beckham', 'retires', 'football']",4.199999809265137,2,1590,4807,-3217,10349089
4584,"['tibia', 'abruptly', 'close', 'border', 'country']","['tibia', 'close', 'border', 'declare', 'martial', 'law', 'south']",3.400000095367432,3,2685,3592,-907,822649
4585,"['magnitude', 'quaker', 'hit', 'greece', 'usgs']","['magnitude', 'quaker', 'bolt', 'japan']",1.0,2,1594,1094,500,250000
4586,"['search', 'man', 'sweep', 'sea']","['vara', 'plan', 'visit', 'real']",0.2000000029802322,0,288,396,-108,11664
4587,"['militant', 'stage', 'pakistan', 'jailbreak']","['taliban', 'prison', 'break', 'militant', 'escape', 'attack', 'pakistan', 'jail']",3.0,2,1595,3020,-1425,2030625
4588,"['meteorite', 'hit', 'central', 'russia', 'people', 'hurt']","['meteorite', 'hit', 'central', 'russia', 'hurt']",3.0,5,4879,3022,1857,3448449
4589,"['blizzard', 'bring', 'northeast', 'halt']","['blizzard', 'gallop', 'northeast', 'close', 'road']",4.199999809265137,2,1498,4805,-3307,10936249
4590,"['nato', 'protest', 'acquit', 'terrorist', 'charge']","['nato', 'protest', 'convict', 'non', 'terrorist', 'charge']",1.600000023841858,4,4009,1534,2475,6125625
4591,"['credibility', 'line', 'syria']","['drama', 'congress', 'world', 'credibility', 'line']",1.399999976158142,2,1625,1305,320,102400
4592,"['taliban', 'agenda', 'pakistan']","['dead', 'big', 'quaker', 'hit', 'pakistan']",0.0,1,548,65,483,233289
4593,"['egypt', 'interior', 'minister', 'survive', 'bomb']","['egypt', 'interior', 'minister', 'survive', 'bomb', 'attack']",5.0,5,4884,5585,-701,491401
4594,"['china', 'juan', 'weaken', 'usd', 'thursday']","['china', 'juan', 'weaken', 'usd', 'tuesday']",2.0,4,4001,1918,2083,4338889
4595,"['drama', 'hold', 'talk', 'syria', 'action']","['cameron', 'lose', 'parliamentary', 'vote', 'syria', 'military', 'action']",1.399999976158142,2,1650,1306,344,118336
4596,"['egypt', 'freeze', 'slim', 'brotherhood', 'asset']","['egypt', 'freeze', 'slim', 'brotherhood', 'fund']",5.0,4,3996,5584,-1588,2521744
4597,"['men', 'report', 'easy', 'high', 'maintenance']","['russian', 'meteorite', 'leave', 'build', 'gape', 'open']",0.0,0,287,52,235,55225
4598,"['bony', 'abbott', 'swear', 'new', 'australian']","['bony', 'abbott', 'worn', 'australia']",4.599999904632568,2,1651,5199,-3548,12588304
4599,"['egypt', 'army', 'crack', 'brotherhood']","['egypt', 'military', 'crack', 'slim', 'brotherhood']",4.0,3,2649,4347,-1698,2883204
4600,"['venezuela', 'assembly', 'meet', 'amid', 'health', 'crisis']","['assembly', 'meet', 'amid', 'crisis']",3.400000095367432,4,3994,3672,322,103684
4601,"['syria', 'opposition', 'threaten', 'quit', 'talk']","['syria', 'opposition', 'agree', 'talk']",2.0,3,2652,1942,710,504100
4602,"['suicide', 'bomber', 'kill', 'policeman', 'pakistan']","['suicide', 'combers', 'soldier', 'pakistan']",2.5999999046325684,2,1655,2391,-736,541696
4603,"['anti', 'government', 'protest', 'storm', 'street', 'iv']","['ukraine', 'protest', 'couple', 'vein', 'statue']",0.800000011920929,1,544,862,-318,101124
4604,"['chicago', 'man', 'sentence', 'terror', 'conviction']","['paul', 'bank', 'heads', 'sentence', 'corruption']",1.0,1,543,1102,-559,312481
4605,"['drone', 'strike', 'kill', 'northwest', 'pakistan']","['drone', 'strike', 'kill', 'seven', 'north', 'waziristan']",2.400000095367432,3,2791,2197,594,352836
4606,"['track', 'fault', 'disrupt', 'train', 'service', 'baffled', 'place', 'marina']","['brain', 'service', 'disrupt', 'baffled', 'place', 'marina']",4.199999809265137,5,4839,4798,41,1681
4607,"['fan', 'sentence', 'year', 'leak', 'government', 'secret']","['briton', 'jail', 'year', 'sell', 'face', 'bomb', 'detector']",1.0,1,540,1017,-477,227529
4608,"['police', 'terrorist', 'link', 'helicopter', 'crash']","['china', 'police', 'seek', 'suspect', 'crash']",1.0,2,1628,1024,604,364816
4609,"['suicide', 'bomber', 'kill', 'russia', 'south']","['suicide', 'bomber', 'kill', 'russia', 'volgograd']",1.7999999523162842,4,4143,1766,2377,5650129
4610,"['kill', 'wound', 'violent', 'attack', 'ran']","['kill', 'wound', 'fresh', 'attack', 'ran']",1.7999999523162842,4,4142,1768,2374,5635876
4611,"['merry', 'visit', 'jordan', 'israel', 'palestinian', 'peace', 'agenda']","['merry', 'postpone', 'visit', 'israel', 'week']",2.5,3,2785,2349,436,190096
4612,"['eurozone', 'bless', 'hit', 'fresh', 'record', 'high']","['bless', 'hit', 'fresh', 'record']",4.400000095367432,4,4138,5036,-898,806404
4613,"['elson', 'angela', 'real', 'hero', 'gandhi', 'peru']","['elson', 'angela', 'health', 'unstable']",1.399999976158142,2,1629,1308,321,103041
4614,"['face', 'bailout', 'tax', 'cypriots', 'cry', 'met', 'wash', 'rank']","['bailout', 'term', 'prompt', 'run', 'typhus', 'bank']",3.0,1,539,2969,-2430,5904900
4615,"['drama', 'sign', 'obamacare']","['americans', 'scramble', 'sign', 'obamacare', 'deadline']",1.2000000476837158,2,1631,1161,470,220900
4616,"['dance', 'armstrong', 'confess', 'pray']","['dance', 'armstrong', 'confess', 'pray', 'interview']",4.199999809265137,4,4135,4813,-678,459684
4617,"['andy', 'murray', 'deserve', 'knighthood', 'david', 'cameron', 'say']","['david', 'cameron', 'andy', 'murray', 'deserve', 'knighthood']",5.0,6,5083,5564,-481,231361
4618,"['rush', 'index', 'close', 'high', 'act']","['rush', 'index', 'close', 'low', 'march']",2.0,3,2782,1881,901,811801
4619,"['state', 'department', 'fail', 'benghazi']","['state', 'keep', 'security', 'chief', 'design', 'benghazi']",2.400000095367432,2,1635,2221,-586,343396
4620,"['soccer', 'france', 'host', 'australia', 'time', 'october']","['nra', 'official', 'face', 'question', 'time', 'controversial', 'remark']",0.0,1,537,56,481,231361
4621,"['honduras', 'ambassador', 'colombia', 'sack', 'wild', 'party']","['honduras', 'ambassador', 'design', 'allege', 'embassy', 'org']",3.5999999046325684,2,1642,3754,-2112,4460544
4622,"['syria', 'destroy', 'chemical', 'weapon']","['tibia', 'destroy', 'chemical', 'weapon']",2.400000095367432,3,2823,2217,606,367236
4623,"['moderate', 'tremor', 'central', 'mediterranean']","['ran', 'moderate', 'candidate', 'win', 'presidential', 'vote']",0.0,1,535,57,478,228484
4624,"['afghan', 'kill', 'suicide', 'attack']","['afghan', 'dead', 'new', 'blast', 'base', 'east', 'afghanistan']",3.5999999046325684,1,534,3800,-3266,10666756
4625,"['suicide', 'bombs', 'egypt', 'military', 'final']","['suicide', 'bomb', 'hit', 'egypt', 'military', 'final', 'kill']",2.799999952316284,4,4127,2724,1403,1968409
4626,"['sign', 'market', 'gain', 'beat', 'economic', 'datum']","['sign', 'market', 'lift', 'positive', 'china', 'datum']",3.400000095367432,3,2796,3432,-636,404496
4627,"['suicide', 'bomber', 'kill', 'pakistan', 'political', 'rally']","['suicide', 'bomber', 'kill', 'guard', 'embassy', 'turkey']",1.600000023841858,3,2818,1518,1300,1690000
4628,"['dorsi', 'supporter', 'kill', 'egypt', 'clash']","['dozen', 'injure', 'dorsi', 'supporter', 'clash', 'security', 'force']",2.200000047683716,3,2813,2094,719,516961
4629,"['student', 'ride', 'airwave']","['magnitude', 'quaker', 'hit', 'taiwan']",0.0,0,285,58,227,51529
4630,"['histories', 'officer', 'drop', 'case']","['history', 'officer', 'attempt', 'murder', 'charge']",2.200000047683716,1,531,2092,-1561,2436721
4631,"['vinnie', 'bones', 'reveal', 'cancer', 'battle', 'new']","['vinnie', 'bones', 'reveal', 'skin', 'cancer']",4.0,4,4167,4489,-322,103684
4632,"['pakistani', 'taliban', 'chief', 'hakimullah', 'mehsud', 'kill', 'drone', 'strike']","['pakistan', 'taliban', 'vow', 'revenge', 'repay', 'hakimullah', 'killing', 'bloodshed']",2.5999999046325684,2,1526,2436,-910,828100
4633,"['dozen', 'kill', 'air', 'strike', 'baker', 'central', 'syria']","['dozen', 'kill', 'syrian', 'air', 'strike', 'baker']",5.0,5,4925,5566,-641,410881
4634,"['luman', 'kill', 'soldier', 'injure', 'pakistan']","['luman', 'kill', 'folio', 'worker', 'pakistan']",2.0,3,2804,1900,904,817216
4635,"['police', 'confirm', 'suspect', 'capture']","['say', 'boston', 'marathon', 'come', 'suspect', 'capture', 'film']",2.200000047683716,2,1527,2099,-572,327184
4636,"['destruction', 'syria', 'chemical', 'weapon', 'begin']","['destruction', 'syria', 'chemical', 'weapons', 'drove', 'difficult']",2.799999952316284,3,2800,2726,74,5476
4637,"['flood', 'canada', 'force', 'evacuation', 'city']","['california', 'wildlife', 'force', 'evacuation', 'home', 'university']",0.800000011920929,2,1528,841,687,471969
4638,"['say', 'drone', 'violate', 'pakistan', 'sovereignty']","['drone', 'strike', 'violate', 'pakistan', 'sovereignty']",4.400000095367432,4,4155,5049,-894,799236
4639,"['drama', 'praises', 'angela', 'inspiration']","['drama', 'nail', 'angela', 'inspiration', 'effect']",4.800000190734863,3,2769,5419,-2650,7022500
4640,"['drama', 'come', 'listen', 'israel', 'palestinians']","['merry', 'welcomes', 'arab', 'plan', 'israel', 'palestinian', 'talks']",0.800000011920929,1,530,840,-310,96100
4641,"['e', 'mail', 'oil', 'firm', 'ask', 'trader', 'meet', 'minister']","['oil', 'firm', 'ask', 'rogue', 'trader', 'meet', 'minister']",4.199999809265137,6,5110,4825,285,81225
4642,"['death', 'toll', 'siberia', 'police', 'attack', 'rise']","['death', 'toll', 'sonya', 'bus', 'attack', 'rise']",1.399999976158142,4,4126,1376,2750,7562500
4643,"['syria', 'declare', 'chemical', 'weapon', 'sign', 'convention']","['russia', 'syria', 'work', 'concrete', 'chemical', 'weapons', 'plan']",2.5999999046325684,2,1534,2425,-891,793881
4644,"['australia', 'scrap', 'soar', 'national', 'debt', 'ceiling']","['australian', 'insist', 'argument', 'indonesia']",0.0,0,283,59,224,50176
4645,"['sign', 'market', 'hit', 'high', 'hope', 'debt', 'deal']","['sign', 'stock', 'hit', 'week', 'high', 'hope', 'debt', 'deal']",4.800000190734863,6,5037,5410,-373,139129
4646,"['italian', 'crime', 'minister', 'paris', 'anti', 'design']","['palestinian', 'crime', 'minister', 'fayyad', 'design']",1.399999976158142,3,2733,1316,1417,2007889
4647,"['south', 'africa', 'admit', 'mistake', 'schizophrenic', 'angela', 'signer']","['south', 'africa', 'admit', 'possible', 'mistake', 'deaf', 'signer', 'angela', 'memorial']",3.200000047683716,6,5035,3227,1808,3268864
4648,"['ran', 'say', 'issue', 'remain', 'nuclear', 'talk']","['ran', 'vow', 'preserve', 'peaceful', 'nuclear', 'program']",1.600000023841858,2,1519,1519,0,0
4649,"['crowd', 'father', 'bethlehem', 'christmas']","['oh', 'little', 'town', 'bethlehem', 'real']",2.0,1,528,1957,-1429,2042041
4650,"['peacekeeper', 'kill', 'sudan', 'darfur']","['peacekeeper', 'kill', 'bye', 'clash']",1.600000023841858,2,1500,1521,-21,441
4651,"['nato', 'patriot', 'missile', 'battery', 'operational', 'syrian', 'border']","['drama', 'patriot', 'missile', 'battery', 'troop', 'stay', 'jordan', 'near', 'syrian', 'border']",3.200000047683716,5,4945,3221,1724,2972176
4652,"['stock', 'tumble', 'day', 'shutdown']","['stock', 'fall', 'day', 'government', 'shutdown']",4.599999904632568,3,2720,5277,-2557,6538249
4653,"['guinea', 'vote', 'long', 'delay', 'legislative', 'poll']","['equatoguinean', 'vote', 'legislative', 'poll']",3.400000095367432,3,2719,3448,-729,531441
4654,"['nato', 'troop', 'kill', 'afghanistan', 'attack']","['nato', 'troop', 'kill', 'afghan', 'insider', 'attack']",3.0,4,4083,3028,1055,1113025
4655,"['israel', 'soldier', 'hit', 'palestinian', 'child', 'neuron']","['israel', 'soldier', 'kill', 'palestinian', 'woman', 'west', 'bank']",1.2000000476837158,3,2718,1162,1556,2421136
4656,"['voice', 'alarm', 'israel', 'strike', 'syria']","['israel', 'official', 'confirm', 'second', 'air', 'strike', 'syria']",2.200000047683716,3,2716,2023,693,480249
4657,"['egypt', 'army', 'haunches', 'new', 'air', 'maids', 'final', 'militant']","['egypt', 'launch', 'new', 'assault', 'final', 'militant']",3.400000095367432,4,4080,3426,654,427716
4658,"['french', 'force', 'attack', 'al', 'qaeda', 'ali', 'ally']","['battle', 'retaken', 'north', 'ali', 'hundred', 'french', 'troop', 'drive', 'al', 'say', 'link', 'rebel']",2.5999999046325684,3,2764,2373,391,152881
4659,"['egyptian', 'police', 'fire', 'tear', 'gas', 'brotherhood', 'protest']","['india', 'dear', 'tired', 'sing', 'gape', 'protesters']",1.2000000476837158,0,282,1163,-881,776161
4660,"['syria', 'regime', 'agree', 'attend', 'peace', 'conference']","['syria', 'opposition', 'agree', 'principle', 'attend', 'peace', 'conference']",3.0,5,4895,3023,1872,3504384
4661,"['dozen', 'injure', 'jet', 'crash', 'land', 'francisco', 'airport']","['guiana', 'air', 'crash', 'land', 'francisco', 'airport']",3.799999952316284,4,4079,4181,-102,10404
4662,"['child', 'die', 'fire', 'myanmar', 'mosque', 'fire']","['myanmar', 'police', 'child', 'die', 'electrical', 'fire', 'mosque']",4.599999904632568,5,4898,5279,-381,145161
4663,"['senate', 'vote', 'fiscal', 'cliff', 'deal', 'deadline', 'year']","['fiscal', 'cliff', 'house', 'delay', 'vote', 'fiscal', 'cliff', 'deal', 'live']",2.799999952316284,4,4078,2730,1348,1817104
4664,"['knife', 'arrest', 'entrance', 'buckingham', 'palace']","['charged', 'buckingham', 'palace', 'arrest']",2.200000047683716,3,2761,2068,693,480249
4665,"['people', 'bury', 'colorado', 'avalanche']","['snowboarder', 'kill', 'colorado', 'avalanche']",2.799999952316284,2,1503,2735,-1232,1517824
4666,"['moon', 'review', 'syria', 'chemical', 'arms', 'accord']","['review', 'syria', 'chemical', 'arm', 'accord']",3.5999999046325684,4,3965,3817,148,21904
4667,"['iraqi', 'president', 'hospital', 'health', 'problem']","['iraqi', 'president', 'hospital', 'suffer', 'stroke']",3.5999999046325684,3,2758,3826,-1068,1140624
4668,"['malaysia', 'long', 'rule', 'coalition', 'hang', 'power']","['malaysia', 'rule', 'coalition', 'win', 'majority']",3.799999952316284,3,2756,4180,-1424,2027776
4669,"['explosion', 'dear', 'cranial', 'embassy', 'beirut']","['blast', 'near', 'cranial', 'embassy', 'beirut']",4.199999809265137,3,2754,4817,-2063,4255969
4670,"['hurt', 'new', 'orleans', 'shooting']","['police', 'hurt', 'nola', 'shooting']",4.199999809265137,2,1504,4816,-3312,10969344
4671,"['age', 'lament', 'political', 'change', 'defence', 'budget']","['age', 'depend', 'propose', 'cut', 'defense', 'spending']",2.400000095367432,1,541,2176,-1635,2673225
4672,"['bank', 'carry', 'liquid', 'get', 'flight', 'russia']","['bank', 'carry', 'liquid', 'direct', 'flight', 'russia']",4.400000095367432,5,4908,5061,-153,23409
4673,"['egypt', 'brotherhood', 'stand', 'ground', 'kill']","['egypt', 'slim', 'brotherhood', 'stand', 'dorsi']",2.400000095367432,3,2747,2189,558,311364
4674,"['dato', 'troop', 'kill', 'afghan', 'child']","['nato', 'strike', 'kill', 'afghan', 'child']",3.0,3,2746,3046,-300,90000
4675,"['cranial', 'president', 'call', 'new', 'nuclear', 'talk']","['cranial', 'minister', 'blame', 'west', 'fail', 'duke', 'talk']",2.0,2,1581,1777,-196,38416
4676,"['flood', 'kill', 'force', 'salary', 'home']","['flood', 'forces', 'canada', 'come']",3.400000095367432,1,577,3464,-2887,8334769
4677,"['nato', 'troop', 'kill', 'afghanistan']","['right', 'nato', 'troop', 'kill', 'afghanistan']",2.5999999046325684,4,4098,2370,1728,2985984
4678,"['typhoon', 'widow', 'make', 'windfall', 'east', 'china']","['typhoon', 'widow', 'slum', 'southwestern', 'china']",3.799999952316284,3,2744,4179,-1435,2059225
4679,"['angela', 'spend', 'christmas', 'hospital']","['angela', 'movie', 'open', 'month', 'south', 'africa']",0.2000000029802322,1,574,401,173,29929
4680,"['exit', 'poll', 'suggest', 'ruin', 'ally', 'win', 'moscow', 'vote']","['exit', 'poll', 'show', 'ruin', 'ally', 'win', 'moscow', 'vote', 'cavalry', 'cry', 'foul']",3.400000095367432,7,5345,3463,1882,3541924
4681,"['judge', 'enter', 'guilty', 'plea', 'james', 'holmes']","['guilty', 'plea', 'james', 'holmes', 'insanity', 'option', 'table']",4.0,4,4122,4510,-388,150544
4682,"['kill', 'pain', 'train', 'crash']","['kill', 'triple', 'car', 'coming', 'ran', 'diyala']",1.0,1,573,1056,-483,233289
4683,"['chris', 'room', 'ride', 'de', 'france', 'engage']","['chris', 'grown', 'concert', 'cancel', 'new']",0.0,1,567,62,505,255025
4684,"['apple', 'pp', 'direct', 'driver', 'alaska', 'airport', 'runaway']","['apple', 'pp', 'send', 'driver', 'airport']",3.5999999046325684,4,4121,3821,300,90000
4685,"['suspect', 'drone', 'kill', 'militant', 'pakistan']","['drone', 'kill', 'militant', 'pakistan']",3.400000095367432,4,4120,3453,667,444889
4686,"['francis', 'begin', 'papa', 'prayer']","['hope', 'francis', 'lips', 'vatican', 'prayer']",3.5999999046325684,2,1546,3820,-2274,5171076
4687,"['senate', 'meet', 'path', 'fiscal', 'impulse', 'elusive']","['senate', 'sunday', 'session', 'days', 'amid', 'fiscal', 'masse']",3.5999999046325684,2,1547,3819,-2272,5161984
4688,"['egypt', 'brotherhood', 'beleaguered', 'leader']","['egypt', 'slim', 'brotherhood', 'met', 'pass', 'march']",1.7999999523162842,2,1554,1671,-117,13689
4689,"['china', 'new', 'stealth', 'frigate', 'commission']","['belarus', 'latvia', 'set', 'border', 'commission']",0.2000000029802322,1,986,406,580,336400
4690,"['ran', 'violence', 'kill']","['ran', 'violence', 'kill', 'seven']",2.200000047683716,3,2741,1980,761,579121
4691,"['protest', 'continue', 'tense', 'ukraine', 'capital']","['protest', 'continue', 'brazil']",1.600000023841858,2,1551,1525,26,676
4692,"['prison', 'release', 'kidnap', 'egypt', 'final']","['bedouin', 'release', 'prisons', 'seize', 'egypt', 'final']",3.200000047683716,3,2717,3261,-544,295936
4693,"['syria', 'welcome', 'ran', 'nuclear', 'deal']","['ran', 'world', 'power', 'clinch', 'breakthrough', 'nuclear', 'deal']",3.0,3,2723,2788,-65,4225
4694,"['israel', 'face', 'european', 'backwash', 'settlement', 'plan']","['israel', 'call', 'account', 'late', 'settlement', 'plan', 'european', 'country']",3.5999999046325684,4,4112,3814,298,88804
4695,"['drama', 'joke', 'reporter', 'dinner']","['drama', 'joke', 'fun', 'critic', 'press', 'dinner']",2.200000047683716,3,2753,2006,747,558009
4696,"['ellen', 'respond', 'marrow', 'abuse', 'claim', 'letter']","['ellen', 'depend', 'self', 'marrow', 'abuse', 'claim']",4.199999809265137,4,4111,4902,-791,625681
4697,"['inmate', 'escape', 'tibia', 'al', 'kweifiya', 'prison']","['prisoner', 'escape', 'libyan', 'jail']",4.400000095367432,1,1329,5051,-3722,13853284
4698,"['nuclear', 'option']","['shot', 'nuclear', 'readiness']",1.2000000476837158,1,1346,1164,182,33124
4699,"['amp', 'old', 'march']","['old', 'march']",2.5999999046325684,2,1562,2494,-932,868624
4700,"['islamist', 'kill', 'suicide', 'attack', 'tiger']","['war', 'bomb', 'kill', 'turkish', 'town', 'near', 'syrian', 'border']",1.0,1,1333,1033,300,90000
4701,"['determine', 'syria', 'chemical', 'weapon']","['vote', 'eliminate', 'syria', 'chemical', 'weapon']",2.799999952316284,3,2812,2744,68,4624
4702,"['dowden', 'father', 'arrive', 'moscow']","['edward', 'dowden', 'father', 'moscow']",4.199999809265137,3,2815,4901,-2086,4351396
4703,"['pakistani', 'taliban', 'name', 'new', 'leader', 'drone', 'strike']","['pakistani', 'taleban', 'chief', 'kill', 'drone', 'strike']",2.200000047683716,3,2820,2106,714,509796
4704,"['win', 'coming', 'pakistan', 'kill']","['militant', 'battle', 'pakistani', 'police']",1.2000000476837158,0,44,1165,-1121,1256641
4705,"['slim', 'brotherhood', 'supporter', 'die', 'cairo', 'clash']","['slim', 'brotherhood', 'supporter', 'die', 'egypt', 'clash']",3.5999999046325684,5,4940,3808,1132,1281424
4706,"['facebook', 'earning', 'jump', 'mobile', 'accelerate']","['facebook', 'profit', 'jump', 'user', 'base', 'expand']",3.400000095367432,2,1568,3679,-2111,4456321
4707,"['syria', 'envoy', 'call', 'national', 'unity', 'government']","['syria', 'envoy', 'call', 'political', 'change', 'end', 'conflict']",2.200000047683716,3,2809,2113,696,484416
4708,"['thirty', 'head', 'italy', 'plunge']","['thirty', 'head', 'italian', 'plunge']",3.200000047683716,3,2770,3250,-480,230400
4709,"['roger', 'videotron', 'extend', 'reach', 'network', 'share', 'deal']","['roger', 'videotron', 'reach', 'network', 'sharing', 'spectrum', 'deal']",4.199999809265137,5,4936,4883,53,2809
4710,"['china', 'stock', 'end', 'low', 'thursday']","['china', 'stock', 'close', 'lower', 'thursday']",5.0,3,2772,5570,-2798,7828804
4711,"['hopeless', 'women', 'protest', 'berlusconi', 'notes', 'election']","['bulgaria', 'president', 'backs', 'protesters', 'oppose', 'snap', 'elections']",0.6000000238418579,0,80,707,-627,393129
4712,"['indonesia', 'schoolchildren', 'kill', 'indonesia', 'volcano', 'eruption']","['indonesia', 'dead', 'indonesian', 'volcanic', 'eruption']",2.799999952316284,2,1583,2699,-1116,1245456
4713,"['real', 'reach', 'new', 'italian', 'government']","['italy', 'swear', 'new', 'coalition', 'government']",3.400000095367432,2,1641,3669,-2028,4112784
4714,"['drama', 'mourn', 'death', 'icon', 'elson', 'angela']","['south', 'africans', 'mourn', 'celebrate', 'angela']",1.7999999523162842,2,1639,1694,-55,3025
4715,"['boa', 'step', 'boris', 'march', 'delhi']","['time', 'history', 'technion', 'teach', 'engineering', 'russia']",0.0,0,73,63,10,100
4716,"['singapore', 'stock', 'close', 'high']","['indian', 'stock', 'open', 'high']",1.7999999523162842,2,1666,1690,-24,576
4717,"['maldive', 'hold', 'fresh', 'election', 'president']","['maldive', 'hold', 'fresh', 'presidential', 'election']",4.599999904632568,4,4100,5309,-1209,1461681
4718,"['egypt', 'announce', 'arrest', 'slim', 'brotherhood', 'supporter']","['egypt', 'order', 'arrest', 'brotherhood', 'chief']",1.7999999523162842,3,2644,1639,1005,1010025
4719,"['new', 'world', 'trade', 'enter', 'declare', 'table', 'build']","['world', 'trade', 'enter', 'name', 'small', 'building']",4.199999809265137,3,2645,4885,-2240,5017600
4720,"['papers', 'war']","['papers', 'june']",1.7999999523162842,1,1303,1638,-335,112225
4721,"['israel', 'green', 'light', 'settler', 'home']","['israel', 'unveil', 'settler', 'home']",3.200000047683716,3,2706,3327,-621,385641
4722,"['piers', 'organ', 'question', 'police']","['pier', 'organ', 'interview', 'police', 'packing', 'case']",3.5999999046325684,2,1649,3751,-2102,4418404
4723,"['lumbar', 'photojournalist', 'gangrene', 'case', 'crack', 'accuse', 'arrest']","['lumbar', 'journalist', 'gang', 'rape', 'case', 'accuse', 'arrest']",4.800000190734863,4,3956,5348,-1392,1937664
4724,"['israel', 'arrest', 'semen', 'tossed', 'spy']","['israel', 'force', 'detain', 'neuron', 'arrest', 'raid']",1.600000023841858,2,1626,1527,99,9801
4725,"['pakistani', 'girl', 'learn', 'hard', 'lesson']","['pakistani', 'girl', 'shoot', 'taliban', 'appear', 'video']",1.7999999523162842,2,1604,1626,-22,484
4726,"['egypt', 'interim', 'president', 'appoint', 'adviser']","['egypt', 'interim', 'president', 'swear', 'new', 'cabinet']",2.799999952316284,3,2681,2749,-68,4624
4727,"['china', 'launch', 'air', 'air', 'missile', 'copper']","['china', 'court', 'sentence', 'fili', 'life', 'imprisonment', 'corruption']",0.6000000238418579,1,1289,710,579,335241
4728,"['confirm', 'fear', 'syria', 'chemical', 'weapon']","['near', 'syria', 'chemical', 'weapon']",1.399999976158142,3,2692,1267,1425,2030625
4729,"['egypt', 'crackdown', 'draw', 'condemnation']","['egypt', 'egypt', 'crackdown', 'spark', 'global', 'outrage']",4.599999904632568,2,1620,5311,-3691,13623481
4730,"['egypt', 'swear', 'new', 'interim', 'leader']","['egypt', 'army', 'crack', 'brotherhood']",0.6000000238418579,1,1299,709,590,348100
4731,"['war', 'come', 'kill', 'pakistan']","['suicide', 'bomber', 'kill', 'pakistan']",2.5999999046325684,2,1414,2468,-1054,1110916
4732,"['senior', 'pakistani', 'taliban', 'commander', 'capture', 'afghanistan']","['pakistan', 'demand', 'protection', 'militant']",0.6000000238418579,0,43,708,-665,442225
4733,"['river', 'spanish', 'train', 'crash', 'face', 'question', 'judge']","['brain', 'driver', 'pain', 'crash', 'question', 'judge']",5.0,3,2642,5572,-2930,8584900
4734,"['stock', 'close', 'high']","['singapore', 'stock', 'close', 'low']",1.600000023841858,2,1448,1528,-80,6400
4735,"['release', 'initial', 'report', 'cracking', 'impart', 'water']","['man', 'china', 'detain', 'take', 'girl', 'hotel']",0.0,0,16,34,-18,324
4736,"['russia', 'blame', 'syrian', 'rebel', 'chemical', 'attack']","['russia', 'ask', 'consider', 'inquiry', 'syria', 'chemical', 'arm', 'use']",2.5999999046325684,2,1467,2482,-1015,1030225
4737,"['philippine', 'rebel', 'reach', 'wealth', 'share', 'deal']","['philippine', 'rebel', 'reach', 'wealth', 'deal']",5.0,5,4847,5574,-727,528529
4738,"['death', 'toll', 'west', 'things', 'violence', 'rise']","['urgent', 'death', 'toll', 'china', 'fire', 'rise']",1.2000000476837158,3,2673,1166,1507,2271049
4739,"['man', 'contest', 'seat']","['man', 'contest', 'election', 'seat']",4.75,3,2678,5334,-2656,7054336
4740,"['trailblaze', 'israel', 'electric', 'car', 'company', 'letter', 'place', 'fold']","['trailblaze', 'israel', 'electric', 'car', 'company', 'fold']",4.400000095367432,6,5197,5033,164,26896
4741,"['houston', 'texans', 'head', 'coach', 'mary', 'kubiak', 'hospitalize', 'collapse', 'game']","['texans', 'coach', 'mary', 'kubiak', 'stable', 'condition', 'collapse']",2.799999952316284,5,4841,2721,2120,4494400
4742,"['fro', 'oak', 'taliban', 'parlor', 'kill', 'drone', 'strike']","['taliban', 'commander', 'kill', 'drone', 'strike']",4.400000095367432,4,3843,5037,-1194,1425636
4743,"['war', 'bomb', 'kill', 'northwest', 'syria']","['war', 'bomb', 'northern', 'syria', 'kill']",4.599999904632568,4,3851,5307,-1456,2119936
4744,"['south', 'organ', 'soldier', 'kill', 'man', 'try', 'cross', 'border', 'north']","['north', 'hut', 'remaining', 'outline', 'south']",1.0,2,1871,1031,840,705600
4745,"['dead', 'spanish', 'train', 'crash']","['dead', 'spanish', 'high', 'speed', 'train', 'crash']",3.400000095367432,4,3847,3582,265,70225
4746,"['foreigner', 'sentence', 'death', 'drug', 'smuggling', 'egypt']","['egypt', 'sentence', 'pakistani', 'amid', 'death', 'drug', 'smuggling']",4.199999809265137,5,4835,4886,-51,2601
4747,"['french', 'train', 'detail', 'south', 'paris']","['french', 'train', 'passenger', 'tell', 'crash', 'ordeal']",1.2000000476837158,2,1861,1167,694,481636
4748,"['spokesman', 'president', 'donald', 'began', 'die']","['began', 'spokesman', 'carry', 'speaker', 'die']",4.199999809265137,3,2686,4889,-2203,4853209
4749,"['egypt', 'vote', 'new', 'constitution']","['egyptians', 'vote', 'division', 'constitution']",3.799999952316284,2,1893,4231,-2338,5466244
4750,"['drama', 'meet', 'angela', 'family', 'icon', 'remain', 'hospital']","['drama', 'meet', 'angela', 'family', 'will', 'not', 'visit', 'hospital']",2.799999952316284,5,4860,2665,2195,4818025
4751,"['weak', 'earning', 'drag', 'stock', 'lower', 'early', 'trade']","['weak', 'earning', 'drag', 'stock', 'lower', 'street']",3.799999952316284,5,4886,4229,657,431649
4752,"['fear', 'dead', 'helicopter', 'clash', 'pub']","['fear', 'dead', 'helicopter', 'pub', 'crash']",5.0,4,3834,5576,-1742,3034564
4753,"['siberia', 'lawmaker', 'charge', 'allege', 'bribery']","['iberian', 'charge', 'accept', 'bribe']",3.400000095367432,1,1255,3613,-2358,5560164
4754,"['super', 'raise', 'vs', 'dollar', 'early', 'trade']","['super', 'raise', 'dollar', 'early', 'trade']",1.7999999523162842,5,4885,1751,3134,9821956
4755,"['israel', 'teres', 'urge', 'return', 'peace', 'talk']","['israel', 'teres', 'call', 'return', 'peace', 'talk']",5.0,5,4883,5579,-696,484416
4756,"['drama', 'set', 'speak', 'syria', 'white', 'house', 'edt']","['drama', 'deliver', 'statement', 'syria', 'white', 'house']",5.0,4,3846,5580,-1734,3006756
4757,"['indian', 'stock', 'open', 'low']","['indian', 'stock', 'close', 'low']",1.7999999523162842,3,2712,1763,949,900601
4758,"['read', 'possible', 'solo', 'action', 'syria']","['make', 'case', 'action', 'syria']",3.400000095367432,2,1883,3588,-1705,2907025
4759,"['grief', 'clash', 'police', 'belfast']","['corner', 'clash', 'police', 'tunisia']",1.2000000476837158,2,2001,1168,833,693889
4760,"['china', 'quaker', 'death', 'toll', 'rise']","['china', 'fly', 'death', 'toll', 'rise']",1.399999976158142,4,3853,1271,2582,6666724
4761,"['arrest', 'bangladesh', 'building', 'toll', 'rise']","['owner', 'arrest', 'bangladesh', 'building', 'toll', 'reach']",2.5999999046325684,4,3859,2502,1357,1841449
4762,"['condemn', 'use', 'chemical', 'weapon', 'syria']","['question', 'arise', 'chemical', 'weapon', 'claim', 'syria']",2.5999999046325684,3,2668,2506,162,26244
4763,"['strong', 'new', 'quaker', 'hit', 'shatter', 'oak', 'region']","['powerful', 'new', 'earthquake', 'hit', 'shatter', 'pakistan', 'region']",4.800000190734863,4,3861,5443,-1582,2502724
4764,"['indian', 'troop', 'kill', 'pakistani', 'soldier', 'kashmir', 'line', 'control']","['indian', 'troop', 'raid', 'pakistani', 'military', 'post']",1.2000000476837158,3,2654,1170,1484,2202256
4765,"['hope', 'benedict', 'xvi', 'days', 'goodby', 'cardinal']","['hope', 'benedict', 'xvi', 'depart', 'vatican', 'time']",3.5999999046325684,3,2695,3760,-1065,1134225
4766,"['china', 'new', 'carrier', 'extend', 'military', 'modernization', 'drive']","['chinese', 'vice', 'premier', 'meet', 'australian', 'governor', 'general']",1.2000000476837158,0,12,1199,-1187,1408969
4767,"['brazilian', 'leader', 'hold', 'crisis', 'talk', 'street', 'protest']","['brazil', 'leader', 'promise', 'reform', 'vote']",1.600000023841858,1,1284,1555,-271,73441
4768,"['tropical', 'storm', 'andrew', 'lip', 'coast']","['tropical', 'storm', 'andrew', 'slide', 'coast']",4.0,4,3935,4456,-521,271441
4769,"['dead', 'indonesia', 'train', 'accident']","['dead', 'indonesia', 'train', 'collide', 'fuel', 'truck']",3.400000095367432,3,2682,3591,-909,826281
4770,"['israel', 'advance', 'plan', 'build', 'settlement', 'home']","['israel', 'unveil', 'plan', 'new', 'settler', 'home']",3.799999952316284,3,2679,4227,-1548,2396304
4771,"['miss', 'new', 'work', 'win', 'miss', 'america', 'crown']","['miss', 'new', 'work', 'crown', 'miss', 'america']",5.0,5,4946,5582,-636,404496
4772,"['austrian', 'find', 'harding', 'steal', 'skull', 'home', 'museum']","['austrian', 'man', 'charge', 'human', 'skull', 'find', 'home']",4.400000095367432,4,3931,5079,-1148,1317904
4773,"['set', 'drama', 'inauguration']","['house', 'back', 'new', 'sanction', 'ran', 'inauguration']",0.4000000059604645,1,1298,515,783,613089
4774,"['suspect', 'maude', 'militant', 'die', 'lebanese', 'custody']","['suspect', 'drone', 'kill', 'militant', 'semen']",0.4000000059604645,2,1991,529,1462,2137444
4775,"['set', 'fire', 'national']","['set', 'fire', 'washington', 'national']",4.800000190734863,3,2698,5417,-2719,7392961
4776,"['kill', 'attack', 'ran']","['kill', 'attack', 'ran']",2.0,3,2647,1853,794,630436
4777,"['thousand', 'protest', 'gay', 'marriage']","['thousand', 'protest', 'gay', 'marriage', 'france']",3.200000047683716,4,3927,3297,630,396900
4778,"['india', 'ink', 'image', 'january']","['india', 'ink', 'image', 'march']",1.0,3,2641,1038,1603,2569609
4779,"['capitol', 'lockdown', 'shot', 'fire']","['watch', 'live', 'capitol', 'lockdown', 'report', 'shot', 'fire']",4.800000190734863,4,3925,5412,-1487,2211169
4780,"['china', 'st', 'pilot', 'free', 'trade', 'opens']","['shanghai', 'free', 'trade', 'begin', 'operation']",3.799999952316284,2,1722,4224,-2502,6260004
4781,"['kill', 'injure', 'bomb', 'blast', 'pakistan']","['kill', 'injure', 'blast', 'pakista']",2.5999999046325684,3,2793,2461,332,110224
4782,"['select', 'image', 'bangladesh', 'building', 'collapse']","['kill', 'bangladesh', 'building', 'collapse']",1.399999976158142,3,2789,1273,1516,2298256
4783,"['chinese', 'court', 'uphold', 'death', 'penalty', 'belong', 'murderer']","['court', 'uphold', 'death', 'sentence', 'belong', 'murderer']",4.400000095367432,5,5010,5092,-82,6724
4784,"['egypt', 'protest', 'disperse']","['abduction', 'teacher', 'sentence']",0.0,0,5,2,3,9
4785,"['cylinder', 'blast', 'pakistan', 'school', 'bus', 'kill']","['deadly', 'cylinder', 'pakistan', 'school']",3.799999952316284,3,2788,4222,-1434,2056356
4786,"['north', 'organ', 'cargo', 'reveal', 'missile', 'repair', 'trade', 'cuba']","['n', 'organ', 'ship', 'carry', 'cuba', 'missile', 'seize']",2.799999952316284,3,2786,2701,85,7225
4787,"['israel', 'force', 'detain', 'palestinians', 'west', 'bank']","['israel', 'forces', 'arrest', 'palestinians', 'west', 'bank']",4.800000190734863,4,3917,5414,-1497,2241009
4788,"['protest', 'sweep', 'brazil', 'despite', 'concession']","['protest', 'plan', 'brazil', 'despite', 'concession']",4.0,4,3916,4441,-525,275625
4789,"['angela', 'jerk', 'win', 'term', 'german', 'election']","['jerked', 'sins', 'fig', 'germany', 'election']",3.799999952316284,1,1246,4221,-2975,8850625
4790,"['south', 'organ', 'worker', 'start', 'leave', 'joint', 'factory']","['south', 'organ', 'worker', 'set', 'leave', 'joint', 'factory', 'zone']",3.799999952316284,6,5159,4220,939,881721
4791,"['senate', 'vote', 'move', 'ahead', 'age', 'nod']","['benedict', 'come', 'home', 'new', 'house', 'new', 'hope']",0.0,0,3,3,0,0
4792,"['kill', 'score', 'injure', 'suicide', 'come', 'russian', 'train', 'station']","['suicide', 'bomber', 'kill', 'russian', 'train', 'station']",3.200000047683716,5,4963,3237,1726,2979076
4793,"['cambodian', 'opposition', 'leader', 'mainly', 'return', 'stir', 'election']","['cambodia', 'opposition', 'head', 'turn', 'parliament', 'poll', 'bid']",3.0,1,1263,2909,-1646,2709316
4794,"['west', 'nail', 'syria', 'opposition', 'vote', 'join', 'peace', 'talk']","['syrian', 'opposition', 'delegation', 'talk']",2.5999999046325684,2,1827,2521,-694,481636
4795,"['drama', 'travel', 'tornado', 'ravage', 'oklahoma']","['drama', 'visit', 'tornado', 'hit', 'oklahoma']",4.599999904632568,3,2778,5283,-2505,6275025
4796,"['deal', 'fiscal', 'cliff', 'drama', 'go', 'holiday']","['john', 'boehner', 'humble', 'origin', 'fiscal', 'cliff', 'undo']",1.0,2,1816,1044,772,595984
4797,"['syria', 'car', 'bomb', 'kill', 'rebel', 'hold', 'town']","['final', 'car', 'bomb', 'kill', 'egyptian', 'soldier']",1.7999999523162842,3,2816,1744,1072,1149184
4798,"['merry', 'b', 'palestinian', 'economic', 'plan', 'work']","['merry', 'deal', 'nuclear', 'talk', 'ran']",0.0,1,1270,4,1266,1602756
4799,"['bangladesh', 'building', 'collapse', 'death', 'toll', 'hit']","['indian', 'building', 'collapse', 'death', 'toll', 'rise']",0.800000011920929,4,3960,780,3180,10112400
4800,"['dozen', 'dead', 'central', 'african', 'republic', 'fighting']","['dead', 'central', 'african', 'republic', 'clash']",3.400000095367432,4,3959,3551,408,166464
4801,"['tibia', 'threaten', 'army', 'action', 'oil', 'protest']","['comb', 'threat', 'force', 'evacuation', 'princeton']",0.800000011920929,0,19,782,-763,582169
4802,"['turkish', 'union', 'strike', 'monday', 'protest', 'police', 'violence']","['turkey', 'unrest', 'union', 'strike', 'police', 'crackdown']",3.400000095367432,3,2803,3570,-767,588289
4803,"['wicker', 'pitch', 'upgrade', 'greek', 'credit', 'rating']","['moody', 'upgrade', 'greek', 'credit', 'rating']",3.400000095367432,4,3957,3674,283,80089
4804,"['lumen', 'ambush', 'police', 'boat', 'siberia', 'oil', 'region']","['sudanese', 'police', 'block', 'protest', 'human', 'right', 'commission']",0.0,1,1351,5,1346,1811716
4805,"['russians', 'leave', 'syria', 'cross', 'lebanon']","['russia', 'deliver', 'humanitarian', 'aid', 'syrian', 'refugee', 'lebanon']",2.200000047683716,1,1327,2020,-693,480249
4806,"['soldier', 'kill', 'insider', 'attack', 'afghanistan']","['soldier', 'kill', 'bomb', 'attack', 'pakistan']",0.800000011920929,3,2734,785,1949,3798601
4807,"['south', 'african', 'icon', 'elson', 'angela', 'hospitalize']","['south', 'africa', 'elson', 'angela', 'hospitalize']",5.0,4,3955,5635,-1680,2822400
4808,"['hope', 'francis', 'condemn', 'global', 'indifference', 'suffer']","['hope', 'francis', 'commemorate', 'dead', 'emigrant', 'lampedusa']",1.399999976158142,2,1780,1274,506,256036
4809,"['judge', 'mansour', 'swear', 'egypt', 'interim', 'president']","['justice', 'idly', 'mansour', 'swear', 'egypt', 'interim', 'president']",4.400000095367432,5,4949,5077,-128,16384
4810,"['kill', 'young', 'girl', 'eastern', 'afghanistan']","['kill', 'southern', 'afghanistan', 'official']",2.799999952316284,2,1777,2656,-879,772641
4811,"['demyan', 'police', 'arrest', 'key', 'll', 'shabaab', 'recruit', 'financier']","['sonya', 'hair', 'arrest', 'anti', 'terror', 'police']",3.200000047683716,2,1775,3243,-1468,2155024
4812,"['drama', 'announce', 'gun', 'control', 'plan', 'wednesday']","['drama', 'set', 'gun', 'control', 'plan']",3.5999999046325684,4,3953,3787,166,27556
4813,"['bomb', 'kill', 'people', 'wound', 'dozen', 'boston', 'marathon']","['bomb', 'find', 'boston', 'marathon', 'attack']",2.200000047683716,3,2739,2034,705,497025
4814,"['syria', 'chemical', 'weapon', 'end', 'sea']","['destroy', 'syria', 'chemical', 'weapon', 'stockpile', 'sea']",2.400000095367432,4,3946,2178,1768,3125824
4815,"['president', 'early', 'conclusion', 'co', 'partnership', 'ri', 'vanka']","['pakistan', 'deep', 'economic', 'tie', 'ri', 'vanka']",2.5999999046325684,2,1803,2401,-598,357604
4816,"['free', 'centre', 'abuse', 'probe']","['story', 'building', 'collapse', 'bute', 'beta']",0.0,0,39,7,32,1024
4817,"['comb', 'explode', 'greek', 'shopping', 'mall', 'people', 'injure']","['comb', 'explode', 'athens', 'shopping', 'mall', 'wound']",4.400000095367432,4,3943,5112,-1169,1366561
4818,"['australians', 'kill', 'plane', 'crash']","['dozen', 'kill', 'plane', 'crash']",3.0,3,2750,2821,-71,5041
4819,"['dead', 'include', 'german', 'maryland', 'mall', 'shooting']","['dead', 'maryland', 'mall', 'shooting']",4.199999809265137,4,3942,4722,-780,608400
4820,"['confirm', 'satin', 'syria', 'attack']","['war', 'crime', 'find', 'satin', 'syria', 'chemical', 'weapon', 'attack']",3.400000095367432,3,2749,3488,-739,546121
4821,"['kill', 'monster', 'truck', 'crash']","['kill', 'mexico', 'monster', 'truck', 'crash']",3.200000047683716,4,3941,3316,625,390625
4822,"['jerked', 'lies', 'rd', 'term', 'office', 'germany', 'elections']","['jerked', 'sins', 'fig', 'germany', 'election']",3.25,2,1794,3387,-1593,2537649
4823,"['x', 'virginia', 'governor', 'mob', 'mcdonnell', 'charge', 'corruption']","['virginia', 'ex', 'sov', 'mob', 'mcdonnell', 'wife', 'charge', 'corruption']",3.799999952316284,5,4979,4214,765,585225
4824,"['printer', 'son', 'sofa', 'lowell', 'test', 'positive', 'banner', 'substance']","['sprinter', 'son', 'test', 'positive', 'banner', 'substance']",3.400000095367432,5,4978,3479,1499,2247001
4825,"['magnitude', 'quaker', 'hit', 'honshu', 'japan', 'cenc']","['quaker', 'bolt', 'santa', 'cruz', 'islands', 'cenc']",1.7999999523162842,2,1792,1758,34,1156
4826,"['pakistan', 'release', 'senior', 'afghan', 'taliban', 'prisoner']","['pakistan', 'release', 'senior', 'taliban', 'commander', 'saturday']",3.799999952316284,4,3915,4213,-298,88804
4827,"['egypt', 'court', 'order', 'release', 'mubarak']","['egypt', 'court', 'order', 'mubarak', 'free']",5.0,4,3951,5637,-1686,2842596
4828,"['american', 'investigator', 'wait', 'question', 'arrest', 'boston', 'bomber']","['police', 'converge', 'street', 'search', 'boston', 'bomb', 'suspect']",1.7999999523162842,1,1331,1750,-419,175561
4829,"['dead', 'injure', 'china', 'road', 'accident']","['dead', 'injure', 'e', 'china', 'road', 'accident']",1.75,5,4858,1623,3235,10465225
4830,"['bollywood', 'cut', 'cost', 'rule', 'collapse', 'bite']","['bollywood', 'cut', 'cost', 'rule', 'crisis', 'bite']",4.199999809265137,5,4830,4705,125,15625
4831,"['woman', 'face', 'high', 'car', 'insurance', 'premium']","['woman', 'driver', 'face', 'insurance', 'premium', 'rise']",5.0,4,3914,5638,-1724,2972176
4832,"['tornado', 'rip', 'widest', 'kill', 'devastating', 'neighborhood']","['tornado', 'damaging', 'storm', 'hit', 'widest', 'kill']",3.200000047683716,3,2713,3321,-608,369664
4833,"['china', 'give', 'regulatory', 'access', 'audit', 'record']","['china', 'oppose', 'arm', 'sale', 'taiwan']",0.800000011920929,1,1242,766,476,226576
4834,"['singapore', 'stock', 'end', 'percent']","['singapore', 'stock', 'end']",2.0,3,2766,1803,963,927369
4835,"['ran', 'atomic', 'agency', 'talk', 'rowhani', 'election']","['iaea', 'ran', 'hold', 'nuclear', 'talk', 'rohans', 'election']",4.800000190734863,3,2755,5468,-2713,7360369
4836,"['china', 'new', 'reject', 'hack', 'claim']","['china', 'premier', 'reject', 'groundless', 'hack', 'accusation']",5.0,3,2760,5640,-2880,8294400
4837,"['dzhokhar', 'tsarnaev', 'plead', 'guilty', 'boston', 'come', 'charge']","['dzhokhar', 'tsarnaev', 'charge', 'boston', 'marathon', 'come']",2.5999999046325684,5,4634,2407,2227,4959529
4838,"['picture', 'day', 'august']",['picture'],2.799999952316284,1,1241,2717,-1476,2178576
4839,"['chinese', 'general', 'son', 'get', 'year', 'jail', 'rape']","['chinese', 'army', 'singer', 'get', 'year', 'jail', 'gang', 'rape']",3.400000095367432,5,4635,3605,1030,1060900
4840,"['police', 'seek', 'driver', 'crash', 'kill', 'child']","['police', 'seek', 'luman', 'new', 'orleans', 'parade', 'shooting']",0.0,2,1796,8,1788,3196944
4841,"['egypt', 'hold', 'presidential', 'election', 'parliamentary', 'poll']","['egypt', 'interim', 'president', 'swear', 'new', 'cabinet']",1.399999976158142,1,1047,1288,-241,58081
4842,"['pentagon', 'adjust', 'plan', 'intense', 'attack', 'syria']","['hope', 'thank', 'public', 'join', 'syria', 'vigil']",1.0,1,1048,1051,-3,9
4843,"['simon', 'bank', 'martial', 'art', 'club', 'amid', 'kill']","['simon', 'dans', 'partial', 'arts', 'schools', 'amid', 'willing']",5.0,2,1799,5644,-3845,14784025
4844,"['afghan', 'legislator', 'approve', 'new', 'election', 'law']","['afghan', 'president', 'approve', 'new', 'election', 'law']",2.5999999046325684,5,4610,2437,2173,4721929
4845,"['pakistan', 'army', 'adamant', 'fight', 'taliban']","['oak', 'army', 'adamant', 'fight', 'taleban']",4.800000190734863,3,2726,5477,-2751,7568001
4846,"['egyptian', 'army', 'push', 'attack', 'kidnap']","['egypt', 'dorsi', 'rule', 'talk', 'hostage', 'video', 'appear']",1.399999976158142,0,38,1278,-1240,1537600
4847,"['south', 'africans', 'mourn', 'angela', 'bury']","['south', 'africa', 'hold', 'state', 'funeral', 'angela']",2.799999952316284,2,1804,2720,-916,839056
4848,"['witness', 'hear', 'loud', 'boot', 'boston', 'marathon']","['report', 'explosion', 'finish', 'line', 'boston', 'marathon']",3.0,2,1785,2847,-1062,1127844
4849,"['cryptic', 'crossword', 'saturday', 'april']","['ruin', 'crossword', 'saturday', 'april']",2.799999952316284,3,2807,2723,84,7056
4850,"['costa', 'concordia', 'captain', 'try', 'manslaughter']","['costa', 'concordia', 'survivor', 'detail', 'experience', 'year', 'later']",1.2000000476837158,2,1782,1211,571,326041
4851,"['israel', 'minister', 'laws', 'merry', 'boycott', 'warning']","['israel', 'minister', 'slum', 'merry', 'boycott', 'warning']",4.599999904632568,5,4668,5285,-617,380689
4852,"['angelina', 'police', 'aunt', 'die', 'breast', 'cancer']","['angelina', 'police', 'complex', 'truth', 'breast', 'cancer']",2.799999952316284,4,3871,2712,1159,1343281
4853,"['myanmar', 'urge', 'party', 'unity', 'amid', 'squabble']","['urge', 'party', 'unity', 'amid', 'squabble']",5.0,5,4670,5645,-975,950625
4854,"['thing', 'wednesday']","['thing', 'today']",3.0,1,1057,2859,-1802,3247204
4855,"['white', 'house', 'defense', 'contractor', 'discuss', 'harm', 'automatic', 'spending', 'cut']","['white', 'house', 'defense', 'firm', 'discuss', 'automatic', 'spending', 'cut']",4.400000095367432,7,5230,5060,170,28900
4856,"['venezuela', 'hugo', 'die', 'cancer']","['venezuelan', 'president', 'hugo', 'die', 'cancer']",3.799999952316284,3,2821,4237,-1416,2005056
4857,"['zambian', 'president', 'arrest']","['labia', 'ex', 'president', 'rupia', 'arrest']",4.0,2,1776,4498,-2722,7409284
4858,"['senate', 'confirm', 'ellen', 'red', 'chair']","['senate', 'confirm', 'janet', 'ellen', 'new', 'central', 'bank', 'chief']",4.199999809265137,3,2781,4779,-1998,3992004
4859,"['palestinian', 'prisoner', 'release', 'israel', 'prison']","['palestinian', 'prisoner', 'die', 'cancer', 'unrest', 'israel', 'jail']",1.0,3,2775,1054,1721,2961841
4860,"['sign', 'share', 'rally', 'string', 'beat', 'datum']","['sign', 'markets', 'strong', 'sobs', 'data']",4.0,1,1052,4500,-3448,11888704
4861,"['kill', 'wound', 'bomb', 'attack', 'northern', 'ran']","['kill', 'wound', 'fresh', 'attack', 'ran']",2.799999952316284,4,3886,2708,1178,1387684
4862,"['officer', 'injure', 'india', 'anti', 'rape', 'protest', 'die']","['indian', 'policeman', 'injure', 'gang', 'rape', 'protest', 'die']",4.199999809265137,4,3887,4782,-895,801025
4863,"['typhus', 'ballot', 'remark', 'alarm', 'market']","['typhus', 'ballot', 'usual', 'neuro', 'nonsense']",2.5999999046325684,2,1778,2522,-744,553536
4864,"['action', 'james', 'diana', 'ojukwu', 'apga', 'national', 'leader']","['diana', 'ojukwu', 'apga', 'national', 'leader']",4.199999809265137,5,4674,4783,-109,11881
4865,"['conclusively', 'determine', 'chemical', 'weapons', 'use', 'syria']","['see', 'conclusive', 'evidence', 'chemical', 'arms', 'use', 'syria']",4.800000190734863,3,2657,5453,-2796,7817616
4866,"['kill', 'luman', 'raid', 'village']","['kill', 'lasts', 'india']",0.2000000029802322,1,1044,394,650,422500
4867,"['egypt', 'shut', 'slim', 'brotherhood', 'newspaper']","['egypt', 'slim', 'brotherhood', 'deputy', 'head', 'arrest']",1.399999976158142,3,2669,1279,1390,1932100
4868,"['strong', 'earthquake', 'western', 'china', 'kill', 'people']","['strong', 'earthquake', 'western', 'china', 'kill']",3.0,5,4661,2865,1796,3225616
4869,"['dowden', 'thank', 'russia', 'asylum']","['dowden', 'thank', 'russia', 'grant', 'asylum']",5.0,4,3911,5648,-1737,3017169
4870,"['senate', 'confirm', 'ellen', 'red', 'head']","['senate', 'confirm', 'ellen', 'red', 'chair']",4.199999809265137,4,3910,4791,-881,776161
4871,"['french', 'force', 'key', 'ali', 'town']","['french', 'force', 'seize', 'key', 'town']",3.799999952316284,4,3909,4174,-265,70225
4872,"['boston', 'come', 'suspect', 'bury', 'virginia']","['boston', 'bomb', 'suspect', 'bury', 'virginia', 'cemetery']",5.0,4,3908,5649,-1741,3031081
4873,"['large', 'extremely', 'dangerous', 'tornado', 'head', 'oklahoma', 'city']","['tom', 'baby', 'kill', 'torpedo', 'rake', 'oklahoma', 'city', 'area']",1.600000023841858,2,1838,1583,255,65025
4874,"['postage', 'drama', 'drag', 'alabama', 'school', 'bus', 'shooting']","['nevada', 'dead', 'hurt', 'middle', 'school', 'shooting']",0.800000011920929,2,1846,761,1085,1177225
4875,"['palestinian', 'president', 'assign', 'academic', 'form', 'west', 'bank']","['palestinian', 'president', 'want', 'israelis', 'talk', 'peace']",1.7999999523162842,2,1832,1735,97,9409
4876,"['pakistan', 'balaga', 'leave', 'hospital', 'await', 'surgery']","['balaga', 'leave', 'british', 'hospital']",3.5999999046325684,3,2702,3785,-1083,1172889
4877,"['find', 'dead', 'swim', 'pool', 'essex', 'hotel']","['woman', 'find', 'dead', 'essex', 'hotel', 'swimming', 'pool']",4.0,5,4643,4517,126,15876
4878,"['pakistan', 'condemn', 'drone', 'strike', 'shawl', 'area']","['pakistan', 'condemn', 'drone', 'strike', 'miranshah']",3.200000047683716,4,3904,3123,781,609961
4879,"['resident', 'return', 'texas', 'blast', 'site']","['resident', 'return', 'fallujah']",0.0,2,1814,18,1796,3225616
4880,"['south', 'africa', 'ray', 'elson', 'angela']","['south', 'africa', 'unite', 'prayer', 'song', 'elson', 'angela']",4.199999809265137,4,3902,4741,-839,703921
4881,"['ran', 'ahmadinejad', 'face', 'charge', 'election', 'appearance', 'aide']","['ahmadinejad', 'face', 'charge', 'election', 'appearance']",4.199999809265137,5,4652,4742,-90,8100
4882,"['miliband', 'pledge', 'strengthen', 'minimum', 'wage']","['portugal', 'china', 'strengthen', 'scientific', 'research', 'tie']",0.0,1,1040,19,1021,1042441
4883,"['singapore', 'stock', 'close', 'low']","['singapore', 'stock', 'close', 'high']",2.5999999046325684,3,2705,2474,231,53361
4884,"['dnieper', 'wait', 'result', 'appeal']","['new', 'glory', 'china', 'strive', 'renewal']",0.0,0,28,20,8,64
4885,"['apple', 'share', 'hit', 'hard', 'shone', 'disappointment']","['apple', 'stock', 'plunge', 'earning', 'disappointment']",3.200000047683716,2,1695,3091,-1396,1948816
4886,"['renew', 'sanction', 'zimbabwe']","['lift', 'diamond', 'sanction', 'zimbabwe']",3.0,2,1699,2824,-1125,1265625
4887,"['occupy', 'palestinian', 'territory', 'palestinians', 'rebuff', 'peace', 'talk', 'blueprint']","['occupy', 'palestinian', 'territory', 'palestinians', 'face', 'route']",1.399999976158142,4,3897,1285,2612,6822544
4888,"['owner', 'charge', 'bangladesh', 'factory', 'fire']","['survivor', 'find', 'bangladesh', 'factory']",1.7999999523162842,2,1704,1741,-37,1369
4889,"['egypt', 'set', 'lure', 'gulf', 'investor']","['egypt', 'seek', 'lure', 'investor']",3.400000095367432,3,2665,3535,-870,756900
4890,"['russia', 'reach', 'agreement', 'syria']","['russia', 'reach', 'agreement', 'syria', 'weapon']",3.400000095367432,4,3895,3499,396,156816
4891,"['palestinians', 'jordan', 'coordinate', 'stance', 'peace', 'talk']","['james', 'senior', 'deny', 'papa', 'coordinate', 'peace', 'talk']",1.7999999523162842,3,2710,1663,1047,1096209
4892,"['note', 'cancel', 'province', 'tense', 'election']","['cambodian', 'opposition', 'reject', 'run', 'men', 'election', 'win']",0.0,1,1094,21,1073,1151329
4893,"['drama', 'cancer', 'moscow', 'meeting', 'ruin']","['drama', 'cancel', 'meeting', 'ruin']",4.0,3,2709,4474,-1765,3115225
4894,"['klci', 'sutures', 'trade', 'mix', 'mid', 'day']","['share', 'mix', 'mid', 'day']",3.5999999046325684,3,3204,3793,-589,346921
4895,"['suspect', 'drone', 'strike', 'kill', 'pakistan']","['drone', 'strike', 'kill', 'pakistan']",2.799999952316284,4,4178,2674,1504,2262016
4896,"['egypt', 'court', 'order', 'mubarak', 'release']","['egypt', 'court', 'turn', 'mubarak', 'release', 'request']",2.0,4,4018,1873,2145,4601025
4897,"['holland', 'threaten', 'legal', 'action', 'affair', 'allegation']","['françois', 'holland', 'threaten', 'legal', 'action', 'affair', 'claim']",4.0,5,4638,4482,156,24336
4898,"['cranial', 'exile', 'report', 'death', 'ran', 'camp']","['cranial', 'exile', 'kill', 'ran', 'camp', 'sheaf']",3.0,4,3890,2839,1051,1104601
4899,"['blade', 'gunner', 'histories', 'dispute', 'murder', 'charge']","['history', 'cop', 'seven', 'attempt', 'murder', 'charge']",2.0,2,1692,1813,-121,14641
4900,"['israel', 'force', 'detain', 'neuron', 'arrest', 'raid']","['israel', 'credibility', 'line', 'ran', 'nuclear', 'challenge']",2.25,1,1095,2156,-1061,1125721
4901,"['egyptians', 'vote', 'islamist', 'back', 'constitution']","['judge', 'poll', 'direct', 'voter', 'egypt', 'constitution', 'vote']",1.399999976158142,2,1689,1286,403,162409
4902,"['mexico', 'swear', 'president', 'amid', 'violent', 'protest']","['new', 'mexico', 'sov', 'richardson', 'press', 'north', 'organ', 'test', 'ban']",0.0,1,1088,26,1062,1127844
4903,"['helicopter', 'clash', 'near', 'rail', 'station', 'london']","['helicopter', 'clash', 'london']",4.0,3,3761,4490,-729,531441
4904,"['indonesian', 'capital', 'ray', 'retro', 'ease', 'traffic', 'chaos']","['makarka', 'ray', 'retro', 'ease', 'traffic', 'chaos']",3.799999952316284,5,4624,4135,489,239121
4905,"['japanese', 'plane', 'fly', 'china', 'new', 'defense', 'zone']","['japan', 's', 'organ', 'military', 'plane', 'defy', 'china', 'new', 'defence', 'zone']",4.0,4,3893,4491,-598,357604
4906,"['typhoon', 'survivor', 'raid', 'philippine', 'store']","['typhoon', 'alpha', 'kill', 'philippines']",1.2000000476837158,1,1066,1231,-165,27225
4907,"['war', 'comb', 'wound', 'hezbollah', 'stronghold', 'lebanon']","['war', 'bomb', 'rock', 'hezbollah', 'stronghold', 'lebanon']",3.200000047683716,4,3894,3093,801,641601
4908,"['urge', 'syrian', 'opposition', 'assist', 'immediate', 'release', 'foreigner', 'capture', 'syria']","['s', 'opposition', 'candidate', 'close', 'poll', 'gap']",0.6000000238418579,1,1067,695,372,138384
4909,"['dead', 'miss', 'canada', 'train', 'disaster']","['dead', 'miss', 'china', 'landslide']",0.6000000238418579,2,1741,696,1045,1092025
4910,"['senate', 'confirm', 'janet', 'ellen', 'federal', 'reserve', 'chief']","['senate', 'confirm', 'janet', 'ellen', 'federal', 'reserve', 'hair']",4.599999904632568,6,5156,5286,-130,16900
4911,"['say', 'name', 'new', 'pakistani', 'taliban', 'leader', 'hakimullah', 'mehsud', 'kill', 'drone', 'strike']","['pakistani', 'taliban', 'chief', 'hakimullah', 'mehsud', 'kill', 'drone', 'strike']",3.400000095367432,7,5288,3567,1721,2961841
4912,"['kill', 'comb', 'lasts', 'ran']","['kill', 'baquba', 'last']",2.200000047683716,1,1078,2001,-923,851929
4913,"['russia', 'destroy', 'chemical', 'weapons', 'stockpile']","['britain', 'see', 'evidence', 'sad', 'use', 'chemical', 'weapons']",1.0,2,1752,1020,732,535824
4914,"['ran', 'earthquake', 'death', 'toll', 'rise']","['algeria', 'hostage', 'death', 'toll', 'rise']",0.6000000238418579,3,3773,670,3103,9628609
4915,"['suarez', 'set', 'comeback']","['french', 'set', 'ali', 'ground', 'combat']",0.800000011920929,1,1072,820,252,63504
4916,"['maldive', 'team', 'india', 'observe', 'election']","['testimony', 'trial', 'iberian', 'begin']",0.6000000238418579,0,26,669,-643,413449
4917,"['death', 'toll', 'rise', 'storm', 'waver', 'matter', 'northern', 'europe']","['storm', 'death', 'toll', 'rise', 'wind', 'rain', 'matter', 'north', 'europe']",3.200000047683716,6,5151,3189,1962,3849444
4918,"['pakistan', 'release', 'afghan', 'taliban', 'prisoner']","['pakistan', 'release', 'seven', 'afghan', 'taliban', 'fighter']",3.5999999046325684,4,3899,3755,144,20736
4919,"['fix', 'reaction', 'sex', 'marriage']","['new', 'zealand', 'legalize', 'sex', 'marriage']",2.200000047683716,2,1757,2070,-313,97969
4920,"['weatherman', 'red', 'ballot', 'arrest', 'sex', 'claim']","['weatherman', 'red', 'ballot', 'hold', 'ex', 'abuse']",3.799999952316284,3,3778,4131,-353,124609
4921,"['drone', 'strike', 'kill', 'pakistan']","['pakistan', 'drone', 'strike', 'kill']",3.0,4,3901,2911,990,980100
4922,"['building', 'collapse', 'india', 'fear', 'wrap']","['india', 'building', 'collapse', 'kill', 'dozen', 'wrap']",3.0,4,3912,2915,997,994009
4923,"['somalia', 'shebab', 'claim', 'responsibility', 'nairobi', 'mall', 'attack']","['syrian', 'rebel', 'claim', 'responsibility', 'kill', 'lebanon']",1.2000000476837158,2,1758,1234,524,274576
4924,"['syrian', 'troop', 'push', 'strategic', 'rebelheld', 'town']","['syrian', 'army', 'push', 'assault', 'rebel', 'hold', 'town']",4.0,3,3730,4354,-624,389376
4925,"['israel', 'agree', 'release', 'palestinian', 'prisoner']","['israel', 'release', 'palestinian', 'prisoner']",2.799999952316284,4,3906,2671,1235,1525225
4926,"['dozen', 'die', 'clash', 'erupt', 'dorsi', 'rally', 'cairo']","['dead', 'clash', 'dorsi', 'ally', 'egypt']",3.5999999046325684,2,1738,3758,-2020,4080400
4927,"['opposition', 'protest', 'begin', 'bangkok', 'shutdown']","['protest', 'launch', 'bangkok', 'shutdown']",4.800000190734863,3,3738,5351,-1613,2601769
4928,"['spanish', 'train', 'crash', 'driver', 'question']","['spanish', 'train', 'driver', 'pardon', 'question', 'judge']",3.799999952316284,4,3907,4128,-221,48841
4929,"['france', 'nails', 'breakthrough', 'real', 'syria', 'weapons']","['france', 'welcomes', 'russia', 'real', 'syria']",4.0,3,3750,4365,-615,378225
4930,"['isaf', 'soldier', 'kill', 'afghan', 'insider', 'attack']","['british', 'soldier', 'shoot', 'dead', 'afghan', 'insider', 'attack']",4.0,4,3888,4346,-458,209764
4931,"['rush', 'death', 'ivory', 'coast', 'stampede']","['dead', 'ivory', 'coast', 'stampede']",3.400000095367432,3,3791,3586,205,42025
4932,"['glasgow', 'helicopter', 'crash', 'search', 'end']","['glasgow', 'helicopter', 'crash', 'head']",2.799999952316284,3,3786,2686,1100,1210000
4933,"['dead', 'marathon', 'bomb']","['taliban', 'deny', 'involvement', 'boston', 'marathon', 'come']",1.2000000476837158,1,1076,1235,-159,25281
4934,"['swiss', 'tourist', 'gang', 'rapid', 'india']","['swiss', 'tourist', 'gang', 'rapid', 'india']",5.0,5,4616,5650,-1034,1069156
4935,"['india', 'trace', 'passive', 'cyclone']","['india', 'issue', 'red', 'alert', 'cycle', 'hamlin']",2.799999952316284,1,1026,2663,-1637,2679769
4936,"['discipline', 'student', 'german', 'thought', 'spare', 'colorado', 'shooting']","['discipline', 'student', 'think', 'key', 'motive']",3.400000095367432,2,1724,3604,-1880,3534400
4937,"['kill', 'japan', 'road', 'tunnel', 'collapse']","['kill', 'syrian', 'air', 'strike']",1.2000000476837158,1,974,1236,-262,68644
4938,"['plan', 'shut', 'petrol', 'pump', 'night', 'oily']","['india', 'get', 'reject', 'proposal', 'shut', 'petrol', 'pump', 'night']",3.799999952316284,4,3865,4126,-261,68121
4939,"['clinton', 'testify', 'month', 'benghazi', 'attack']","['clinton', 'return', 'work', 'plan', 'testify', 'benghazi', 'attack']",3.799999952316284,4,3867,4139,-272,73984
4940,"['ten', 'thousand', 'ukrainian', 'protest', 'iv']","['ten', 'thousand', 'line', 'cast', 'vote', 'human']",0.6000000238418579,2,1733,664,1069,1142761
4941,"['karzai', 'visit', 'pakistan', 'taliban', 'peace', 'talk']","['afghan', 'president', 'extend', 'visit', 'pakistan', 'taliban', 'talk']",3.5999999046325684,4,3868,3776,92,8464
4942,"['thief', 'snatch', 'english', 'channel', 'swimmer', 'custom', 'wheelchair']","['thief', 'steal', 'channel', 'swimmer', 'wheelchair']",4.0,4,3869,4409,-540,291600
4943,"['die', 'car', 'crash']","['kill', 'crash', 'tiananmen', 'square']",4.599999904632568,1,975,5308,-4333,18774889
4944,"['singapore', 'share', 'open', 'lower', 'friday']","['singapore', 'share', 'open', 'higher', 'thursday']",2.200000047683716,3,3816,2088,1728,2985984
4945,"['drama', 'pledge', 'reign', 'economy']","['drama', 'press', 'congress', 'act', 'economy']",2.5999999046325684,2,1807,2452,-645,416025
4946,"['earthquake', 'northwest', 'china', 'head']","['win', 'quaker', 'kill', 'china']",2.400000095367432,1,976,2246,-1270,1612900
4947,"['white', 'ulcer', 'give', 'consecutive', 'life', 'term']","['white', 'ulcer', 'get', 'life', 'racketeering', 'kill']",3.200000047683716,3,3829,3201,628,394384
4948,"['demyan', 'force', 'cause', 'mall', 'collapse']","['official', 'say', 'demyan', 'force', 'cause', 'mall', 'collapse']",5.0,5,4621,5651,-1030,1060900
4949,"['oak', 'mission', 'uae', 'gear', 'election']","['islamist', 'party', 'egypt', 'unite', 'election']",1.399999976158142,1,977,1281,-304,92416
4950,"['bangladesh', 'building', 'disaster', 'death', 'toll', 'pass']","['bangladesh', 'building', 'collapse', 'death', 'toll', 'limb']",3.0,4,3870,2763,1107,1225449
4951,"['algeria', 'hostage', 'crisis', 'end', 'death', 'toll', 'unclear']","['algeria', 'hostage', 'crisis', 'end', 'bloodbath']",3.799999952316284,4,3872,4123,-251,63001
4952,"['egypt', 'ministry', 'urge', 'end', 'pro', 'dorsi', 'protest']","['egypt', 'child', 'kill', 'cairo', 'clash', 'pro', 'dorsi', 'protest']",2.799999952316284,4,3873,2732,1141,1301881
4953,"['south', 'africa', 'angela', 'take', 'hospital']","['south', 'africa', 'angela', 'remain', 'hospital']",3.200000047683716,4,3874,3195,679,461041
4954,"['china', 'juan', 'strengthen', 'usd']","['china', 'juan', 'strengthen', 'new', 'high', 'usd']",3.0,4,3875,2760,1115,1243225
4955,"['police', 'question', 'man', 'deadly', 'boardwalk', 'crash']","['police', 'arrest', 'suspect', 'deadly', 'drive', 'attack']",2.200000047683716,2,1980,2098,-118,13924
4956,"['turkish', 'riot', 'police', 'tear', 'gas', 'maksim', 'square', 'protest']","['turkish', 'riot', 'police', 'enter', 'maksim', 'square']",3.0,5,4630,2759,1871,3500641
4957,"['chicago', 'shooting', 'show', 'cap', 'step', 'noticing']","['chicago', 'shooting', 'show', 'gap', 'step', 'policy']",5.0,4,3876,5652,-1776,3154176
4958,"['bed', 'require', 'car', 'car', 'safety', 'communication']","['guatemala', 'overturn', 'dictator', 'genocide', 'conviction']",0.0,0,23,109,-86,7396
4959,"['north', 'shut', 'offer', 'talk']","['north', 'shoot', 'ricket']",1.2000000476837158,1,982,1244,-262,68644
4960,"['prince', 'charles', 'compare', 'ruin']","['prince', 'charles', 'compare', 'vladimir', 'ruin', 'wolf']",5.0,4,3878,5653,-1775,3150625
4961,"['ran', 'warn', 'military', 'intervention', 'ran']","['explosion', 'near', 'damascus', 'military', 'airport']",0.0,1,983,112,871,758641
4962,"['israel', 'accuse', 'ran', 'president', 'hypocrisy']","['greek', 'accuse', 'coalition', 'hypocrisy']",1.2000000476837158,2,1992,1238,754,568516
4963,"['police', 'clash', 'youth', 'cairo', 'anti', 'dorsi', 'protest']","['egypt', 'police', 'clash', 'pro', 'dorsi', 'protest']",2.799999952316284,4,3880,2682,1198,1435204
4964,"['diplomats', 'feet', 'munich', 'critical', 'time']","['diplomats', 'discuss', 'ran', 'nuclear', 'program']",2.400000095367432,1,984,2231,-1247,1555009
4965,"['dowden', 'give', 'refugee', 'document', 'ecuador']","['dowden', 'pose', 'fly', 'moscow']",1.2000000476837158,1,985,1240,-255,65025
4966,"['message', 'world', 'dress', 'freedom']","['pakistan', 'mark', 'world', 'dress', 'freedom']",2.200000047683716,3,3807,2081,1726,2979076
4967,"['foreign', 'minister', 'discuss', 'syria', 'arm', 'embargo']","['foreign', 'minister', 'seek', 'solution', 'syria', 'arm']",3.5999999046325684,4,3884,3770,114,12996
4968,"['death', 'toll', 'philippine', 'earthquake', 'rise']","['death', 'toll', 'philippines', 'quaker', 'rise']",3.5999999046325684,3,3812,3804,8,64
4969,"['stock', 'watch', 'close', 'monday']","['stock', 'watch', 'monday']",4.0,3,3727,4371,-644,414736
4970,"['army', 'jet', 'kill', 'militant', 'pakistan', 'air', 'maid']","['drone', 'kill', 'militant', 'pakistan']",3.200000047683716,3,3667,3147,520,270400
4971,"['egyptian', 'police', 'fire', 'tear', 'gas', 'protest', 'cairo']","['police', 'fire', 'tear', 'gas', 'protest', 'cairo']",4.0,6,5177,4399,778,605284
4972,"['philippines', 'hold', 'second', 'senator', 'corruption']","['philippine', 'recover', 'powerful', 'typhoid']",1.399999976158142,0,41,1313,-1272,1617984
4973,"['german', 'envoy', 'optimistic', 'ran', 'talk']","['ran', 'cautiously', 'optimistic', 'future', 'nuclear', 'talk']",1.399999976158142,3,3641,1360,2281,5202961
4974,"['renowned', 'spanish', 'flamenco', 'guitarist', 'face', 'lucia', 'die']","['spanish', 'flamenco', 'guitarist', 'face', 'de', 'lucia', 'die']",4.599999904632568,6,5172,5288,-116,13456
4975,"['chinese', 'icebreaker', 'change', 'course', 'suspicious', 'object']","['chinese', 'search', 'plane', 'find', 'suspicious', 'object']",2.0,3,3645,1784,1861,3463321
4976,"['dowden', 'bundle', 'search', 'asylum']","['dowden', 'hit', 'bundle', 'search', 'asylum']",5.0,4,3885,5632,-1747,3052009
4977,"['death', 'toll', 'building', 'collapse', 'south', 'india', 'mount']","['kill', 'building', 'collapse', 'southern', 'india']",2.799999952316284,3,3654,2729,925,855625
4978,"['pakistan', 'impose', 'temporary', 'ban', 'channel']","['pakistan', 'dismissed', 'case', 'fbi', 'agent']",1.399999976158142,1,987,1318,-331,109561
4979,"['palestinian', 'prisoner', 'arrive', 'muqata', 'ramallah']","['pakistani', 'prisoner', 'assault', 'mamma', 'jail']",1.0,1,956,1070,-114,12996
4980,"['dead', 'injure', 'china', 'road', 'accident']","['hurt', 'papa', 'city', 'car', 'accident']",1.0,1,957,1073,-116,13456
4981,"['mass', 'security', 'force', 'smother', 'bangkok', 'protest']","['security', 'force', 'stay', 'barrack', 'protest', 'dwindle']",1.7999999523162842,3,3659,1709,1950,3802500
4982,"['refuse', 'resign', 'gaze', 'comment']","['spanish', 'refuse', 'resign', 'corruption', 'scandal']",0.2000000029802322,2,1964,375,1589,2524921
4983,"['explosion', 'kill', 'outside', 'mosque', 'lebanon', 'tripoli']","['explosion', 'rock', 'city', 'northern', 'lebanon']",2.0,2,1966,1806,160,25600
4984,"['pakistan', 'fighter', 'jet', 'bomb', 'taliban', 'hideous']","['pakistan', 'want', 'arm', 'supply', 'syrian', 'side', 'stop']",1.600000023841858,1,958,1558,-600,360000
4985,"['lumen', 'right', 'second', 'sonya', 'attack']","['luman', 'second', 'sonya', 'attack']",3.0,3,3665,2780,885,783225
4986,"['resume', 'search', 'miss', 'british', 'sailor', 'public']","['coast', 'guard', 'suspend', 'search', 'miss', 'british', 'sailor']",2.400000095367432,4,3945,2238,1707,2913849
4987,"['iraqi', 'comb', 'attacks']","['iraqi', 'war', 'comb', 'dear', 'church', 'hills']",3.0,2,1968,2785,-817,667489
4988,"['egypt', 'force', 'set', 'block', 'access', 'dorsi', 'protest', 'camp']","['egyptian', 'force', 'clear', 'pro', 'dorsi', 'protest', 'camp']",2.400000095367432,4,3950,2240,1710,2924100
4989,"['noble', 'author', 'boris', 'passing', 'die']","['noble', 'laureate', 'boris', 'passing', 'die']",5.0,4,3952,5631,-1679,2819041
4990,"['japan', 'opposition', 'party', 'chief', 'criticize', 'economic', 'policy']","['opposition', 'mdc', 'party', 'challenge', 'robert', 'election', 'win']",0.0,2,1996,119,1877,3523129
4991,"['suspect', 'take', 'custody', 'boston', 'coming', 'case']","['boston', 'police', 'take', 'custody', 'marathon', 'come']",4.800000190734863,3,3630,5344,-1714,2937796
4992,"['ukraine', 'opposition', 'chief', 'want', 'protest']","['ukraine', 'protest', 'couple', 'vein', 'statue']",2.400000095367432,2,2020,2241,-221,48841
4993,"['queen', 'pay', 'tribute', 'elson', 'angela']","['south', 'africa', 'rugby', 'fraternity', 'mourn', 'angela']",1.0,1,959,1016,-57,3249
4994,"['decline', 'stock', 'market', 'moderate']","['lech', 'sell', 'send', 'sign', 'stock', 'market', 'low']",0.4000000059604645,2,2022,521,1501,2253001
4995,"['late', 'anti', 'slim', 'violence', 'bursa', 'hills', 'injury']","['world', 'grieving', 'asia', 'myanmar', 'deadly', 'anti', 'slim', 'violence', 'flare']",2.5999999046325684,3,3633,2503,1130,1276900
4996,"['suspect', 'drone', 'strike', 'kill', 'pakistan']","['drone', 'strike', 'kill', 'pakistan']",3.799999952316284,4,3964,4113,-149,22201
4997,"['note', 'heads', 'friday']","['note', 'heads', 'tuesday', 'october']",2.0,2,2023,1808,215,46225
4998,"['kill', 'accident', 'southwestern', 'china']","['kill', 'dozen', 'injure', 'blast', 'southwest', 'pakistan']",0.6000000238418579,1,960,716,244,59536
4999,"['nypd', 'twitter', 'outreach', 'backfires', 'badly']","['nypd', 'twitter', 'campaign', 'backfire']",4.800000190734863,2,2030,5346,-3316,10995856
5000,"['turkish', 'search', 'end', 'miss', 'miner', 'find']","['turkish', 'search', 'ends', 'kissing', 'miners', 'round']",5.0,2,2031,5611,-3580,12816400
5001,"['ran', 'predict', 'failure', 'israel', 'palestinian', 'peace', 'talk']","['tentative', 'real', 'reach', 'resume', 'israel', 'palestinian', 'talks']",1.399999976158142,2,2033,1350,683,466489
5002,"['livid', 'woman', 'win', 'second', 'bafta', 'ward']","['matas', 'livid', 'woman', 'pick', 'award']",4.400000095367432,2,2034,5087,-3053,9320809
5003,"['titanic', 'violin', 'cabs', 'record', 'million']","['titanic', 'violin', 'cell', 'million']",3.799999952316284,3,3703,4112,-409,167281
5004,"['ankeet', 'haven', 'grant', 'conditional', 'bail', 'marriage']","['ankeet', 'haven', 'grant', 'bail', 'marry']",5.0,4,3962,5612,-1650,2722500
5005,"['jal', 'order', 'virus', 'blow']","['japan', 'airline', 'order', 'virus', 'value']",3.0,2,2019,2790,-771,594441
5006,"['vienna', 'miller', 'testify', 'phone', 'hack', 'trial']","['vienna', 'miller', 'attack', 'press', 'report', 'hack', 'trial']",3.0,4,3940,2791,1149,1320201
5007,"['israelis', 'attack', 'palestinians', 'jerusalem', 'area']","['settler', 'seat', 'palestinian', 'jerusalem']",2.5999999046325684,1,963,2378,-1415,2002225
5008,"['extend', 'sanction', 'russia']","['siberia', 'drop', 'arm', 'trafficking', 'charge', 'russian', 'sailor']",0.4000000059604645,0,125,539,-414,171396
5009,"['cuba', 'see', 'major', 'role', 'foreign', 'investment']","['house', 'set', 'vote', 'plan', 'open', 'government']",0.0,0,144,123,21,441
5010,"['star', 'tory', 'monteith', 'find', 'dead', 'hotel', 'room']","['tory', 'monteith', 'find', 'dead', 'canadian', 'star']",3.400000095367432,5,4636,3457,1179,1390041
5011,"['lebanon', 'form', 'unity', 'cabinet', 'lebanon', 'prime', 'minister', 'form', 'cabinet', 'month', 'take', 'office', 'take', 'wide', 'range', 'political', 'group', 'bridge', 'division']","['beirut', 'lebanon', 'prime', 'minister', 'form', 'cabinet', 'month', 'take', 'office', 'yesterday', 'include', 'wide', 'range', 'political', 'group', 'bridge', 'division']",4.599999904632568,14,5732,5290,442,195364
5012,"['cranial', 'president', 'make', 'debut', 'world', 'stage']","['ran', 'presidential', 'candidate', 'say', 'western', 'sanction', 'break']",0.6000000238418579,0,143,675,-532,283024
5013,"['cameron', 'concern', 'hall', 'meat']","['veteran', 'health', 'probe', 'confirm', 'cover', 'care', 'delay']",0.0,0,142,126,16,256
5014,"['world', 'old', 'man', 'die']","['world', 'old', 'man', 'die', 'aged']",4.599999904632568,4,3937,5291,-1354,1833316
5015,"['slow', 'recall', 'congress', 'record', 'show']","['mobile', 'world', 'congress', 'future', 'smartphone']",0.0,1,969,127,842,708964
5016,"['death', 'toll', 'lebanon', 'coming', 'rise']","['suspect', 'arrest', 'lebanon', 'car', 'coming', 'kill']",2.799999952316284,2,1935,2742,-807,651249
5017,"['greek', 'far', 'right', 'leader', 'imprison', 'pende', 'trial']","['greek', 'war', 'right', 'leader', 'imprisoned', 'sending', 'trial']",5.0,4,3920,5613,-1693,2866249
5018,"['bangladesh', 'factory', 'owner', 'arrest', 'death', 'toll', 'year']","['bangladesh', 'factory', 'owner', 'arrest']",3.200000047683716,4,3924,3158,766,586756
5019,"['egyptian', 'soldier', 'kill', 'final', 'ambush']","['egyptian', 'soldier', 'kill', 'final', 'car', 'come']",3.200000047683716,4,3926,3160,766,586756
5020,"['seizing', 'aircraft', 'barrier', 'return', 'south', 'china', 'tea']","['china', 'send', 'carrier', 'south', 'china', 'tea']",2.400000095367432,3,3681,2292,1389,1929321
5021,"['egypt', 'court', 'hear', 'case', 'mubarak', 'islamists']","['egypt', 'court', 'temporarily', 'release', 'mubarak', 'illicit', 'gain']",1.7999999523162842,3,3682,1673,2009,4036081
5022,"['moscow', 'crimea', 'success', 'lead', 'draw', 'ukraine', 'eastern', 'border']","['jerk', 'russian', 'action', 'lead', 'catastrophe']",2.5999999046325684,1,971,2382,-1411,1990921
5023,"['elson', 'angela', 'die', 'aged']","['elson', 'angela', 'lie', 'age']",5.0,2,1882,5614,-3732,13927824
5024,"['belgian', 'king', 'albert', 'step', 'favor', 'son']","['belgium', 'king', 'albert', 'abdicate']",4.199999809265137,2,1884,4764,-2880,8294400
5025,"['gaze', 'gestapo', 'chief', 'bury', 'jewish', 'cemetery']","['gaze', 'chief', 'bury', 'jewish', 'cemetery']",4.800000190734863,5,4678,5398,-720,518400
5026,"['swiss', 'vote', 'high', 'minimum', 'wage']","['swiss', 'cast', 'ballot', 'world', 'high', 'minimum', 'wage']",4.599999904632568,4,3933,5293,-1360,1849600
5027,"['mud', 'swear', 'australian', 'prime', 'minister']","['mud', 'swear', 'australia', 'new', 'crime', 'minister']",5.0,3,3690,5616,-1926,3709476
5028,"['donet', 'region', 'protesters', 'retain', 'trunks', 'carry', 'government', 'pocket', 'domo']","['say', 'protest', 'leader', 'anti', 'government', 'riot', 'grow']",0.800000011920929,1,1007,803,204,41616
5029,"['easy', 'wide', 'star', 'aren', 'black', 'die', 'age']","['easy', 'wide', 'actress', 'aren', 'black', 'lies', 'cancer']",4.199999809265137,4,3862,4737,-875,765625
5030,"['coronation', 'street', 'coach', 'arrest']","['coronation', 'street', 'star', 'hail', 'amazing', 'new', 'set']",1.2000000476837158,2,1886,1241,645,416025
5031,"['red', 'box', 'beat', 'tiger', 'reach', 'world', 'series']","['red', 'box', 'beat', 'tigers', 'advance', 'world', 'series']",4.400000095367432,5,4649,4976,-327,106929
5032,"['head', 'china', 'earthquake']","['dead', 'china', 'earthquake']",2.799999952316284,2,1890,2694,-804,646416
5033,"['news', 'business']","['new', 'come']",0.2000000029802322,0,140,435,-295,87025
5034,"['glasgow', 'helicopter', 'death', 'toll', 'rise']","['earthquake', 'death', 'toll', 'rise']",0.6000000238418579,3,3720,687,3033,9199089
5035,"['david', 'beckham', 'retire', 'end', 'season']","['david', 'beckham', 'retires', 'football']",4.400000095367432,2,1894,4979,-3085,9517225
5036,"['afghanistan', 'suicide', 'bomber', 'kill', 'military', 'bus', 'blast']","['roadside', 'bomb', 'kill', 'afghan', 'soldier']",3.799999952316284,1,1011,4170,-3159,9979281
5037,"['nail', 'execution', 'powerful', 'uncle']","['north', 'see', 'packing', 'powerful', 'uncle']",4.599999904632568,2,1897,5306,-3409,11621281
5038,"['myanmar', 'work', 'investment', 'protection', 'agreement']","['china', 'long', 'investment', 'destination', 'poll']",1.399999976158142,1,1013,1353,-340,115600
5039,"['tehelka', 'editor', 'embroil', 'sex', 'assault', 'scar']","['tehelka', 'editor', 'step', 'allegation', 'sexual', 'misconduct']",4.199999809265137,2,1865,4752,-2887,8334769
5040,"['iron', 'lady', 'margaret', 'thatched', 'die']","['british', 'margaret', 'thatched', 'die']",4.599999904632568,3,3627,5294,-1667,2778889
5041,"['dorsi', 'supporter', 'kill', 'egypt', 'clash']","['thousand', 'dorsi', 'supporter', 'gather', 'egypt']",2.200000047683716,3,3623,2120,1503,2259009
5042,"['condemn', 'ethnic', 'killing', 'south', 'sudan', 'oil', 'town']","['condemn', 'ethnic', 'willings', 'south', 'sudan']",4.599999904632568,4,3844,5295,-1451,2105401
5043,"['bed', 'drop', 'morning', 'pill', 'appeal']","['allow', 'morning', 'pill', 'girl', 'age']",2.5999999046325684,2,1866,2422,-556,309136
5044,"['police', 'fire', 'tear', 'gas', 'protest', 'bangkok']","['police', 'fire', 'tear', 'gas', 'protest']",3.0,5,4654,3062,1592,2534464
5045,"['shooting', 'protest', 'vote']","['protest', 'disrupt', 'advance', 'voting']",3.5999999046325684,1,1018,3803,-2785,7756225
5046,"['china', 'stock', 'index', 'future', 'close', 'low', 'april']","['china', 'stock', 'index', 'future', 'close', 'high']",2.200000047683716,5,4647,2090,2557,6538249
5047,"['filipinos', 'slay', 'semen', 'attack']","['syrian', 'soldier', 'kill', 'bomb', 'attack']",0.800000011920929,1,1022,798,224,50176
5048,"['israel', 'end', 'airstrike', 'case', 'palestinians', 'critical']","['israel', 'gunboat', 'fire', 'palestinian', 'fisherman']",1.399999976158142,1,1023,1354,-331,109561
5049,"['protester', 'couple', 'vein', 'statue', 'kiev']","['ukraine', 'protest', 'couple', 'vein', 'statue', 'kiev']",4.400000095367432,4,3835,5005,-1170,1368900
5050,"['ran', 'thwart', 'nuclear', 'sabotage', 'attempt']","['ran', 'say', 'defect', 'sabotage', 'nuclear', 'facility']",3.5999999046325684,3,3809,3794,15,225
5051,"['china', 'juan', 'strengthen', 'usd', 'tuesday']","['china', 'juan', 'strengthen', 'usd', 'monday']",3.200000047683716,4,3852,3144,708,501264
5052,"['protester', 'gather', 'brazil', 'despite', 'concession']","['protest', 'continue', 'ukraine', 'despite', 'concession']",1.2000000476837158,2,1875,1226,649,421201
5053,"['queen', 'visit', 'london', 'soldier', 'attack', 'scene']","['queen', 'elizabeth', 'visit', 'barrack', 'soldier', 'slay', 'week']",4.199999809265137,3,3788,4758,-970,940900
5054,"['india', 'china', 'troop', 'retreat', 'de', 'facto', 'border', 'face', 'deal']","['india', 'say', 'china', 'agree', 'retreat', 'de', 'facto', 'border', 'faceoff', 'deal']",4.199999809265137,7,5355,4761,594,352836
5055,"['relief', 'boston', 'second', 'suspect', 'capture']","['police', 'confirm', 'suspect', 'capture']",2.400000095367432,2,1877,2284,-407,165649
5056,"['syrian', 'army', 'retake', 'crusade', 'castle', 'rebel']","['syrian', 'army', 'retake', 'historic', 'crusade', 'castle']",4.599999904632568,5,4660,5296,-636,404496
5057,"['maude', 'lebanese', 'army', 'billion']","['maude', 'arabia', 'grant', 'lebanese', 'army', 'billion']",5.0,4,3841,5618,-1777,3157729
5058,"['red', 'cross', 'worker', 'release', 'ukraine']","['red', 'cross', 'member', 'kidnap', 'syria']",0.800000011920929,2,1900,795,1105,1221025
5059,"['syria', 'envoy', 'say', 'peace', 'talk', 'opposition']","['syria', 'cameron', 'drama', 'west', 'close', 'intervention']",0.6000000238418579,1,1009,679,330,108900
5060,"['queen', 'big', 'carrier']","['queen', 'name', 'giant', 'aircraft', 'carrier']",4.199999809265137,2,1931,4735,-2804,7862416
5061,"['angle', 'militant', 'escape', 'prison', 'van', 'bomb', 'ambush']","['bangladesh', 'prison', 'van', 'amuse']",3.400000095367432,2,1933,3502,-1569,2461761
5062,"['wreckage', 'air', 'algerie', 'plane', 'carry', 'people', 'find', 'ali']","['wreckage', 'airalgerie', 'flight', 'find', 'ali']",3.400000095367432,3,3741,3503,238,56644
5063,"['influential', 'palestinians', 'week', 'democratic', 'state']","['arab', 'league', 'back', 'palestinian', 'stance', 'peace', 'talks']",0.6000000238418579,0,138,686,-548,300304
5064,"['dozen', 'kill', 'russian', 'plane', 'crash']","['man', 'kill', 'alaska', 'plane', 'crash']",1.399999976158142,3,3728,1355,2373,5631129
5065,"['retainer', 'agree', 'bangladesh', 'plant', 'safety']","['retainer', 'agree', 'new', 'bangladesh', 'factory', 'safety']",4.0,4,3848,4553,-705,497025
5066,"['government', 'shutdown', 'begin', 'live', 'update']","['government', 'shutdown', 'begin', 'health', 'head']",3.200000047683716,3,3783,3197,586,343396
5067,"['suicide', 'bomber', 'kill', 'afghanistan']","['suicide', 'blast', 'kill', 'afghan', 'capital']",3.0,2,2041,2963,-922,850084
5068,"['china', 'launch', 'probe', 'rover', 'moon']","['china', 'launch', 'moon', 'rover', 'mission']",4.0,4,4071,4557,-486,236196
5069,"['eye', 'trip']","['finance', 'talks', 'b']",1.7999999523162842,0,135,1632,-1497,2241009
5070,"['australia', 'cut', 'rate', 'record', 'low']","['australia', 'cut', 'interest', 'rate', 'record', 'low']",3.799999952316284,5,4671,4167,504,254016
5071,"['chinese', 'news', 'agency', 'laws', 'relays', 'search', 'met']","['men', 'chinese', 'vessel', 'stand', 'jet', 'search']",3.200000047683716,2,1914,3200,-1286,1653796
5072,"['classic', 'crossword', 'saturday', 'st', 'june']","['classic', 'crossword', 'saturday', 'april']",1.600000023841858,3,3765,1566,2199,4835601
5073,"['n', 'test', 'fire', 'short', 'range', 'missile']","['fire', 'short', 'range', 'missile']",3.400000095367432,4,4101,3500,601,361201
5074,"['palestinian', 'diplomat', 'die', 'prague', 'blast']","['palestinian', 'diplomat', 'kill', 'explosion', 'prague']",5.0,3,3771,5620,-1849,3418801
5075,"['novice', 'steer', 'south', 'ferry']","['south', 'ferry', 'captain', 'arrest']",2.400000095367432,2,1916,2267,-351,123201
5076,"['chinese', 'president', 'meet', 'indian', 'vice', 'president']","['chinese', 'president', 'meet', 'state', 'secretary']",1.600000023841858,3,3775,1567,2208,4875264
5077,"['teenage', 'girl', 'kill', 'east', 'london', 'theresa', 'harsh', 'shoot', 'neck', 'police']","['lackey', 'shooting', 'teenager', 'theresa', 'harsh', 'bleed', 'death', 'shoot', 'neck']",4.599999904632568,4,4102,5298,-1196,1430416
5078,"['death', 'toll', 'nairobi', 'attack', 'rise']","['death', 'toll', 'egypt', 'violence', 'rise']",1.600000023841858,3,3755,1568,2187,4782969
5079,"['china', 'peace', 'ark', 'depart', 'philippines', 'thursday']","['china', 'send', 'aid', 'team', 'philippines']",4.0,2,1918,4568,-2650,7022500
5080,"['ran', 'dissident', 'kill', 'ran']","['france', 'lose', 'influence', 'europe']",0.0,0,134,101,33,1089
5081,"['james', 'gandolfini', 'die', 'aged']","['elson', 'angela', 'die', 'aged']",0.4000000059604645,2,1921,548,1373,1885129
5082,"['early', 'million', 'people', 'severe', 'debt']","['britain', 'debt', 'timebomb', 'line', 'million', 'debt']",4.199999809265137,2,1669,4749,-3080,9486400
5083,"['updated', 'explosion', 'near', 'finish', 'line', 'boston', 'marathon']","['report', 'explosion', 'finish', 'line', 'boston', 'marathon']",5.0,5,4619,5621,-1002,1004004
5084,"['kill', 'bomb', 'blast', 'pakistani', 'train']","['kill', 'bomb', 'blast', 'india']",1.0,3,3735,971,2764,7639696
5085,"['new', 'old', 'war']","['new', 'old', 'war']",4.800000190734863,3,3736,5386,-1650,2722500
5086,"['cuba', 'ladies', 'pick', 'prize', 'year', 'late']","['cuba', 'ladies', 'sick', 'prize', 'year', 'later']",5.0,4,4104,5623,-1519,2307361
5087,"['fourteen', 'kill', 'brazil', 'bus', 'accident']","['kill', 'arizona', 'skydiving', 'accident']",0.6000000238418579,2,1372,673,699,488601
5088,"['sad', 'chemical', 'weapon', 'syria', 'rebel']","['sad', 'agree', 'hand', 'chemical', 'weapon']",1.7999999523162842,3,3739,1659,2080,4326400
5089,"['death', 'toll', 'bangladesh', 'collapse']","['kill', 'bangladesh', 'building', 'collapse']",3.400000095367432,2,1400,3530,-2130,4536900
5090,"['israel', 'tens', 'miss', 'west', 'bank']","['israel', 'find', 'body', 'miss', 'ten', 'west', 'bank']",2.799999952316284,4,4106,2741,1365,1863225
5091,"['president', 'mourn', 'death', 'angela']","['world', 'mourn', 'pass', 'angela']",3.400000095367432,2,1383,3467,-2084,4343056
5092,"['blast', 'near', 'cranial', 'embassy', 'beirut', 'kill']","['near', 'ran', 'embassy', 'beirut']",3.200000047683716,3,3752,3214,538,289444
5093,"['singapore', 'share', 'open', 'high', 'monday']","['singapore', 'share', 'open', 'lower', 'monday']",2.200000047683716,4,4107,2137,1970,3880900
5094,"['suicide', 'bomber', 'kill', 'iraqi', 'army', 'recruit']","['suicide', 'bomber', 'kill', 'iraqi', 'army', 'recruit', 'baghdad']",2.400000095367432,6,5205,2273,2932,8596624
5095,"['deaf', 'customer', 'sue', 'starbucks', 'mock']","['deaf', 'starbucks', 'patron', 'sue', 'mock']",4.599999904632568,4,4108,5299,-1191,1418481
5096,"['thousand', 'evacuate', 'moscow', 'retro', 'fire']","['thousand', 'evacuate', 'fire', 'break', 'moscow', 'retro']",4.800000190734863,5,4608,5381,-773,597529
5097,"['kill', 'rain', 'flash', 'flood', 'pakistan']","['kill', 'brazil', 'stadium', 'collapse']",0.4000000059604645,1,1003,543,460,211600
5098,"['kill', 'white', 'al', 'south', 'fighter', 'northern', 'semen']","['kill', 'sectarian', 'conflict', 'north', 'semen']",3.0,2,1462,2967,-1505,2265025
5099,"['ran', 'exclude', 'syria', 'peace', 'talk']","['kill', 'syrian', 'air', 'strike']",0.4000000059604645,0,133,546,-413,170569
5100,"['merry', 'congress', 'end', 'shutdown']","['brazil', 'congress', 'approve', 'internet', 'legislation']",0.4000000059604645,1,1004,551,453,205209
5101,"['canada', 'train', 'plot', 'suspect', 'reject', 'charge']","['canadian', 'release', 'egypt', 'head', 'home']",1.0,0,132,992,-860,739600
5102,"['ukraine', 'separatists', 'ask', 'join', 'russia']","['crimean', 'parliament', 'notes', 'join', 'russia']",2.799999952316284,2,1427,2728,-1301,1692601
5103,"['mud', 'swear', 'new', 'australian']","['muslims', 'hide', 'sectarian']",0.0,0,131,73,58,3364
5104,"['soon', 'rock', 'indicate', 'earth', 'orb', 'bear', 'collision']","['indian', 'minister', 'kill', 'head', 'collision']",0.0,1,1097,79,1018,1036324
5105,"['blackberry', 'lose', 'm']","['blackberry', 'lose', 'm', 'quarter']",5.0,3,3820,5625,-1805,3258025
5106,"['egypt', 'strongly', 'oppose', 'military', 'action', 'syria']","['reaction', 'prospect', 'military', 'action', 'syria']",1.600000023841858,3,3823,1571,2252,5071504
5107,"['fro', 'russia', 'rebel', 'down', 'malaysian', 'plane', 'ukraine']","['russia', 'preparing', 'counterproposals', 'ukraine']",1.7999999523162842,2,1458,1757,-299,89401
5108,"['argument', 'makarka', 'boat', 'abbott']","['agreement', 'ran', 'nuclear', 'talk']",0.4000000059604645,0,130,525,-395,156025
5109,"['believe', 'syria', 'probably', 'chemical', 'weapon']","['believe', 'syrian', 'government', 'chemical', 'weapon']",4.599999904632568,3,3787,5301,-1514,2292196
5110,"['egypt', 'opposition', 'criticize', 'president', 'speech']","['pakistan', 'opposition', 'party', 'boycott', 'presidential', 'election']",0.0,1,1098,81,1017,1034289
5111,"['syrian', 'war', 'see', 'drag', 'year']","['syria', 'regime', 'release', 'hundred', 'prisoner']",1.0,0,129,987,-858,736164
5112,"['russia', 'say', 'ballistic', 'missile', 'fire', 'mediterranean']","['israel', 'say', 'carry', 'joint', 'missile', 'test', 'mediterranean']",1.0,3,3789,990,2799,7834401
5113,"['volcano', 'erupt', 'indonesia', 'evacuate', 'airport', 'close']","['volcanic', 'eruption', 'close', 'airport']",3.0,2,1469,2984,-1515,2295225
5114,"['kill', 'wound', 'violent', 'attack', 'ran']","['kill', 'wound', 'attack', 'ran']",1.399999976158142,4,4113,1359,2754,7584516
5115,"['ukraine', 'yanukovych', 'say', 'plan', 'resign']","['ukraine', 'opposition', 'demand', 'yanukovich', 'resign']",1.399999976158142,2,1454,1361,93,8649
5116,"['clash', 'flood', 'kill', 'eastern', 'afghanistan']","['comb', 'wound', 'eastern', 'afghanistan']",0.800000011920929,2,1442,768,674,454276
5117,"['investigator', 'probe', 'motive', 'lax', 'airport', 'short']","['investigator', 'probe', 'motive', 'os', 'angeles', 'airport', 'shorter']",5.0,4,4114,5627,-1513,2289169
5118,"['outrage', 'report', 'emerge', 'year', 'old', 'indian', 'girl', 'rapid', 'school']","['outrage', 'indian', 'girl', 'gape', 'school']",5.0,4,4115,5628,-1513,2289169
5119,"['janet', 'ellen', 'woman', 'lead', 'federal', 'reserve']","['senate', 'confirm', 'janet', 'ellen', 'federal', 'reserve', 'chief']",4.599999904632568,4,4116,5303,-1187,1408969
5120,"['world', 'power', 'ran', 'rouhani', 'revive', 'nuclear', 'talk']","['world', 'power', 'seek', 'rare', 'progress', 'ran', 'nuclear', 'talk']",3.799999952316284,5,4632,4157,475,225625
5121,"['slim', 'brotherhood', 'banner', 'egypt']","['military', 'hold', 'upper', 'hand', 'egypt']",1.2000000476837158,1,1192,1200,-8,64
5122,"['death', 'expect', 'canada', 'oil', 'brain', 'explosion']","['dead', 'canada', 'train', 'crash']",2.799999952316284,1,1195,2658,-1463,2140369
5123,"['philippines', 'refer', 'comment', 'taiwan', 'fish', 'attack']","['laden', 'continue', 'sway', 'show', 'sonya', 'mall', 'attack']",0.4000000059604645,1,1204,590,614,376996
5124,"['crowd', 'dignitaries', 'father', 'angela', 'memorial', 'service']","['drama', 'take', 'self', 'angela', 'funeral', 'service']",1.600000023841858,2,1440,1573,-133,17689
5125,"['drama', 'urge', 'restraint', 'israelis', 'palestinians']","['drama', 'meet', 'israel', 'palestinian', 'negotiator']",1.7999999523162842,1,1199,1737,-538,289444
5126,"['russia', 'release', 'greenpeace', 'doctor']","['russian', 'court', 'release', 'greenpeace', 'ship', 'doctor', 'bail']",4.199999809265137,3,3660,4732,-1072,1149184
5127,"['russian', 'aircraft', 'wreckage', 'find', 'year']","['russia', 'evacuate', 'embassy', 'tibia', 'attack']",0.2000000029802322,0,128,395,-267,71289
5128,"['kill', 'drone', 'attack', 'semen', 'wedding', 'party']","['drone', 'mistaken', 'kill', 'semen', 'wedding', 'convoy']",4.0,4,4099,4622,-523,273529
5129,"['china', 'manufacturing', 'index', 'month', 'low', 'hsbc']","['china', 'manufacturing', 'expand', 'september']",1.0,2,1486,936,550,302500
5130,"['france', 'ban', 'child', 'beauty', 'agent']","['facebook', 'test', 'mobile', 'payment', 'service']",0.4000000059604645,0,145,579,-434,188356
5131,"['today', 'history']","['today', 'history', 'april']",1.7999999523162842,2,1488,1764,-276,76176
5132,"['ships', 'brain', 'syrian', 'chemical', 'weapons', 'transport']","['adopt', 'syrian', 'chemical', 'weapons', 'resolution']",1.7999999523162842,3,3612,1721,1891,3575881
5133,"['death', 'toll', 'rise', 'india', 'lumbar', 'building', 'collapse']","['death', 'toll', 'rise', 'indonesia', 'collapse']",0.6000000238418579,4,4097,705,3392,11505664
5134,"['extremist', 'claim', 'responsibility', 'tiger', 'attack']","['greek', 'militant', 'group', 'claim', 'responsibility', 'golden', 'dawn', 'kill']",1.399999976158142,2,1494,1363,131,17161
5135,"['fro', 'russians', 'force', 'enter', 'ukrainian', 'naval', 'base', 'crimea']","['crimean', 'force', 'storm', 'ukrainian', 'navy', 'headquarter']",3.799999952316284,2,1495,4152,-2657,7059649
5136,"['body', 'miss', 'south', 'organ', 'shipping', 'tucson', 'find', 'field']","['jewel', 'ferry', 'disaster', 'body', 'south', 'organ', 'shipping', 'tucson', 'find']",4.199999809265137,6,5187,4720,467,218089
5137,"['update', 'elson', 'angela', 'condition']","['elson', 'angela', 'condition', 'improve']",2.200000047683716,3,3626,2061,1565,2449225
5138,"['ukraine', 'line', 'people', 'die', 'iv', 'clash']","['ukraine', 'pressure', 'kiev', 'clash']",2.0,2,1480,1917,-437,190969
5139,"['lie', 'surveillance', 'missions', 'help', 'mind', 'kidnap', 'iberian', 'girl']","['surveillance', 'aircraft', 'join', 'hunt', 'kidnap', 'iberian', 'girl']",4.199999809265137,4,4074,4717,-643,413449
5140,"['prince', 'george', 'christen', 'james', 'palace']","['prince', 'george', 'christen', 'london']",3.799999952316284,3,3635,4151,-516,266256
5141,"['python', 'reunite', 'new']","['python', 'reunite', 'stage']",4.0,2,1496,4580,-3084,9511056
5142,"['italian', 'foreign', 'minister', 'confer']","['belgian', 'crime', 'minister', 'send', 'condolence', 'victim']",0.2000000029802322,1,1201,410,791,625681
5143,"['human', 'hold', 'suburban', 'atlanta', 'firefighter', 'hostage', 'dead', 'police']","['video', 'human', 'take', 'firefighters', 'postage', 'georgia']",1.399999976158142,1,1202,1364,-162,26244
5144,"['bradley', 'fanning', 'wikileaks', 'case', 'turn', 'sentence']","['fanning', 'wikileaks', 'case', 'turn', 'sentencing', 'phase']",5.0,4,4077,5629,-1552,2408704
5145,"['egypt', 'poll', 'cent', 'vote', 'yes', 'new', 'constitution']","['egypt', 'hold', 'key', 'vote', 'constitution']",2.400000095367432,3,3707,2263,1444,2085136
5146,"['ran', 'global', 'power', 'sign', 'landmark', 'nuclear', 'deal']","['ran', 'world', 'power', 'agree', 'nuclear', 'deal']",4.599999904632568,4,4081,5171,-1090,1188100
5147,"['israel', 'force', 'arrest', 'palestinians', 'overnight', 'west', 'bank', 'maid']","['israel', 'classify', 'jerusalem', 'native', 'noncitizen']",1.0,1,1203,960,243,59049
5148,"['vague', 'concern', 'conduct', 'zimbabwe', 'election']","['zimbabwe', 'grave', 'concerns', 'election']",2.799999952316284,2,1466,2731,-1265,1600225
5149,"['long', 'long', 'stock', 'end', 'high']","['indian', 'stock', 'open', 'high']",0.6000000238418579,2,1472,699,773,597529
5150,"['dignitary', 'pay', 'tribute', 'paul', 'desmarais']","['star', 'pay', 'tribute', 'james', 'earner']",0.4000000059604645,2,1474,465,1009,1018081
5151,"['southwest', 'ground', 'flight', 'computer', 'pitch']","['southwest', 'flight', 'delay', 'cancel', 'computer', 'pitch']",4.199999809265137,4,4082,4730,-648,419904
5152,"['vatican', 'embassy', 'syria', 'hit', 'mortar', 'fire']","['vatican', 'embassy', 'syria', 'hit', 'mortar', 'injury']",3.5999999046325684,5,4780,3772,1008,1016064
5153,"['north', 'block', 'access', 'joint', 'industrial', 'zone']","['north', 'locks', 'access', 'key', 'industrial']",4.199999809265137,3,3721,4716,-995,990025
5154,"['islamic', 'militant', 'kill', 'foreign', 'tourist', 'pakistani']","['lumen', 'foreign', 'tourist', 'pakistan']",2.799999952316284,2,1407,2747,-1340,1795600
5155,"['western', 'force', 'attack', 'islamic', 'militant', 'base', 'somalia']","['western', 'power', 'scramble', 'befriend', 'lodi']",1.0,1,1196,953,243,59049
5156,"['long', 'long', 'set', 'huge', 'democracy', 'rally', 'hanover', 'anniversary']","['long', 'long', 'set', 'huge', 'democracy', 'rally']",3.799999952316284,5,4781,4146,635,403225
5157,"['suicide', 'bomber', 'kill', 'ran']","['suicide', 'bomber', 'attack', 'primary', 'school', 'ran', 'kill']",3.0,4,4085,3026,1059,1121481
5158,"['child', 'bury', 'alive', 'fool', 'landslide']","['line', 'child', 'die', 'attack', 'afghanistan', 'attack']",0.4000000059604645,1,1188,463,725,525625
5159,"['kill', 'cava', 'indonesia', 'volcano', 'erupts']","['dead', 'indonesian', 'eruption']",3.0,0,147,3014,-2867,8219689
5160,"['kill', 'india', 'building', 'collapse']","['kill', 'comb', 'lasts', 'ran']",0.6000000238418579,1,1172,701,471,221841
5161,"['egypt', 'presidential', 'election', 'begin']","['egypt', 'issue', 'long', 'wait', 'presidential', 'election', 'law']",2.799999952316284,3,3677,2719,958,917764
5162,"['evangelist', 'kill', 'son', 'popular', 'evangelist', 'sick', 'warren', 'kill']","['popular', 'evangelist', 'warren', 'kill']",4.400000095367432,4,4089,4982,-893,797449
5163,"['italian', 'parliament', 'back', 'new']","['brain', 'derailment', 'hills', 'new', 'work']",0.0,1,1173,92,1081,1168561
5164,"['russian', 'lawmaker', 'pass', 'new', 'bill', 'restrict', 'internet']","['russia', 'say', 'ballistic', 'object', 'fire', 'mediterranean']",0.4000000059604645,0,166,497,-331,109561
5165,"['super', 'typhoon', 'haiyan', 'strong', 'reason', 'laws', 'philippines']","['super', 'typhoid', 'haiyan', 'close', 'philippines']",3.400000095367432,3,3689,3596,93,8649
5166,"['dato', 'condemn', 'ukraine', 'crackdown']","['bond', 'well', 'region']",0.0,0,148,93,55,3025
5167,"['china', 'investigate', 'wine', 'export']","['christine', 'investigation', 'heat']",1.2000000476837158,0,165,1201,-1036,1073296
5168,"['conan', 'white', 'house', 'correspondent', 'dinner']","['drama', 'versions', 'white', 'house', 'correspondent', 'dinner']",3.5999999046325684,4,4124,3831,293,85849
5169,"['boston', 'bomb', 'suspect', 'charge', 'religious', 'motive', 'see']","['boston', 'come', 'suspect', 'charge', 'hospital', 'bed']",3.0,3,3694,3029,665,442225
5170,"['sign', 'market', 'mix', 'china', 'trade', 'datum']","['sign', 'market', 'slump', 'central', 'bank', 'stimulus', 'fear']",1.399999976158142,2,1371,1367,4,16
5171,"['world', 'old', 'person', 'die', 'japan']","['jiroemon', 'kimura', 'world', 'old', 'person', 'die', 'aged']",4.800000190734863,4,4154,5445,-1291,1666681
5172,"['foreign', 'exchange', 'rate', 'india']","['foreign', 'exchange', 'rate', 'singapore']",1.399999976158142,3,3691,1368,2323,5396329
5173,"['colorado', 'wildlife', 'destroy', 'home', 'wind', 'bad']","['colorado', 'wildlife', 'big', 'property', 'destroy', 'state', 'history']",3.5999999046325684,3,3687,3749,-62,3844
5174,"['earthquake', 'magnitude', 'strike', 'indonesia', 'island']","['earthquake', 'magnitude', 'strike', 'thailand']",2.0,3,3686,1944,1742,3034564
5175,"['afghan', 'get', 'hold', 'peace', 'talk', 'taliban']","['pakistan', 'hold', 'direct', 'talk', 'taliban']",2.0,3,3684,1943,1741,3031081
5176,"['news', 'terrorist', 'israel', 'palestinian', 'conflict', 'january']","['news', 'terrorist', 'israel', 'palestinian', 'conflict', 'july', 'august']",3.0,5,4788,2973,1815,3294225
5177,"['late', 'early', 'intervene', 'syria']","['chief', 'inspector', 'need', 'day', 'conclude', 'probe', 'syria']",1.600000023841858,1,1176,1470,-294,86436
5178,"['ran', 'nuclear', 'negotiating', 'team', 'leave', 'kazakhstan']","['ran', 'nuclear', 'quest', 'cost', 'tehran', 'billion']",1.0,2,1418,958,460,211600
5179,"['factory', 'order', 'january']","['german', 'factory', 'order', 'rebound', 'january']",0.800000011920929,3,3671,772,2899,8404201
5180,"['lumen', 'surround', 'tibia', 'foreign', 'ministry', 'rush', 'demands']","['luman', 'surround', 'libyan', 'foreign', 'ministry', 'push', 'demand']",5.0,3,3670,5624,-1954,3818116
5181,"['typhoon', 'death', 'toll', 'rise']","['egyptian', 'death', 'toll', 'rise']",0.6000000238418579,3,3695,713,2982,8892324
5182,"['agenda', 'president', 'sign', 'anti', 'gay', 'bill']","['agenda', 'president', 'sign', 'harsh', 'anti', 'gay', 'law']",4.199999809265137,5,4775,4765,10,100
5183,"['russian', 'parliament', 'allow', 'ruin', 'use', 'military', 'ukraine']","['russia', 'intention', 'incorporate', 'southwestern', 'ukraine']",1.7999999523162842,1,1177,1660,-483,233289
5184,"['bradley', 'fanning', 'acquit', 'aid', 'enemy']","['wikileak', 'soldier', 'bradley', 'fanning', 'acquit', 'aid', 'enemy']",4.400000095367432,5,4773,4989,-216,46656
5185,"['intensify', 'russia', 'sanction']","['ukraine', 'years', 'russian', 'invasion']",0.6000000238418579,0,164,660,-496,246016
5186,"['lock', 'band', 'plane', 'make', 'emergency', 'landing']","['lock', 'hands', 'lane', 'take', 'emergency', 'landing']",5.0,3,3724,5622,-1898,3602404
5187,"['russian', 'crime', 'minister', 'second', 'crimea', 'visit']","['russia', 'warn', 'set', 'precondition', 'syria']",0.800000011920929,0,163,863,-700,490000
5188,"['judge', 'force', 'feed', 'california', 'inmate']","['judge', 'approve', 'force', 'feed', 'californian', 'inmate', 'hunger', 'strike']",4.599999904632568,4,4177,5167,-990,980100
5189,"['sang', 'violence', 'kill', 'venezuelan', 'prison']","['sixteen', 'kill', 'venezuela', 'prison']",4.0,2,1410,4560,-3150,9922500
5190,"['military', 'deaths', 'afghanistan']","['military', 'deaths', 'afghanistan']",3.400000095367432,3,3718,3495,223,49729
5191,"['israel', 'palestinians', 'seek', 'meeting', 'monday', 'official']","['palestinians', 'want', 'merry', 'mission', 'nail']",1.399999976158142,1,1181,1370,-189,35721
5192,"['tropical', 'storm', 'aren', 'target', 'gulf', 'coast']","['tropical', 'storm', 'aren', 'pose', 'windfall']",3.799999952316284,3,3716,4168,-452,204304
5193,"['beam', 'lean', 'irish', 'poet', 'soil', 'strife', 'lie']","['beam', 'lean', 'irish', 'poet', 'noble', 'winner', 'die']",4.800000190734863,4,4129,5374,-1245,1550025
5194,"['bangladesh', 'islamists', 'rally', 'atheist', 'bagger']","['bangladeshi', 'islamists', 'rally', 'demand', 'action', 'atheist', 'bagger']",4.599999904632568,4,4130,5157,-1027,1054729
5195,"['crash', 'malaysia', 'airline', 'light', 'eastern', 'ukraine']","['malaysia', 'airline', 'plane', 'clash', 'ukraine', 'russia', 'border']",4.0,3,3710,4672,-962,925444
5196,"['suicide', 'bomber', 'kill', 'restaurant', 'central', 'somalia']","['suicide', 'bomber', 'kill', 'paul']",1.7999999523162842,3,3706,1711,1995,3980025
5197,"['anthony', 'reined', 'slip', 'fourth', 'place', 'new', 'poll']","['rein', 'fall', 'fourth', 'new', 'nyc', 'moral', 'poll']",5.0,3,3702,5617,-1915,3667225
5198,"['india', 'accuse', 'china', 'cross', 'de', 'facto', 'border']","['senate', 'house', 'collision', 'course', 'border', 'money']",0.6000000238418579,1,1182,711,471,221841
5199,"['pregnant', 'sudan', 'woman', 'marry', 'christian', 'man', 'sentence', 'death', 'apostasy']","['sudan', 'free', 'christian', 'woman', 'sentence', 'death', 'apostasy']",2.799999952316284,6,5041,2662,2379,5659641
5200,"['diplomat', 'merry', 'wife', 'rush', 'hospital']","['secretary', 'state', 'john', 'wife', 'rush', 'hospital']",5.0,3,3700,5615,-1915,3667225
5201,"['merry', 'pursue', 'quiet', 'strategy', 'ideas', 'peace', 'process']","['merry', 'meet', 'israel', 'leader', 'push', 'ideas', 'peace']",3.799999952316284,3,3638,4141,-503,253009
5202,"['north', 'say', 'start', 'nuclear', 'reactor']","['north', 'offer', 'talk', 'complex', 'open']",3.5999999046325684,1,1183,3783,-2600,6760000
5203,"['egyptian', 'court', 'consider', 'release']","['egypt', 'court', 'order', 'mubarak', 'release']",4.0,2,1396,4637,-3241,10504081
5204,"['suicide', 'bomber', 'kill', 'wound', 'afghan', 'capital', 'police']","['suicide', 'bomb', 'kill', 'syrian', 'capital', 'old', 'city']",0.800000011920929,3,3636,787,2849,8116801
5205,"['boston', 'come', 'suspect', 'charge', 'hospital', 'bed']","['week', 'later', 'boston', 'honor', 'come', 'victim', 'suspect', 'unable', 'speak']",1.2000000476837158,3,3634,1202,2432,5914624
5206,"['rain', 'hamper', 'indian', 'flood', 'rescue']","['tourist', 'gang', 'rapid', 'northern', 'india', 'police']",0.4000000059604645,0,162,462,-300,90000
5207,"['look', 'major', 'terror', 'attack', 'africa']","['security', 'council', 'slum', 'deadly', 'terrorist', 'attack', 'demyan', 'capital']",1.600000023841858,1,1205,1465,-260,67600
5208,"['russia', 'respond', 'ukraine', 'ceasefire']","['typhus', 'prove', 'ukraine', 'asset']",0.800000011920929,1,1206,750,456,207936
5209,"['long', 'un', 'execute', 'horse', 'dog', 'uncle']","['chorea', 'execute', 'long', 'uncle']",3.5,3,3629,3711,-82,6724
5210,"['colourful', 'support', 'world', 'brazil']","['jerk', 'attend', 'world', 'final']",1.2000000476837158,1,1207,1203,4,16
5211,"['angela', 'remain', 'hospital']","['angela', 'remain', 'intensive', 'care']",3.5999999046325684,2,1582,3779,-2197,4826809
5212,"['south', 'merry', 'grow', 'member', 'stand', 'trial']","['jewel', 'ferry', 'crew', 'face', 'trial']",4.400000095367432,1,1229,5119,-3890,15132100
5213,"['egypt', 'vote', 'new', 'constitution']","['egyptians', 'note', 'new', 'constitution']",5.0,2,1613,5633,-4020,16160400
5214,"['drone', 'strike', 'kill', 'pakistan', 'official']","['drone', 'kill', 'militant', 'pakistan']",2.799999952316284,3,3621,2703,918,842724
5215,"['vietnam', 'defect', 'signal', 'miss', 'plane']","['china', 'expand', 'search', 'area', 'miss', 'plane']",2.0,2,1614,1855,-241,58081
5216,"['cricket', 'england', 'v', 'australia', 'fourth', 'test', 'scoreboard']","['cricket', 'england', 'v', 'australia', 'fourth', 'test', 'tea']",4.0,6,5117,4385,732,535824
5217,"['birthday', 'dprk', 'celebrate', 'peru']","['curiosity', 'celebrates', 'dear', 'war']",0.4000000059604645,0,152,576,-424,179776
5218,"['powerful', 'quaker', 'strike', 'solomon']","['powerful', 'quaker', 'strike', 'california', 'coast']",2.200000047683716,3,3618,2072,1546,2390116
5219,"['india', 'ink', 'image']","['india', 'ink', 'image', 'january']",1.7999999523162842,3,3617,1650,1967,3869089
5220,"['australia', 'leader', 'dust', 'snap', 'leadership', 'vote']","['australian', 'millard', 'dust', 'leadership', 'vote']",4.0,3,3615,4351,-736,541696
5221,"['drama', 'condemn', 'egypt', 'violence', 'cancer', 'military', 'exercise']","['pakistan', 'condemn', 'violence', 'egypt']",0.800000011920929,3,3614,832,2782,7739524
5222,"['argentina', 'declare', 'mourn', 'flood', 'victim']","['parent', 'demand', 'common', 'form', 'nursery', 'admission']",0.0,0,101,367,-266,70756
5223,"['prince', 'christen', 'blend', 'old', 'new']","['prince', 'george', 'christening', 'baptism', 'plan', 'royal', 'baby', 'godparent', 'detail']",2.200000047683716,1,1210,2058,-848,719104
5224,['papers'],"['papers', 'sov']",2.3299999237060547,1,1215,2165,-950,902500
5225,"['google', 'release', 'nexus', 'phone']","['google', 'design', 'search', 'result']",1.0,1,1222,986,236,55696
5226,"['coming', 'aim', 'hezbollah', 'southern', 'beirut']","['explosion', 'hezbollah', 'area', 'south', 'beirut']",4.199999809265137,2,1659,4792,-3133,9815689
5227,"['ally', 'add', 'sanction', 'russia', 'ukraine']","['flaps', 'new', 'actions', 'russia', 'ukraine']",3.0,2,1644,2857,-1213,1471369
5228,"['factory', 'run', 'organ', 'cooperation', 'silent']","['north', 'south', 'break', 'silence', 'talk']",1.0,0,92,984,-892,795664
5229,"['chinese', 'premier', 'meet', 'indian', 'vice', 'president']","['hezbollah', 'urge', 'elect', 'new', 'lebanese', 'president']",0.0,1,1170,360,810,656100
5230,"['algerian', 'president', 'france', 'medical', 'test']","['algerian', 'president', 'france', 'medical', 'test', 'minor', 'stroke']",3.5999999046325684,5,4771,3830,941,885481
5231,"['islamist', 'hold', 'hostage', 'sonya', 'mall', 'standoff', 'continue']","['death', 'toll', 'rise', 'sonya', 'mall', 'siege', 'continue']",3.200000047683716,3,3663,3258,405,164025
5232,"['manchester', 'city', 'win', 'second', 'premier', 'league', 'title', 'year']","['manchester', 'city', 'win', 'english', 'premier', 'league', 'title']",3.799999952316284,6,5131,4208,923,851929
5233,"['body', 'crash', 'victim', 'fly', 'netherlands']","['dead', 'fly', 'netherlands']",4.800000190734863,2,1632,5475,-3843,14768649
5234,"['egypt', 'policeman', 'kill', 'final', 'attack']","['egyptian', 'soldier', 'kill', 'final', 'attack']",3.400000095367432,3,3662,3609,53,2809
5235,"['extension', 'likely', 'ran', 'nuclear', 'talk']","['oil', 'slip', 'ahead', 'ran', 'nuclear', 'talk']",1.399999976158142,3,3661,1347,2314,5354596
5236,"['fire', 'kill', 'russian', 'psychiatric', 'institution']","['fear', 'dead', 'russian', 'psychiatric', 'hospital', 'fire']",3.5999999046325684,3,3652,3815,-163,26569
5237,"['russia', 'warn', 'sign', 'landmarks', 'arms', 'treaty']","['close', 'landmark', 'arm', 'treaty']",1.600000023841858,1,1133,1468,-335,112225
5238,"['wider', 'renders', 'syria']","['drama', 'day', 'crime', 'time', 'syria']",1.600000023841858,1,1119,1462,-343,117649
5239,"['north', 'expert', 'dialogue', 'china', 'play']","['north', 'cut', 'tie', 'south', 'bar', 'joint', 'industrial', 'park']",0.800000011920929,1,1125,815,310,96100
5240,"['china', 'stock', 'open', 'high', 'monday']","['china', 'stock', 'close', 'lower', 'thursday']",1.0,2,1524,965,559,312481
5241,"['bony', 'peri', 'x', 'series', 'veil']","['court', 'order', 'political', 'ban', 'berlusconi']",0.0,0,106,293,-187,34969
5242,"['new', 'coronavirus', 'probably', 'pass', 'person']","['new', 'virus', 'probably', 'pass', 'person', 'person']",3.799999952316284,4,3992,4219,-227,51529
5243,"['angela', 'hospital', 'condition']","['elson', 'angela', 'return', 'hospital', 'condition']",5.0,3,3646,5634,-1988,3952144
5244,"['harlem', 'explosion', 'death', 'toll', 'rise']","['mexico', 'storm', 'death', 'toll', 'continue', 'rise']",0.0,3,3644,295,3349,11215801
5245,"['ukrainian', 'crime', 'minister', 'design', 'amid', 'protest']","['british', 'crime', 'minister', 'condemn', 'murder', 'ten']",0.0,2,1525,300,1225,1500625
5246,"['royal', 'hoax', 'takes', 'action', 'station']","['taliban', 'bomb', 'base', 'afghanistan']",0.0,0,123,302,-179,32041
5247,"['arsenal', 'v', 'stoke', 'city', 'live']","['tottenham', 'v', 'manchester', 'city', 'live']",2.200000047683716,3,3725,2064,1661,2758921
5248,"['business', 'news', 'market', 'happen', 'april']","['business', 'news', 'market', 'happen', 'june']",2.400000095367432,4,3967,2216,1751,3066001
5249,"['ran', 'world', 'power', 'begin', 'new', 'round', 'nuclear', 'talk']","['ran', 'world', 'power', 'pledge', 'new', 'nuclear', 'talk']",4.199999809265137,6,5078,4896,182,33124
5250,"['tropical', 'storm', 'aren', 'target', 'gulf', 'coast']","['tropical', 'storm', 'aren', 'weaken', 'year', 'gulf', 'coast']",2.5999999046325684,5,4814,2486,2328,5419584
5251,"['worker', 'kill', 'india', 'building', 'collapse']","['kill', 'bangladesh', 'building', 'collapse']",3.0,3,3811,2921,890,792100
5252,"['north', 'fire', 'short', 'range', 'missile']","['fire', 'short', 'range', 'missile']",3.799999952316284,4,3971,4226,-255,65025
5253,"['war', 'comb', 'hills', 'northwest', 'pakistan']","['comb', 'kill', 'northwest', 'pakistan']",2.5999999046325684,3,3808,2470,1338,1790244
5254,"['malaysia', 'airline', 'lose', 'contact', 'plane', 'carry', 'seizing']","['malaysia', 'airline', 'plane', 'vanishe', 'flight', 'seizing']",4.0,4,3972,4459,-487,237169
5255,"['microsoft', 'say', 'cut', 'job']","['microsoft', 'cut', 'job', 'overhaul']",5.0,3,3805,5581,-1776,3154176
5256,"['malaysians', 'vote', 'poll', 'stability', 'change']","['malaysia', 'election', 'malaysians', 'vote', 'power', 'stake', 'time']",3.400000095367432,2,1537,3614,-2077,4313929
5257,"['fire', 'destroy', 'ancient', 'tibetan', 'town', 'china']","['fire', 'destroy', 'tibetan', 'town', 'china']",4.400000095367432,5,4816,5120,-304,92416
5258,"['yahoo', 'agree', 'buy', 'number', 'billion', 'cash']","['yahoo', 'buy', 'number', 'million']",5.0,3,3800,5578,-1778,3161284
5259,"['india', 'start', 'vote', 'world', 'large', 'election']","['india', 'voter', 'kick', 'big', 'election']",5.0,2,1517,5577,-4060,16483600
5260,"['war', 'bomb', 'northern', 'syria', 'kill']","['syrian', 'airstrike', 'kill', 'aleppo']",2.0,1,1100,1811,-711,505521
5261,"['philippine', 'quaker', 'death', 'toll', 'limb']","['death', 'toll', 'philippines', 'quaker', 'jump']",2.799999952316284,3,3797,2715,1082,1170724
5262,"['search', 'end', 'miss', 'asylum', 'seeker']","['search', 'narrow', 'miss', 'man']",1.399999976158142,2,1501,1345,156,24336
5263,"['ukrainian', 'president', 'order', 'day', 'ceasefire', 'east']","['agenda', 'president', 'museveni', 'agree', 'sign', 'anti', 'day']",0.2000000029802322,2,1505,376,1129,1274641
5264,"['icc', 'champions', 'trophy', 'india', 'vs', 'south', 'africa']","['champions', 'trophy', 'india', 'v', 'south', 'africalive']",4.329999923706055,4,3980,4951,-971,942841
5265,"['supreme', 'court', 'take', 'affirmative', 'action', 'michigan', 'ban', 'case']","['supreme', 'court', 'hear', 'michigan', 'affirmative', 'action', 'case']",4.400000095367432,6,5092,5047,45,2025
5266,"['headline', 'major', 'cranial', 'newspaper', 'kept']","['headline', 'major', 'cranial', 'newspaper', 'sov']",3.0,4,3982,2764,1218,1483524
5267,"['cyclone', 'leave', 'trail', 'destruction', 'india']","['cyclone', 'hamlin', 'evacuation', 'keep', 'indian', 'villager', 'alive']",2.400000095367432,1,1112,2205,-1093,1194649
5268,"['taliban', 'kill', 'police', 'west', 'afghanistan']","['drone', 'kill', 'eastern', 'afghanistan']",0.6000000238418579,2,1514,692,822,675684
5269,"['thousand', 'rally', 'support', 'battle', 'tunisia', 'government']","['thousand', 'gather', 'support', 'islamist', 'government', 'tunisia']",4.599999904632568,4,3983,5169,-1186,1406596
5270,"['south', 'africa', 'angela', 'take', 'hospital']","['elson', 'angela', 'take', 'hospital']",4.800000190734863,3,3799,5391,-1592,2534464
5271,"['updated', 'explosion', 'near', 'finish', 'line', 'boston', 'marathon']","['explosion', 'boston', 'marathon', 'finish', 'line']",5.0,5,4819,5571,-752,565504
5272,"['kill', 'southern', 'egypt', 'clash']","['kill', 'north', 'caucasus', 'train', 'station', 'blast']",0.4000000059604645,1,1113,528,585,342225
5273,"['winter', 'storm', 'state', 'state']","['winter', 'storm', 'anus', 'state', 'state']",3.0,3,3817,2778,1039,1079521
5274,"['corpse', 'men', 'round', 'south', 'baghdad']","['iraqi', 'official', 'body', 'find', 'south', 'baghdad']",3.5999999046325684,2,1539,3823,-2284,5216656
5275,"['comb', 'attack', 'kill', 'baghdad', 'christian', 'area']","['bomb', 'baghdad', 'christian', 'area']",3.0,3,3828,3038,790,624100
5276,"['china', 'set', 'fili', 'trial', 'date']","['china', 'fili', 'trial', 'fourth', 'day']",3.200000047683716,3,3827,3246,581,337561
5277,"['muslims', 'prepare', 'start', 'ramadan']","['muslims', 'pray', 'end', 'division']",0.800000011920929,1,1151,811,340,115600
5278,"['japan', 'scramble', 'jet', 'russian', 'military', 'plane']","['separatists', 'ukraine', 'military', 'plane', 'dead']",0.800000011920929,2,1573,828,745,555025
5279,"['thousand', 'prisons', 'claim', 'dole', 'germany']","['thousand', 'white', 'clothe', 'amsterdammers', 'march']",1.0,1,1163,1099,64,4096
5280,"['suspect', 'drone', 'strike', 'kill', 'pakistan']","['suspect', 'drone', 'target', 'islamic', 'seminary', 'pakistan']",2.200000047683716,3,3818,2112,1706,2910436
5281,"['drama', 'sign', 'obamacare']","['drama', 'visit', 'tornado', 'hit', 'oklahoma']",0.4000000059604645,1,1153,536,617,380689
5282,"['general', 'electric', 'post', 'profit', 'drop', 'quarter']","['post', 'profit', 'drop', 'quarter']",5.0,4,4050,5565,-1515,2295225
5283,"['china', 'juan', 'weaken', 'usd']","['china', 'juan', 'strengthen', 'new', 'high', 'usd']",2.0,3,3822,1888,1934,3740356
5284,"['russia', 'find', 'dead', 'lawyer', 'magnitski', 'guilty', 'posthumous', 'trial']","['russia', 'convict', 'dead', 'lawyer', 'magnitski', 'posthumous', 'trial']",5.0,6,5085,5583,-498,248004
5285,['trayvon'],"['trayvon', 'martin']",2.799999952316284,1,1160,2669,-1509,2277081
5286,"['china', 'send', 'large', 'fleet', 'dispute', 'island']","['china', 'ship', 'enter', 'water', 'dispute', 'island']",3.400000095367432,3,3825,3659,166,27556
5287,"['merry', 'plan', 'start', 'talk', 'call', 'release', 'palestinian', 'inmate']","['merry', 'plan', 'include', 'prisoner', 'release', 'settlement', 'freeze']",3.400000095367432,3,3830,3556,274,75076
5288,"['police', 'explosion', 'belfast', 'cathedral', 'quarter']","['explosion', 'paul', 'suicide', 'attack', 'diplomatic', 'area']",2.0,1,1141,1922,-781,609961
5289,"['syrian', 'protest', 'erdogan', 'paris', 'venezuelan', 'stress', 'support', 'syria']","['turkey', 'erdogan', 'ran', 'mend', 'tie', 'split', 'syria']",1.399999976158142,2,1553,1320,233,54289
5290,"['crime', 'minister', 'seek', 'nuclear', 'deal', 'investment', 'japan', 'visit']","['manmohan', 'hope', 'clinch', 'nuclear', 'deal', 'japan']",3.0,3,3751,3037,714,509796
5291,"['postpone', 'missile', 'test', 'n', 'tension']","['embassy', 'staying', 'despite', 'tension']",1.2000000476837158,1,1148,1205,-57,3249
5292,"['drama', 'meet', 'privately', 'family', 'elson', 'angela']","['drama', 'meet', 'angela', 'family']",4.599999904632568,4,4059,5162,-1103,1216609
5293,"['dead', 'shoot', 'damage']","['dead', 'somalia', 'attack']",0.4000000059604645,1,1149,553,596,355216
5294,"['luman', 'kill', 'philippine', 'political', 'violence']","['kill', 'philippines', 'volcano', 'eruption']",0.6000000238418579,1,1156,721,435,189225
5295,"['israel', 'drone', 'lebanon']","['israel', 'shoot', 'drone', 'lebanon']",5.0,3,3745,5604,-1859,3455881
5296,"['israel', 'approve', 'release', 'group', 'palestinian', 'prisoner', 'ahead', 'peace', 'talk']","['syrian', 'opposition', 'confirm', 'participation', 'peace', 'talk']",1.0,2,1532,1010,522,272484
5297,"['deadly', 'clash', 'egypt', 'mark', 'anniversary']","['violent', 'clash', 'mark', 'anniversary', 'egypt', 'uprise']",4.599999904632568,4,4063,5158,-1095,1199025
5298,"['nato', 'americans', 'kill', 'southern', 'afghanistan']","['roadside', 'bomb', 'kill', 'policeman', 'southern', 'afghanistan']",1.600000023841858,3,3742,1457,2285,5221225
5299,"['woman', 'dress', 'woman', 'steal', 'cash']","['cctv', 'work', 'come', 'dress', 'woman', 'trick', 'pensioner']",3.799999952316284,2,1531,4195,-2664,7096896
5300,"['cleveland', 'kidnapped', 'cry', 'gastro', 'round', 'hanged', 'prison']","['cleveland', 'kidnap', 'cry', 'gastro', 'find', 'hang', 'cell']",5.0,3,3740,5602,-1862,3467044
5301,"['google', 'unveils', 'prototype', 'self', 'driving', 'war']","['google', 'unveils', 'concept', 'self', 'driving', 'war']",5.0,5,4829,5601,-772,595984
5302,"['bangladesh', 'garment', 'factory', 'fire', 'kill']","['bangladesh', 'garment', 'factory', 'collapse', 'kill']",2.0,4,4067,1939,2128,4528384
5303,"['seek', 'reassure', 'wary', 'gulf', 'ally', 'ran', 'deal']","['age', 'seek', 'reassure', 'battery', 'gulf', 'ally', 'ran', 'deal']",4.0,6,5095,4571,524,274576
5304,"['ukraine', 'host', 'unity']","['hope', 'hit', 'war', 'sell', 'syria']",0.0,0,355,346,9,81
5305,"['pakistan', 'musharraf', 'arrest', 'bhutto', 'assassination']","['pakistan', 'musharraf', 'arrive', 'court', 'time']",2.400000095367432,2,1523,2195,-672,451584
5306,"['trial', 'late', 'met', 'egypt', 'slim', 'brotherhood', 'chief']","['syria', 'slim', 'brotherhood', 'face', 'uphill', 'battle']",2.200000047683716,2,1571,2107,-536,287296
5307,"['red', 'short', 'live', 'escape']","['march', 'war']",0.0,0,350,280,70,4900
5308,"['israel', 'doctor', 'try', 'abroad', 'force', 'feed', 'palestinian', 'prisoner']","['israel', 'west', 'bank', 'control', 'cost', 'palestinian', 'economy', 'billion']",0.2000000029802322,2,1630,387,1243,1545049
5309,"['washington', 'shops', 'prepare', 'historic', 'tales']","['washington', 'pot', 'shop', 'prepare', 'historic', 'sale']",5.0,3,3733,5607,-1874,3511876
5310,"['rio', 'airport', 'worker', 'strike', 'eve', 'fifa', 'world']","['rio', 'de', 'janeiro', 'airport', 'worker', 'strike', 'eve', 'world']",5.0,6,5084,5597,-513,263169
5311,"['slim', 'brotherhood', 'leader', 'kill']","['egypt', 'arrest', 'slim', 'brotherhood', 'leader']",1.399999976158142,3,3731,1322,2409,5803281
5312,"['ran', 'global', 'power', 'sign', 'landmark', 'nuclear', 'deal']","['ran', 'world', 'power', 'clinch', 'breakthrough', 'nuclear', 'deal']",5.0,4,4043,5595,-1552,2408704
5313,"['air', 'balloon', 'patches', 'fire', 'virginia']","['air', 'balloon', 'patches', 'fire', 'rashes']",2.799999952316284,4,4023,2649,1374,1887876
5314,"['quote', 'leader', 'family', 'angela', 'memorial']","['world', 'unite', 'angela', 'memorial']",2.400000095367432,2,1657,2187,-530,280900
5315,"['lumbar', 'indians', 'put', 'place']","['indonesians', 'vote', 'president', 'tight', 'race']",0.0,0,341,284,57,3249
5316,"['share', 'remain', 'high', 'mid', 'afternoon']","['share', 'continue', 'trend', 'mid', 'afternoon']",4.400000095367432,3,3756,5028,-1272,1617984
5317,"['papers', 'sov']","['papers', 'act']",2.799999952316284,1,1209,2652,-1443,2082249
5318,"['amazon', 'launch', 'new', 'device', 'streaming', 'video']","['amazon', 'unveil', 'new', 'fire', 'stream', 'video', 'box']",4.199999809265137,3,3780,4849,-1069,1142761
5319,"['palestinian', 'president', 'receive', 'jordanian', 'foreign', 'minister']","['palestinian', 'arrest', 'sexually', 'harass', 'young', 'girl']",0.0,1,1208,286,922,850084
5320,"['drama', 'nominate', 'new', 'transportation', 'secretary']","['drama', 'foot', 'battle', 'veterans', 'secretary']",0.2000000029802322,2,1601,400,1201,1442401
5321,"['china', 'juan', 'weaken', 'usd']","['china', 'juan', 'strengthen', 'usd', 'friday']",1.600000023841858,3,3777,1494,2283,5212089
5322,"['french', 'raid', 'wine', 'cellar', 'austerity', 'auction']","['praise', 'ukraine', 'deal', 'call', 'concrete', 'action']",0.2000000029802322,0,364,377,-13,169
5323,"['russia', 'agree', 'seizure', 'syria', 'chemical', 'weapon']","['syrian', 'rebel', 'skeptically', 'chemical', 'weapon', 'deal']",1.399999976158142,2,1618,1323,295,87025
5324,"['s', 'visit', 'kaesong', 'complex']","['demand', 'talk', 'closed', 'factory']",1.399999976158142,0,382,1324,-942,887364
5325,"['algerian', 'priest', 'lecture', 'christian', 'heritage', 'africa']","['telstra', 'apply', 'list', 'china', 'site']",0.0,0,381,326,55,3025
5326,"['headline', 'major', 'cranial', 'newspaper', 'april']","['headline', 'major', 'cranial', 'newspaper', 'august']",3.0,4,4040,2800,1240,1537600
5327,"['complication', 'palestinian', 'reconciliation']","['belgian', 'king', 'address', 'nation', 'amid', 'indication', 'speculation']",0.6000000238418579,0,380,702,-322,103684
5328,"['hijacker', 'arrest', 'plane', 'land', 'geneva', 'airport']","['hijacked', 'aircraft', 'land', 'geneva']",3.0,2,1392,2794,-1402,1965604
5329,"['pcb', 'appoint', 'makar', 'wounds', 'head', 'coach']","['makar', 'wounds', 'pakistan', 'coach']",5.0,3,3333,5656,-2323,5396329
5330,"['make', 'case', 'action', 'syria']","['maude', 'urge', 'action', 'israel', 'strikes', 'syria']",2.400000095367432,2,1393,2225,-832,692224
5331,"['ankara', 'protest', 'clash', 'police']","['peru', 'protest', 'clash', 'police']",1.7999999523162842,3,3334,1651,1683,2832489
5332,"['kill', 'wound', 'violent', 'attack', 'ran']","['kill', 'wound', 'fresh', 'attack', 'ran']",2.200000047683716,4,4039,2132,1907,3636649
5333,"['huerta', 'arrest', 'production', 'child', 'pornography']","['indian', 'arrest', 'suspicion', 'rape']",0.4000000059604645,1,1184,580,604,364816
5334,"['ukraine', 'sign', 'trade', 'russia', 'finalize', 'crimea', 'annexation']","['ukraine', 'court', 'dismiss', 'crimea', 'independence', 'unconstitutional']",2.0,2,1487,1828,-341,116281
5335,"['sad', 'warn', 'turkey', 'heavy', 'price', 'back', 'syrian', 'rebel']","['cabinet', 'war', 'arm', 'syrian', 'rebel']",1.0,2,1481,1052,429,184041
5336,"['indian', 'stock', 'close', 'low']","['long', 'long', 'stock', 'close', 'high']",1.7999999523162842,2,1445,1655,-210,44100
5337,"['kill', 'wound', 'violent', 'attack', 'ran']","['kill', 'wound', 'attack', 'ran']",2.799999952316284,4,4037,2599,1438,2067844
5338,"['indian', 'rape', 'accuse', 'face', 'verdict']","['indian', 'rape', 'accuse', 'find', 'guilty']",3.799999952316284,3,3338,4067,-729,531441
5339,"['ran', 'nuclear', 'deal', 'agree', 'talk']","['ran', 'nuclear', 'real', 'heal', 'decades', 'long', 'dispute']",3.5999999046325684,2,1455,3766,-2311,5340721
5340,"['egyptian', 'military', 'spokesman', 'denounce', 'incitement', 'army']","['labor', 'ministry', 'announcement', 'monday']",0.0,0,374,331,43,1849
5341,"['dowden', 'see', 'chance', 'fair', 'trial']","['dowden', 'see', 'chance', 'fair', 'trial']",5.0,5,4798,5720,-922,850084
5342,"['headline', 'major', 'cranial', 'newspaper', 'dec']","['headline', 'major', 'cranial', 'newspaper', 'july']",2.200000047683716,4,4035,2024,2011,4044121
5343,"['dozen', 'injure', 'connecticut', 'train', 'collision']","['indian', 'minister', 'kill', 'head', 'collision']",0.2000000029802322,1,1005,415,590,348100
5344,"['queen', 'visit', 'britain', 'new', 'prince']","['queen', 'meet', 'britain', 'new', 'baby', 'prince']",5.0,4,4032,5718,-1686,2842596
5345,"['ukraine', 'kill', 'parliament', 'protest']","['ukraine', 'president', 'walls', 'talks', 'protest']",1.0,2,1437,1043,394,155236
5346,"['operator', 'charge', 'fair', 'accident']","['state', 'hair', 'ride', 'operator', 'arrest', 'accident']",4.400000095367432,2,1908,5008,-3100,9610000
5347,"['transcript', 'reveal', 'confusion', 'evacuation', 'south', 'organ', 'ferry']","['transcript', 'reveal', 'confusion', 'merry', 'evacuation']",3.5999999046325684,4,4031,3775,256,65536
5348,"['fall', 'firefighter', 'bring', 'home']","['street', 'end', 'slightly', 'low']",0.2000000029802322,0,345,419,-74,5476
5349,"['syria', 'regime', 'agree', 'attend', 'peace', 'conference']","['russia', 'syria', 'agrees', 'participate', 'conference']",4.800000190734863,2,1880,5416,-3536,12503296
5350,"['vote', 'reject', 'military', 'action']","['britain', 'reject', 'syria', 'military', 'action']",3.400000095367432,3,3340,3648,-308,94864
5351,"['new', 'zealand', 'set', 'realise', 'gay', 'marriage']","['new', 'zealand', 'vote', 'realise', 'sex', 'marriage']",4.400000095367432,4,4027,5018,-991,982081
5352,"['singapore', 'stock', 'end']","['singapore', 'stock', 'close', 'high']",3.0,2,2013,2906,-893,797449
5353,"['venezuelan', 'president', 'visit', 'china']","['senegalese', 'president', 'visit', 'china']",1.7999999523162842,3,3341,1657,1684,2835856
5354,"['cairo', 'protest', 'defy', 'crackdown', 'threat']","['cairo', 'camps', 'protesters', 'fig']",3.5999999046325684,1,967,3765,-2798,7828804
5355,"['kiss', 'plane', 'search', 'turn', 'vietnamese', 'island']","['kiss', 'malaysia', 'airline', 'plane', 'clash', 'vietnam']",3.0,2,2005,2901,-896,802816
5356,"['official', 'malaysia', 'airline', 'brief', 'relative', 'miss', 'flight', 'passenger', 'search', 'progress']","['malaysia', 'airline', 'investigation', 'co', 'pilot', 'miss', 'flight']",1.0,4,4026,1083,2943,8661249
5357,"['star', 'pay', 'tribute', 'tory', 'monteith']","['star', 'pay', 'tribute', 'james', 'earner']",2.200000047683716,3,3343,2083,1260,1587600
5358,"['os', 'angeles', 'airport', 'worker', 'charge', 'make', 'threat']","['os', 'angeles', 'airport', 'worker', 'charge', 'threat']",5.0,6,5050,5714,-664,440896
5359,"['note', 'heads', 'friday']","['note', 'heads', 'friday', 'august']",2.200000047683716,3,3344,2082,1262,1592644
5360,"['cristiano', 'donald', 'hat', 'trick', 'fire', 'portugal', 'world', 'final']","['donald', 'hat', 'trick', 'fire', 'portugal', 'world']",4.800000190734863,6,5049,5425,-376,141376
5361,"['britain', 'prince', 'philip', 'set', 'exploratory', 'surgery']","['prince', 'philip', 'hospitalize']",3.0,2,1974,2758,-784,614656
5362,"['japan', 'start', 'hear', 'sale', 'tax', 'ex', 'bank', 'deputy', 'urge', 'gradual', 'rise']","['japan', 'start', 'hearing', 'propose', 'tax', 'like']",3.5999999046325684,3,3347,3778,-431,185761
5363,"['bomb', 'attack', 'kill', 'soldier', 'civilian']","['school', 'bomb', 'attack', 'kill', 'southern', 'thailand']",1.0,3,3348,1028,2320,5382400
5364,"['italian', 'pilgrim', 'die', 'bus', 'plunge']","['passenger', 'dead', 'italy', 'bus', 'plunge']",3.799999952316284,2,1723,4254,-2531,6405961
5365,"['strong', 'new', 'quaker', 'hit', 'shatter', 'oak', 'region']","['powerful', 'new', 'earthquake', 'hit', 'shatter', 'pakistan', 'region']",5.0,4,4021,5712,-1691,2859481
5366,"['syrian', 'opposition', 'offer', 'sad', 'truce', 'duration', 'ramadan']","['syrian', 'opposition', 'offer', 'sad', 'force', 'truce', 'duration', 'ramadan']",4.599999904632568,7,5234,5164,70,4900
5367,"['dead', 'somalia', 'attack']","['die', 'ran', 'prison', 'attack']",2.200000047683716,1,1074,1970,-896,802816
5368,"['estate', 'mall', 'attacker', 'spend', 'month', 'plan', 'nairobi']","['estate', 'attacker', 'spend', 'month', 'plan', 'nairobi', 'say', 'official']",4.599999904632568,6,5046,5155,-109,11881
5369,"['security', 'council', 'call', 'humanitarian', 'ceasefire', 'papa']","['security', 'council', 'walls', 'unconditional', 'ease', 'fire', 'papa']",4.800000190734863,3,3352,5469,-2117,4481689
5370,"['magnitude', 'quaker', 'hit', 'honshu', 'japan', 'cenc']","['magnitude', 'earthquake', 'bolt', 'taiwan', 'cenc']",2.0,2,1672,1960,-288,82944
5371,"['chinese', 'share', 'close', 'high', 'tuesday']","['chinese', 'share', 'close', 'lower', 'wednesday']",2.200000047683716,3,3353,1989,1364,1860496
5372,"['war', 'bombs', 'iraqi', 'capital']","['war', 'coming', 'kill', 'civilian', 'iraqi', 'capital']",2.400000095367432,3,3332,2298,1034,1069156
5373,"['ukrainian', 'protest', 'street', 'anti', 'government', 'rally']","['ukraine', 'protest', 'couple', 'vein', 'statue', 'kiev']",2.5999999046325684,1,1085,2434,-1349,1819801
5374,"['canadian', 'freight', 'train', 'blast', 'death', 'toll', 'hit', 'rise']","['canadian', 'government', 'monitoring', 'train', 'blast', 'situation']",2.200000047683716,3,3329,2108,1221,1490841
5375,"['nigel', 'garage', 'call', 'government', 'let', 'syrian', 'refugee']","['plan', 'settle', 'syrian', 'refugee']",2.400000095367432,2,1774,2268,-494,244036
5376,"['israel', 'teres', 'urge', 'return', 'peace', 'talk']","['gonsalves', 'keep', 'pressure', 'tom', 'rep']",0.2000000029802322,0,383,405,-22,484
5377,"['china', 'juan', 'strengthen', 'usd', 'tuesday']","['china', 'juan', 'weaken', 'usd']",1.7999999523162842,3,3309,1649,1660,2755600
5378,"['radio', 'israel', 'set', 'increase', 'palestinian', 'prisoner', 'release']","['israel', 'delay', 'palestinian', 'prisoner', 'release']",1.600000023841858,4,4065,1499,2566,6584356
5379,"['dorsi', 'supporter', 'reject', 'plan']","['dorsi', 'supporter', 'march', 'egypt']",2.400000095367432,2,1769,2282,-513,263169
5380,"['egypt', 'court', 'sentence', 'brotherhood', 'supporter', 'death', 'source']","['turkish', 'tell', 'supporter', 'prepare', 'ally']",0.2000000029802322,1,1049,403,646,417316
5381,"['drama', 'condemn', 'kill', 'israel', 'ten']","['body', 'miss', 'israel', 'ten', 'find', 'west', 'bank']",1.399999976158142,2,1806,1326,480,230400
5382,"['man', 'try', 'beheld', 'soldier', 'london', 'street', 'court', 'hear']","['australia', 'speed', 'indonesia', 'president', 'report']",0.0,0,348,342,6,36
5383,"['ukraine', 'protest', 'rebuild', 'barricade']","['ruin', 'speak', 'ukraine', 'protest', 'rebuild', 'barricade']",3.400000095367432,4,4062,3661,401,160801
5384,"['el', 'smith', 'dead', 'mourn', 'comedy', 'favourite']","['tariff', 'bone', 'el', 'smith', 'force', 'life']",2.400000095367432,2,1688,2233,-545,297025
5385,"['dead', 'hurt', 'new', 'work', 'building', 'collapse']","['dead', 'hurt', 'french', 'building', 'collapse']",1.600000023841858,4,4061,1502,2559,6548481
5386,"['chinese', 'share', 'close', 'high', 'tuesday']","['chinese', 'stock', 'close', 'low', 'thursday']",1.600000023841858,2,1726,1510,216,46656
5387,"['india', 'ink', 'image', 'july']","['india', 'ink', 'image', 'march']",3.0,3,3317,2936,381,145161
5388,"['sign', 'muslims', 'celebrate', 'kill', 'afghanistan']","['sign', 'muslims', 'celebrate', 'die', 'pakistan', 'afghanistan']",3.5999999046325684,4,4058,3965,93,8649
5389,"['russian', 'coal', 'mine', 'seek', 'new', 'outlet', 'china']","['russian', 'foreign', 'minister', 'meet', 'chief']",0.4000000059604645,1,1318,500,818,669124
5390,"['pro', 'russia', 'protest', 'demand', 'great', 'autonomy']","['sudanese', 'protest', 'demand', 'regime', 'outer']",1.399999976158142,2,1874,1327,547,299209
5391,"['ran', 'army', 'fight', 'retaken', 'tikrit']","['ran', 'army', 'claim', 'victory', 'tikrit']",3.200000047683716,3,3318,3081,237,56169
5392,"['ran', 'condemn', 'allege', 'israel', 'airstrike', 'syria']","['democrats', 'face', 'divide', 'strike', 'syria']",1.2000000476837158,1,1345,1210,135,18225
5393,"['israel', 'agree', 'extend', 'papa', 'truce', 'hour']","['israel', 'james', 'reportedly', 'agree', 'hour', 'truce']",2.5999999046325684,4,4056,2389,1667,2778889
5394,"['fire', 'south', 'organ', 'bus', 'terminal', 'kill']","['s', 'bus', 'station', 'fire', 'kill', 'seven']",3.200000047683716,3,3319,3102,217,47089
5395,"['civilian', 'nato', 'soldier', 'kill', 'afghanistan']","['nato', 'soldier', 'kill', 'afghanistan']",3.400000095367432,4,4053,3621,432,186624
5396,"['protester', 'swamp', 'street', 'reclaim', 'revolution']","['egypt', 'protester', 'storm', 'slim', 'brotherhood']",1.600000023841858,1,1250,1504,-254,64516
5397,"['tokyo', 'stock', 'open']","['tokyo', 'stock', 'open']",2.799999952316284,3,3322,2627,695,483025
5398,"['australia', 'return', 'asylum', 'seeker', 'ri', 'vanka', 'sea', 'transfer']","['australia', 'australia', 'hand', 'asylum', 'seeker', 'ri', 'vanka']",4.599999904632568,5,4701,5165,-464,215296
5399,"['shankill', 'blast', 'victim', 'remember']","['crocodile', 'victim', 'body', 'recover']",0.2000000029802322,1,1312,402,910,828100
5400,"['people', 'kill', 'twin', 'blast', 'siberia']","['man', 'kill', 'new', 'blast', 'russia']",1.399999976158142,2,1369,1328,41,1681
5401,"['lee', 'star', 'tory', 'monteith', 'find', 'dead', 'hotel', 'room', 'canada']","['lee', 'star', 'tory', 'monteith', 'find', 'dead']",4.400000095367432,6,5086,5027,59,3481
5402,"['poland', 'death', 'toll', 'limb']","['sonya', 'red', 'cross', 'say', 'death', 'toll', 'rise']",0.4000000059604645,2,1379,513,866,749956
5403,"['tokyo', 'stock', 'close']","['tokyo', 'stock', 'close']",1.7999999523162842,3,3324,1664,1660,2755600
5404,"['ran', 'say', 'ready', 'fresh', 'round', 'nuclear', 'talk']","['ran', 'khamenei', 'renew', 'support', 'nuclear', 'talk']",3.5999999046325684,3,3325,3833,-508,258064
5405,"['lash', 'continue', 'police', 'protest', 'turkey']","['turkish', 'police', 'fight', 'protest', 'clear', 'square']",4.400000095367432,2,1397,5065,-3668,13454224
5406,"['refuse', 'medical', 'card', 'urge', 'contact', 'hse']","['hse', 'boss', 'depend', 'medical', 'card', 'plan']",1.2000000476837158,3,3326,1212,2114,4468996
5407,"['large', 'building', 'open', 'west', 'china']","['centre', 'leave', 'splinter', 'presidential', 'vote']",0.0,0,361,314,47,2209
5408,"['israel', 'lightly', 'hurt', 'stone', 'west', 'bank']","['israel', 'troop', 'kill', 'palestinian', 'west', 'bank', 'raid']",1.2000000476837158,3,3327,1223,2104,4426816
5409,"['death', 'toll', 'egypt', 'protest', 'rise']","['death', 'toll', 'egypt', 'violence', 'rise']",3.200000047683716,4,4019,3141,878,770884
5410,"['syrian', 'opposition', 'agree', 'landmark', 'peace', 'talk']","['syria', 'opposition', 'press', 'attend', 'talk']",3.0,2,1661,3069,-1408,1982464
5411,"['poverty', 'state', 'doubt', 'lodi', 'development', 'claim']","['start', 'take', 'recall', 'compensation', 'claim', 'dug']",0.0,1,1309,317,992,984064
5412,"['fro', 'russia', 'rebel', 'hold', 'vote', 'ukraine']","['syria', 'rebel', 'kill', 'hezbollah', 'man', 'lebanon']",0.0,1,1278,319,959,919681
5413,"['georgian', 'vote', 'new', 'president']","['ally', 'georgia', 'millionaire', 'president', 'poll']",2.5999999046325684,1,1276,2375,-1099,1207801
5414,"['mer', 'respiratory', 'illness', 'find', 'official', 'confirm']","['case', 'mer', 'sars', 'like', 'respiratory', 'illness', 'report', 'north', 'america']",4.199999809265137,3,3355,4718,-1363,1857769
5415,"['declare', 'hezbollah', 'military', 'wing', 'terror', 'group']","['put', 'hezbollah', 'military', 'wing', 'terror', 'list']",4.800000190734863,4,3988,5368,-1380,1904400
5416,"['germany', 'welcome', 'ran', 'nuclear', 'agreement']","['syria', 'welcome', 'ran', 'nuclear', 'deal']",1.7999999523162842,3,3356,1676,1680,2822400
5417,"['papers', 'june']","['papers', 'dug']",2.200000047683716,1,1275,2046,-771,594441
5418,"['luman', 'kill', 'foreigner', 'pakistan']","['luman', 'kill', 'tourist', 'pakistan']",4.800000190734863,3,3357,5359,-2002,4008004
5419,"['indian', 'trader', 'strange', 'china', 'send', 'home']","['indian', 'nurse', 'strange', 'ran', 'return', 'home']",1.7999999523162842,3,3383,1683,1700,2890000
5420,"['california', 'governor', 'declare', 'drought', 'emergency']","['california', 'governor', 'declare', 'drought', 'emergency', 'wildfire', 'continue', 'burn']",3.5999999046325684,5,4708,3850,858,736164
5421,"['peace', 'talk', 'palestinians', 'month', 'israel', 'official']","['myo', 'palestinian', 'girl', 'kill', 'israel', 'raid']",0.4000000059604645,1,1268,480,788,620944
5422,"['kill', 'ran', 'car', 'coming']","['child', 'kill', 'syria', 'coming']",0.6000000238418579,2,1510,726,784,614656
5423,"['dead', 'wrap', 'late', 'lumbar', 'building', 'collapse']","['wrap', 'building', 'collapse']",1.2000000476837158,3,3386,1213,2173,4721929
5424,"['air', 'strike', 'kill', 'dozen', 'northern', 'syria']","['ukraine', 'inch', 'crimea']",0.0,0,391,324,67,4489
5425,"['chinese', 'tourist', 'abduct', 'malaysia']","['china', 'return', 'child', 'abduct', 'vietnam']",1.399999976158142,1,1301,1332,-31,961
5426,"['inspector', 'hail', 'progress', 'syria', 'chemical', 'weapon']","['conclude', 'syria', 'chemical', 'weapon', 'house']",2.200000047683716,3,3389,2021,1368,1871424
5427,"['arrest', 'protest', 'nigel', 'garage']","['merry', 'vow', 'progress', 'late', 'intensive', 'ideas', 'trip']",0.0,0,397,323,74,5476
5428,"['luman', 'kill', 'libyan', 'soldier']","['luman', 'kill', 'lebanese', 'troop', 'near', 'syria']",2.400000095367432,2,1574,2239,-665,442225
5429,"['picture', 'complete', 'costa', 'concordia', 'operation']","['timelapse', 'costa', 'concordia', 'operation']",4.400000095367432,3,3390,5041,-1651,2725801
5430,"['ran', 'nuclear', 'talks', 'enter']","['ran', 'nuclear', 'talk', 'enter', 'crucial', 'day']",5.0,3,3391,5735,-2344,5494336
5431,"['protester', 'gather', 'brazil', 'despite', 'concession']","['protest', 'sweep', 'brazil', 'despite', 'concession']",5.0,3,3394,5734,-2340,5475600
5432,"['australian', 'mud', 'call', 'election', 'september']","['australian', 'mud', 'call', 'kept', 'poll']",4.599999904632568,3,3405,5166,-1761,3101121
5433,"['ran', 'nuclear', 'talk', 'expect', 'resume', 'week']","['ran', 'nuclear', 'talk', 'point']",3.0,3,3395,2793,602,362404
5434,"['bangkok', 'tense', 'election', 'eve']","['bangladesh', 'crackdown', 'escalate', 'head', 'election']",2.200000047683716,1,1330,2093,-763,582169
5435,"['china', 'protect', 'foreign', 'business']","['drama', 'confrontation', 'ruin', 'ukraine']",0.0,0,390,321,69,4761
5436,"['notes', 'decriminalize', 'marijuana']","['vote', 'decriminalize', 'pot']",5.0,1,1332,5731,-4399,19351201
5437,"['dead', 'asylum', 'boat', 'sink', 'australia']","['angela', 'spend', 'day', 'hospital']",0.0,0,396,320,76,5776
5438,"['north', 'nail', 'execution', 'powerful', 'uncle']","['north', 'organ', 'intrigue', 'execution', 'power']",2.5999999046325684,2,1542,2517,-975,950625
5439,"['margaret', 'thatched', 'die', 'stroke']","['margaret', 'thatched', 'die']",4.199999809265137,3,3400,4835,-1435,2059225
5440,"['chinese', 'president', 'arrive', 'netherlands', 'state', 'visit', 'nuclear', 'summit']","['chinese', 'president', 'arrive', 'venezuela', 'state', 'visit']",2.400000095367432,5,4713,2245,2468,6091024
5441,"['israel', 'sanction', 'palestinians', 'new', 'blow', 'peace', 'talk']","['israel', 'release', 'palestinian', 'prisoner', 'deal', 'revive', 'peace', 'talk']",2.400000095367432,3,3401,2261,1140,1299600
5442,"['sky', 'news', 'cameraman', 'kill', 'egypt']","['sky', 'news', 'cameraman', 'kill', 'egypt']",4.800000190734863,5,4715,5349,-634,401956
5443,"['stock', 'rise', 'early', 'trading']","['stock', 'inch', 'high', 'early', 'trading']",4.400000095367432,3,3402,5094,-1692,2862864
5444,"['fbi', 'audit', 'expert', 'testify', 'zimmerman', 'trial']","['jury', 'selection', 'begin', 'zimmerman', 'trial']",1.399999976158142,2,1544,1335,209,43681
5445,"['cranial', 'nuclear', 'talk', 'extend', 'november']","['ran', 'nuclear', 'talk', 'extend', 'november']",4.400000095367432,4,3968,5096,-1128,1272384
5446,"['boston', 'come', 'suspect', 'appear', 'court']","['boston', 'come', 'suspect', 'bury']",1.2000000476837158,3,3403,1214,2189,4791721
5447,"['death', 'toll', 'india', 'building', 'collapse', 'hit']","['toll', 'india', 'building', 'collapse', 'hit']",3.200000047683716,5,4698,3176,1522,2316484
5448,"['drama', 'announce', 'creation', 'twin', 'manufacturing', 'hub']","['stock', 'retreat', 'manufacture', 'datum']",0.4000000059604645,0,392,476,-84,7056
5449,"['charge', 'terrorist', 'offence']","['people', 'charge', 'terror', 'offence']",4.800000190734863,2,1548,5393,-3845,14784025
5450,"['president', 'drama', 'reveal', 'plan', 'withdraw', 'troop', 'afghanistan']","['government', 'shutdown', 'drama', 'tell', 'republicans', 'lift', 'threat', 'economy', 'want', 'talk']",0.800000011920929,1,566,860,-294,86436
5451,"['nato', 'raise', 'doubts', 'russia', 'pull', 'ukraine', 'order']","['sign', 'russian', 'withdrawal', 'ukraine', 'order', 'official', 'day']",2.5999999046325684,2,1580,2455,-875,765625
5452,"['ftse', 'bursa', 'malaysia', 'update']","['ftse', 'bursa', 'malaysia', 'update']",3.400000095367432,4,3977,3424,553,305809
5453,"['glasgow', 'helicopter', 'crash', 'search', 'end']","['glasgow', 'helicopter', 'crash', 'woman', 'victim']",2.799999952316284,3,3382,2612,770,592900
5454,"['quotation', 'news']","['quotation', 'day']",3.200000047683716,1,591,3101,-2510,6300100
5455,"['philip', 'leave', 'hospital', 'day']","['angela', 'leave', 'hospital', 'day']",1.7999999523162842,3,3380,1742,1638,2683044
5456,"['fragment', 'king', 'alfred']","['remain', 'winchester', 'king', 'alfred', 'great']",4.599999904632568,2,1572,5154,-3582,12830724
5457,"['israel', 'free', 'second', 'group', 'palestinian', 'prisoner']","['israel', 'release', 'palestinian', 'prisoner']",3.799999952316284,3,3359,4238,-879,772641
5458,"['skydiver', 'dead', 'collide', 'jump']","['skydiver', 'dead', 'collide', 'jump', 'arizona']",3.799999952316284,4,4015,4071,-56,3136
5459,"['iron', 'jetpack', 'spark', 'concern', 'hawaii']","['iron', 'jetpacks', 'park', 'concern']",3.799999952316284,2,1570,4081,-2511,6305121
5460,"['israel', 'free', 'palestinian', 'prisoner']","['israel', 'release', 'palestinian', 'prisoner']",4.599999904632568,3,3362,5156,-1794,3218436
5461,"['france', 'days', 'think', 'responsibilities', 'syria']","['france', 'urge', 'unite', 'syria']",2.5999999046325684,2,1567,2385,-818,669124
5462,"['boston', 'come', 'suspect', 'identify', 'surveillance', 'video', 'arrest']","['boston', 'come', 'suspect', 'fbi', 'surveillance', 'say', 'mother']",3.400000095367432,4,4007,3587,420,176400
5463,"['china', 'anger', 'overcome', 'worry']","['china', 'anger', 'north', 'overcome', 'worry', 'stealth', 'flight']",3.200000047683716,4,4006,3286,720,518400
5464,"['china', 'juan', 'strengthen', 'new', 'high', 'usd']","['china', 'juan', 'weaken', 'usd']",2.200000047683716,3,3364,2059,1305,1703025
5465,"['hold', 'shoot', 'belfast']","['arrest', 'shoot']",3.200000047683716,1,583,3314,-2731,7458361
5466,"['police', 'stop', 'maldives', 'presidential', 'election']","['deity', 'sins', 'ali', 'presidential', 'election']",1.2000000476837158,2,1511,1215,296,87616
5467,"['indian', 'army', 'kill', 'militant', 'indian', 'control', 'kashmir']","['indian', 'troop', 'kill', 'militant', 'commander', 'indian', 'control', 'kashmir']",3.5999999046325684,5,4686,3954,732,535824
5468,"['war', 'bomb', 'kill', 'northwest', 'syria']","['war', 'bomb', 'kill', 'northwest', 'pakistan']",1.2000000476837158,4,4004,1216,2788,7772944
5469,"['ran', 'oil', 'swap', 'eastern', 'neighbor']","['ran', 'urge', 'rapid', 'release', 'diplomat']",0.4000000059604645,1,529,510,19,361
5470,"['turkey', 'president', 'appeal', 'calm']","['texas', 'house', 'provisional', 'approve', 'abortion', 'law']",0.0,0,388,310,78,6084
5471,"['north', 'test', 'fire', 'missile', 'sea']","['n', 'fire', 'shell', 'sea']",2.799999952316284,2,1660,2607,-947,896809
5472,"['die', 'senegal', 'house', 'fire']","['woman', 'die', 'work', 'house', 'fire']",2.200000047683716,3,3367,2050,1317,1734489
5473,"['oh', 'gas', 'blast', 'kill', 'injury', 'dozen']","['syria', 'missile', 'kill', 'include', 'kiss']",0.6000000238418579,1,547,641,-94,8836
5474,"['rolling', 'station', 'open', 'ukrainian', 'presidential', 'election']","['combination', 'open', 'influential', 'wards']",0.2000000029802322,1,551,385,166,27556
5475,"['india', 'ink', 'image', 'april']","['india', 'ink', 'image']",2.5999999046325684,3,3368,2518,850,722500
5476,"['french', 'journalist', 'kill', 'ali']","['france', 'confirm', 'french', 'journalist', 'kill', 'ali']",5.0,4,4000,5671,-1671,2792241
5477,"['luman', 'kill', 'tourist', 'pakistan']","['lumen', 'attack', 'hotel', 'remote', 'pakistani', 'province']",3.200000047683716,0,353,3287,-2934,8608356
5478,"['israel', 'james', 'observe', 'brief', 'papa', 'truce']","['israel', 'james', 'accept', 'temporary', 'truce']",4.599999904632568,3,3371,5160,-1789,3200521
5479,"['china', 'troubled', 'xinjiang', 'hit', 'violence']","['china', 'online', 'population', 'rise', 'man']",0.4000000059604645,1,556,514,42,1764
5480,"['relative', 'scuffle', 'police', 'china', 'fire', 'kill']","['angry', 'family', 'demand', 'answer', 'china', 'plant', 'fire', 'kill']",3.799999952316284,3,3372,4080,-708,501264
5481,"['ran', 'reject', 'claim', 'chlorine', 'bomb']","['ran', 'reject', 'mko', 'claim', 'nuclear', 'site']",2.400000095367432,3,3373,2199,1174,1378276
5482,"['india', 'minister', 'wife', 'die', 'unnatural', 'death', 'affair', 'rumour']","['minister', 'wife', 'death', 'unnatural']",3.799999952316284,4,3995,4070,-75,5625
5483,"['dead', 'hurt', 'shoot', 's', 'carolina', 'oceanfront', 'hotel']","['dead', 'injure', 'train', 'collision', 'near', 'moscow']",0.2000000029802322,1,558,397,161,25921
5484,"['burial', 'boston', 'come', 'suspect', 'appear', 'legal']","['ready', 'home', 'boston', 'come', 'victim', 'leave', 'hospital']",1.0,2,1382,1058,324,104976
5485,"['kill', 's', 'china', 'road', 'cave']","['kill', 'china', 'earthquake']",1.2000000476837158,2,1387,1217,170,28900
5486,"['south', 'africa', 'president', 'angela', 'improve']","['afghan', 'president', 'delay', 'sign', 'deal']",0.0,1,634,339,295,87025
5487,"['world', 'news', 'update', 'need', 'know']","['labour', 'tax', 'rate', 'need', 'know']",0.6000000238418579,2,1477,647,830,688900
5488,"['syrian', 'civil', 'war', 'photo']","['syrian', 'civil', 'war', 'peace', 'talk', 'risk', 'ran', 'invitation']",1.2000000476837158,3,3378,1218,2160,4665600
5489,"['abdullah', 'sides', 'head', 'afghan', 'presidential', 'toll']","['explosion', 'hear', 'near', 'afghan', 'presidential', 'palace']",1.0,2,1433,1045,388,150544
5490,"['man', 'blame', 'rival', 'colleague', 'murder']","['pakistans', 'man', 'blame', 'rival', 'kill', 'party', 'member']",4.199999809265137,3,3307,4868,-1561,2436721
5491,"['bangladesh', 'honors', 'factory', 'victims']","['retainer', 'bangladesh', 'factory', 'safety']",2.799999952316284,2,1927,2587,-660,435600
5492,"['meet', 'fire', 'national', 'die']","['get', 'fire', 'national', 'blow', 'hospital']",3.0,2,2021,2774,-753,567009
5493,"['japan', 'depend', 'dolphin', 'hunt', 'criticism']","['japan', 'depend', 'dolphin', 'hunt', 'criticism']",5.0,5,4692,5664,-972,944784
5494,"['comb', 'blast', 'rock', 'shopping', 'mall', 'siberia', 'kill']","['comb', 'blast', 'indian', 'opposition', 'rally', 'kill']",1.399999976158142,3,3292,1337,1955,3822025
5495,"['philippine', 'typhoid', 'death', 'toll']","['philippine', 'typhoid', 'death', 'toll', 'rise']",3.400000095367432,4,4151,3660,491,241081
5496,"['police', 'fire', 'tear', 'venezuelan', 'vote', 'protest']","['heir', 'madura', 'win', 'venezuela', 'presidency']",0.6000000238418579,0,378,645,-267,71289
5497,"['attack', 'kill', 'ran']","['suicide', 'attack', 'kill', 'northern', 'ran']",1.7999999523162842,3,3232,1667,1565,2449225
5498,"['chinese', 'political', 'adviser', 'meet', 'greek']","['chinese', 'political', 'adviser', 'meet', 'cement', 'president']",3.400000095367432,4,4149,3546,603,363609
5499,"['palestinian', 'diplomat', 'injure', 'explosion', 'prague']","['palestinian', 'ambassador', 'injure', 'apartment', 'blast']",4.0,2,1681,4633,-2952,8714304
5500,"['ukraine', 'leader', 'pledge', 'crisis', 'talk']","['ukraine', 'leader', 'pledges', 'crisis', 'talks']",5.0,3,3233,5661,-2428,5895184
5501,"['kill', 'attack', 'ran']","['kill', 'series', 'attack', 'ran']",3.0,3,3235,3011,224,50176
5502,"['military', 'presence', 'asia']","['nato', 'military', 'presence', 'amid', 'russian', 'threat']",1.2000000476837158,2,1697,1219,478,228484
5503,"['believe', 'syrian', 'government', 'chemical', 'weapon']","['suspect', 'syria', 'chemical', 'weapon']",5.0,2,1696,5660,-3964,15713296
5504,"['world', 'power', 'ran', 'resume', 'expert', 'nuclear', 'talk']","['ran', 'nuclear', 'expert', 'world', 'power', 'resume', 'talk', 'week']",4.0,7,5304,4661,643,413449
5505,"['egypt', 'slim', 'brotherhood', 'refuse']","['egyptian', 'court', 'sentence', 'slim', 'brotherhood', 'leader', 'life', 'prison']",1.399999976158142,2,1693,1338,355,126025
5506,"['dead', 'canada', 'bus', 'train', 'crash']","['dead', 'paris', 'train', 'crash']",2.200000047683716,3,3238,2140,1098,1205604
5507,"['chinese', 'president', 'meet', 'greek', 'call', 'strong', 'partnership']","['chinese', 'president', 'meet', 'indian', 'vice', 'president']",1.7999999523162842,3,3240,1705,1535,2356225
5508,"['astrazeneca', 'pay', 'buy', 'bristol', 'eyes', 'squibb', 'diabetes', 'alliance']","['astrazeneca', 'buy', 'bristol', 'diabetes', 'venture', 'billion']",5.0,4,4141,5677,-1536,2359296
5509,"['italian', 'fugitive', 'arrest', 'dominican', 'republic']","['australian', 'icebreaker', 'arrive', 'antarctica', 'new', 'rescue', 'bid']",0.0,0,365,334,31,961
5510,"['india', 'hold', 'talk', 'china', 'week']","['egypt', 'hold', 'talk', 'imf', 'loan', 'week']",1.399999976158142,3,3241,1339,1902,3617604
5511,"['israel', 'carrying', 'round', 'offensive', 'papa']","['israel', 'haunches', 'round', 'offensive', 'papa']",4.800000190734863,4,4140,5400,-1260,1587600
5512,"['thud', 'alert', 'israel', 'prime', 'minister', 'sentence', 'year', 'jail', 'corruption']","['thud', 'alert', 'sentence', 'year', 'israel']",3.799999952316284,5,4696,4110,586,343396
5513,"['brahimi', 'apology', 'syria', 'lack', 'peace', 'progress']","['mediator', 'apologize', 'syrian', 'lack', 'peace', 'progress']",3.799999952316284,3,3242,4203,-961,923521
5514,"['egyptian', 'protest', 'issue', 'dorsi', 'resignation', 'ultimatum']","['ukraine', 'protest', 'battle', 'police', 'new', 'clash']",0.4000000059604645,1,652,591,61,3721
5515,"['thing', 'foci', 'olympics']","['thing', 'ethanol']",0.0,1,430,332,98,9604
5516,"['china', 'stock', 'open', 'lower', 'wednesday']","['china', 'stock', 'close', 'lower', 'monday']",2.5999999046325684,3,3244,2409,835,697225
5517,"['delay', 'missile', 'test', 'tension', 'rise']","['william', 'vague', 'decision', 'halt', 'missile', 'test', 'sensible']",3.400000095367432,2,1773,3506,-1733,3003289
5518,"['fire', 'seizing', 'kill']","['fire', 'seizing', 'kill']",5.0,3,3246,5700,-2454,6022116
5519,"['india', 'china', 'ink', 'border', 'agreement']","['india', 'china', 'ink', 'agreement', 'trans', 'border', 'river']",3.799999952316284,5,4717,4199,518,268324
5520,"['venezuela', 'expel', 'diplomat']","['venezuela', 'expel', 'diplomat']",5.0,3,3247,5699,-2452,6012304
5521,"['heavy', 'hit', 'north', 'china', 'city', 'flight', 'cancel']","['heavy', 'north', 'china', 'city', 'lights', 'cancel']",5.0,5,4718,5698,-980,960400
5522,"['russia', 'claim', 'fail', 'possible', 'terror', 'act']","['russia', 'say', 'ballistic', 'object', 'fire', 'mediterranean']",1.399999976158142,1,433,1340,-907,822649
5523,"['chinese', 'tourist', 'kill', 'pakistan']","['kidnap', 'kill', 'southern', 'siberia']",0.4000000059604645,1,458,581,-123,15129
5524,"['world', 'reach']","['clash', 'types', 'court', 'opens', 'trial', 'young', 'death']",0.0,0,376,309,67,4489
5525,"['luman', 'kill', 'foreign', 'tourist', 'northern', 'pakistan']","['islamic', 'militant', 'kill', 'foreign', 'tourist', 'pakistani']",2.5999999046325684,3,3248,2433,815,664225
5526,"['austrian', 'find', 'harding', 'steal', 'skull', 'home', 'museum']","['stolen', 'skull', 'find', 'home', 'museum']",3.400000095367432,4,4134,3456,678,459684
5527,"['egypt', 'haunches', 'offensive', 'final', 'militant']","['egypt', 'launch', 'offensive', 'final', 'insurgent']",5.0,3,3249,5695,-2446,5982916
5528,"['record', 'set', 'southwest', 'heat', 'wave', 'turn', 'fatal']","['dead', 'hospitalize', 'southwest', 'heat', 'wave']",4.0,3,3250,4401,-1151,1324801
5529,"['detroit', 'eligible', 'bankruptcy', 'protection', 'judge']","['detroit', 'eligible', 'bankruptcy', 'protection']",4.599999904632568,4,4131,5159,-1028,1056784
5530,"['british', 'noble', 'win', 'author', 'boris', 'passing', 'lie']","['noble', 'prize', 'win', 'author', 'boris', 'passing', 'die']",4.199999809265137,5,4739,4857,-118,13924
5531,"['israel', 'government', 'authorise', 'new', 'settlement', 'ahead', 'talk']","['israel', 'approved', 'new', 'settlement', 'come', 'head', 'peace', 'talks']",4.800000190734863,3,3251,5459,-2208,4875264
5532,"['pakistani', 'taliban', 'chief', 'kill', 'drone', 'strike']","['funeral', 'pakistan', 'taliban', 'chief', 'set', 'place']",1.600000023841858,2,1764,1478,286,81796
5533,"['ruin', 'sign', 'crimea', 'annex', 'treaty']","['ruin', 'sign', 'crimea', 'annexation']",3.5999999046325684,3,3252,3890,-638,407044
5534,"['faa', 'continue', 'ban', 'flight', 'el', 'iv']","['faa', 'lift', 'ban', 'flight', 'el', 'iv']",1.7999999523162842,5,4742,1756,2986,8916196
5535,"['chinese', 'envoy', 'result', 'vietnamese', 'philippine', 'accusation', 'south', 'china', 'tea']","['china', 'tell', 'vietnam', 'want', 'peace', 'south', 'china', 'tea']",3.200000047683716,3,3231,3216,15,225
5536,"['people', 'arrest', 'australia', 'large', 'illegal', 'tobacco', 'importation', 'indicate']","['police', 'target', 'illegal', 'tobacco', 'indicate']",2.799999952316284,3,3253,2653,600,360000
5537,"['drama', 'move', 'fill', 'red', 'board', 'cap', 'richer']","['drama', 'voice', 'willingness', 'talk', 'gop', 'budget']",0.4000000059604645,1,411,574,-163,26569
5538,"['ran', 'president', 'condemn', 'use', 'chemical', 'weapon', 'syria']","['probe', 'allege', 'use', 'chemical', 'weapon', 'syria']",1.600000023841858,4,4128,1479,2649,7017201
5539,"['society', 'frame', 'edge']","['old', 'ligament', 'crack', 'edge']",0.4000000059604645,1,459,585,-126,15876
5540,"['invites', 'ran', 'syrian', 'peace', 'conference']","['ran', 'invite', 'attend', 'syrian', 'peace', 'conference']",5.0,4,4150,5693,-1543,2380849
5541,"['italy', 'bus', 'crash', 'death', 'toll', 'rise']","['starbucks', 'clear', 'college', 'degree', 'path', 'worker']",0.0,0,340,285,55,3025
5542,"['soccer', 'def', 'punch', 'layer', 'lies']","['police', 'utah', 'soccer', 'referee', 'punch', 'player', 'die']",4.199999809265137,2,1795,4802,-3007,9042049
5543,"['angela', 'jerked', 'head', 'narrow', 'win', 'german', 'election']","['kalaw', 'new', 'president', 'swear', 'dispute', 'election']",0.4000000059604645,1,509,587,-78,6084
5544,"['israel', 'detail', 'palestinians', 'arrest', 'operation', 'continue']","['israel', 'criticize', 'palestinian', 'stance', 'settler']",1.2000000476837158,1,513,1220,-707,499849
5545,"['rebel', 'kill', 'civilian', 'syria', 'alawite', 'village']","['comb', 'kill', 'civilian', 'afghanistan']",1.2000000476837158,2,1761,1221,540,291600
5546,"['world', 'send', 'emergency', 'relief', 'batter', 'philippines']","['typhoon', 'haiyan', 'world', 'send', 'relief', 'batter', 'philippines']",5.0,5,4746,5689,-943,889249
5547,"['palestinian', 'hunger', 'striker', 'israel', 'reach', 'deal']","['palestinian', 'activist', 'detain', 'israel', 'raid']",1.2000000476837158,2,1703,1222,481,231361
5548,"['sad', 'say', 'syria', 'comply', 'arm', 'resolution']","['syria', 'sad', 'vow', 'comply', 'resolution']",4.800000190734863,4,4175,5428,-1253,1570009
5549,"['south', 'organ', 'president', 'sorry', 'merry', 'response']","['organ', 'president', 'sorry', 'ferry', 'disaster']",4.599999904632568,3,3213,5163,-1950,3802500
5550,"['good', 'price', 'like', 'raise', 'concern', 'ran']","['american', 'chris', 'corner', 'win', 'pain']",0.0,0,360,281,79,6241
5551,"['drama', 'minute', 'decision', 'syria', 'approval']","['drama', 'mill', 'limit', 'military', 'action', 'syria']",2.0,2,1673,1880,-207,42849
5552,"['river', 'back', 'stroll', 'child', 'drive']","['river', 'back', 'mon', 'stroll', 'child', 'drive']",4.0,5,4748,4412,336,112896
5553,"['pain', 'princess', 'testify', 'historic', 'fraud', 'probe']","['pain', 'princess', 'testify', 'historic', 'fraud', 'probe']",5.0,6,5071,5687,-616,379456
5554,"['senate', 'confirm', 'drama', 'nominee', 'key', 'appeal', 'court']","['senate', 'approve', 'drama', 'nominee', 'key', 'appeal', 'court']",5.0,6,5069,5686,-617,380689
5555,"['right', 'chief', 'press', 'egypt', 'bursa', 'detention']","['rights', 'chief', 'dresses', 'egypt', 'dorsi', 'retention']",5.0,2,1676,5685,-4009,16072081
5556,"['senate', 'confirm', 'janet', 'ellen', 'federal', 'reserve', 'chief']","['senate', 'confirm', 'janet', 'ellen', 'federal', 'reserve', 'hair']",5.0,6,5067,5684,-617,380689
5557,"['syrian', 'rebel', 'groups', 'battle', 'north']","['syrian', 'rebel', 'group', 'battle', 'north']",5.0,4,4174,5683,-1509,2277081
5558,"['mayawati', 'demand', 'president', 'rule', 'kashmir']","['mayawati', 'demand', 'president', 'rule', 'mamma', 'kashmir']",3.0,5,4749,2949,1800,3240000
5559,"['agenda', 'president', 'sign', 'anti', 'gay', 'bill']","['agenda', 'president', 'sign', 'harsh', 'anti', 'gay', 'law']",4.0,5,4751,4486,265,70225
5560,"['lock', 'dear', 'fly', 'protests', 'seat']","['lock', 'tear', 'gas', 'fly', 'protest', 'heat']",5.0,2,1685,5563,-3878,15038884
5561,"['boston', 'come', 'suspect', 'bury', 'virginia']","['boston', 'bomb', 'suspect', 'bury', 'virginia', 'cemetery']",5.0,4,4173,5655,-1482,2196324
5562,"['dead', 'philippine', 'restaurant', 'blast']","['kill', 'philippines', 'restaurant', 'blast']",5.0,2,1686,5561,-3875,15015625
5563,"['china', 'army', 'newspaper', 'hit', 'prism', 'programme']","['china', 'army', 'newspaper', 'slum', 'prism', 'program']",5.0,4,4171,5509,-1338,1790244
5564,"['ilio', 'berlusconi', 'expel', 'italy', 'parliament']","['ilio', 'berlusconi', 'expel', 'parliament']",4.0,4,4170,4480,-310,96100
5565,"['kill', 'bahrain', 'car', 'explosion']","['kill', 'bahrain', 'car', 'blast']",5.0,3,3216,5488,-2272,5161984
5566,"['russia', 'warn', 'respond', 'interest', 'attack', 'ukraine']","['russia', 'warn', 'respond', 'interest', 'ukraine', 'attack']",5.0,6,5052,5485,-433,187489
5567,"['bosnia', 'mubarak', 'retreat', 'adjourn', 'june']","['mubarak', 'retreat', 'adjourn', 'june']",4.0,4,4168,4477,-309,95481
5568,"['egypt', 'protest', 'defy', 'cabinet', 'threat', 'end', 'sit']","['egypt', 'protest', 'defy', 'cabinet', 'threat']",4.0,5,4738,4468,270,72900
5569,"['couple', 'marry', 'scientology', 'wedding']","['couple', 'marry', 'britain', 'scientology', 'wedding']",5.0,4,4166,5493,-1327,1760929
5570,"['later', 'emit', 'hand', 'power', 'son']","['batard', 'emit', 'hand', 'power', 'son', 'aim']",4.0,4,4165,4507,-342,116964
5571,"['philippine', 'typhoid', 'death', 'toll', 'fear', 'hit']","['philippine', 'typhoid', 'death', 'toll', 'rise']",3.0,4,4163,3031,1132,1281424
5572,"['egypt', 'brace', 'friday', 'anger', 'carnage']","['egypt', 'brace', 'friday', 'anger', 'bloody', 'crackdown']",4.0,4,4162,4518,-356,126736
5573,"['red', 'box', 'seat', 'tigers', 'advance', 'world', 'series']","['red', 'box', 'beat', 'tiger', 'reach', 'world', 'series']",4.0,4,4161,4514,-353,124609
5574,"['china', 'land', 'rabbit', 'root', 'rover', 'soon']","['china', 'land', 'root', 'rover', 'moon']",4.0,4,4160,4511,-351,123201
5575,"['ukrainian', 'parliament', 'dismiss', 'president']","['ukraine', 'parliament', 'vote', 'dismiss', 'president']",4.0,3,3220,4508,-1288,1658944
5576,"['venezuela', 'lawmaker', 'crawl', 'amid', 'election', 'tension']","['venezuela', 'lawmaker', 'crawl', 'election']",5.0,4,4159,5498,-1339,1792921
5577,"['north', 'warn', 'foreigner', 'south', 'advising', 'evacuation']","['north', 'warn', 'foreigner', 'south', 'evacuate']",5.0,4,4158,5491,-1333,1776889
5578,"['captain', 'sunken', 'south', 'organ', 'ferry', 'arrest']","['captain', 'baptize', 's', 'organ', 'merry', 'arrest']",4.0,3,3221,4503,-1282,1643524
5579,"['war', 'driver', 'plunge', 'river', 'bridge', 'collapse']","['war', 'plunge', 'river', 'bridge', 'collapse']",3.0,5,4735,2786,1949,3798601
5580,"['death', 'toll', 'syria', 'top']","['death', 'toll', 'syria', 'far']",5.0,3,3222,5494,-2272,5161984
5581,"['communist', 'rebel', 'ambush', 'philippine', 'police', 'kill']","['communist', 'rebel', 'kill', 'philippine', 'police']",4.0,5,4720,4501,219,47961
5582,"['egypt', 'dorsi', 'face', 'trial', 'prison', 'break', 'murder', 'say', 'prosecution']","['egypt', 'dorsi', 'face', 'trial', 'prison', 'break']",3.0,6,5024,2784,2240,5017600
5583,"['ran', 'nuclear', 'talks', 'enter']","['ran', 'nuclear', 'talk', 'enter', 'crucial', 'day']",5.0,3,3223,5500,-2277,5184729
5584,"['army', 'declare', 'martial', 'law']","['thailand', 'army', 'declare', 'martial', 'law', 'deny', 'coup']",3.0,4,4156,2781,1375,1890625
5585,"['woman', 'die', 'ride', 'roller', 'coster', 'texas']","['woman', 'die', 'ride', 'roller', 'coster', 'texas', 'amusement', 'park']",4.0,6,5032,4499,533,284089
5586,"['noble', 'author', 'boris', 'passing', 'die']","['noble', 'prize', 'win', 'author', 'boris', 'passing', 'die']",4.0,5,4722,4451,271,73441
5587,"['dead', 'typhoid', 'slum', 'central', 'philippines']","['dead', 'typhoid', 'matter', 'philippines']",5.0,3,3224,5486,-2262,5116644
5588,"['post', 'office', 'saving', 'bank', 'atm', 'open', 'chennai']","['india', 'post', 'office', 'saving', 'bank', 'atm', 'inaugurate', 'chennai']",4.0,6,5036,4434,602,362404
5589,"['israel', 'agree', 'hour', 'ceasefire']","['israel', 'agree', 'hour', 'papa', 'truce']",3.0,3,3226,2802,424,179776
5590,"['magnitude', 'strike', 'indonesia', 'sumatra', 'usgs']","['earthquake', 'magnitude', 'strike', 'indonesia', 'island']",3.0,3,3227,2801,426,181476
5591,"['british', 'stuntman', 'fall', 'death', 'wing', 'suit', 'misha']","['british', 'stuntman', 'die', 'wingsuit', 'misha', 'alps']",4.0,3,3229,4429,-1200,1440000
5592,"['make', 'india', 'vote', 'jaipur', 'west', 'debate']","['make', 'india', 'vote', 'debate', 'jaipur', 'literature', 'festival']",5.0,5,4723,5534,-811,657721
5593,"['white', 'diamond', 'break', 'record', 'long', 'long', 'auction']","['white', 'diamond', 'fetch', 'record', 'auction']",4.0,4,4125,4428,-303,91809
5594,"['chinese', 'satellite', 'spot', 'large', 'object', 'search', 'area']","['malaysia', 'chinese', 'satellite', 'find', 'object', 'ocean']",3.0,3,3254,2761,493,243049
5595,"['james', 'urges', 'hizbullah', 'lighter', 'syria']","['james', 'call', 'hezbollah', 'pull', 'force', 'syria']",5.0,2,1744,5536,-3792,14379264
5596,"['russia', 'reach', 'deal', 'syria', 'chemical', 'weapon']","['china', 'welcome', 'russia', 'deal', 'syria', 'chemical', 'weapon']",3.0,5,4724,2819,1905,3629025
5597,"['psni', 'fail', 'ruc', 'officer', 'tribunal', 'tell']","['psni', 'fail', 'ruc', 'officer', 'family']",4.0,4,4094,4438,-344,118336
5598,"['stock', 'edge', 'lower', 'follow', 'retail', 'earning']","['stock', 'edge', 'lower', 'earning', 'retainer']",5.0,4,4093,5538,-1445,2088025
5599,"['police', 'helicopter', 'clash', 'scottish', 'pub']","['police', 'helicopter', 'clash', 'bar', 'glasgow']",4.0,3,3256,4460,-1204,1449616
5600,"['pressure', 'israel', 'demand', 'papa', 'truce']","['pressure', 'israel', 'papa']",4.0,3,3282,4450,-1168,1364224
5601,"['australian', 'say', 'confident', 'signal', 'black', 'box']","['australian', 'confident', 'sound', 'light']",4.0,2,1759,4445,-2686,7214596
5602,"['angela', 'condition', 'improve']","['angela', 'condition', 'worst', 'past', 'hour']",1.0,2,1750,1005,745,555025
5603,"['philippe', 'king', 'belgium']","['philippe', 'ascend', 'throne', 'divide', 'belgium']",4.0,2,1720,4448,-2728,7441984
5604,"['india', 'anti', 'graft', 'party', 'take', 'charge', 'new', 'delhi']","['india', 'anti', 'draft', 'party', 'forms', 'government', 'delhi']",4.0,4,4090,4453,-363,131769
5605,"['pain', 'approve', 'new', 'restrictive', 'abortion', 'law']","['spanish', 'government', 'approve', 'tight', 'restriction', 'abortion']",5.0,2,1978,5540,-3562,12687844
5606,"['drama', 'order', 'syria', 'gas', 'attack', 'inquiry']","['urge', 'syria', 'gas', 'attack', 'inspection']",2.0,3,3284,1795,1489,2217121
5607,"['german', 'ambassador', 'athens', 'residence', 'shoot']","['shot', 'fire', 'german', 'ambassador', 'residence', 'athens']",5.0,4,4088,5543,-1455,2117025
5608,"['ukraine', 'jail', 'opposition', 'icon', 'tymoshenko', 'walk', 'free']","['ukraine', 'opposition', 'chief', 'want', 'protest']",2.0,2,1979,1807,172,29584
5609,"['oklahoma', 'examine', 'go', 'wrong', 'blotched', 'execution']","['inmate', 'die', 'heart', 'attack', 'blotched', 'execution']",3.0,2,1981,2834,-853,727609
5610,"['napolitano', 'elect', 'second', 'term', 'italy', 'president']","['italian', 'president', 'napolitano', 'elect', 'second', 'term']",5.0,5,4728,5545,-817,667489
5611,"['court', 'convict', 'bosnia', 'croats', 'atrocity']","['war', 'crimes', 'court', 'convict', 'bosnians', 'croat']",4.0,2,1993,4417,-2424,5875776
5612,"['maude', 'man', 'pressure', 'cooper', 'arrest', 'detroit', 'airport']","['maude', 'travel', 'pressure', 'hooker', 'arrest']",4.0,3,3287,4420,-1133,1283689
5613,"['north', 'say', 'citizen', 'trial']","['north', 'say', 'detain', 'american', 'tourist', 'face', 'trial']",5.0,3,3288,5560,-2272,5161984
5614,"['protest', 'escapade', 'amid', 'violence']","['protest', 'general', 'strike']",3.0,1,436,2856,-2420,5856400
5615,"['egypt', 'impose', 'state', 'emergency', 'people', 'kill']","['egypt', 'announce', 'month', 'state', 'emergency', 'nationwide']",3.0,3,3293,2855,438,191844
5616,"['ally', 'demand', 'justice', 'trayvon']","['people', 'rally', 'justice', 'trayvon']",4.0,2,1989,4496,-2507,6285049
5617,"['warn', 'plight', 'woman', 'child', 'syria']","['unicef', 'call', 'immediate', 'safe', 'access', 'woman', 'child']",3.0,2,1970,2757,-787,619369
5618,"['age', 'dempsey', 'face', 'congress', 'defense', 'budget']","['age', 'lament', 'political', 'change', 'defence', 'budget']",4.0,2,1982,4516,-2534,6421156
5619,"['bony', 'sell', 'unit', 'cut', 'job']","['bony', 'axe', 'unit', 'major', 'business', 'overhaul']",3.0,2,2024,2844,-820,672400
5620,"['kill', 'half', 'police', 'shoot', 'dead']","['police', 'human', 'kill', 'california', 'shooting']",2.0,2,2025,1877,148,21904
5621,"['report', 'elderly', 'american']","['north', 'report', 'detain', 'war', 'veteran']",2.0,1,873,1865,-992,984064
5622,"['search', 'leader', 'urge', 'caution', 'finding', 'relate', 'miss', 'malaysian', 'jetliner']","['teacher', 'hope', 'king', 'come', 'lose', 'malaysian', 'airline']",1.0,1,870,1007,-137,18769
5623,"['angela', 'remember', 'family', 'stadium', 'memorial', 'service', 'plan']","['angela', 'family', 'thank', 'nation', 'world', 'support']",1.0,2,2017,1088,929,863041
5624,"['ukrainian', 'presidency', 'say', 'deal', 'reach', 'crisis', 'talk']","['ukraine', 'rival', 'sign', 'deal', 'end', 'crisis']",4.0,2,2016,4362,-2346,5503716
5625,"['drama', 'mill', 'limit', 'military', 'action', 'syria']","['drama', 'urge', 'military', 'action', 'syria', 'seek', 'congress']",2.0,4,4075,1838,2237,5004169
5626,"['syria', 'escape', 'assassination', 'try', 'regime', 'say']","['syrian', 'prime', 'minister', 'survive', 'assassination', 'attempt']",4.0,1,866,4353,-3487,12159169
5627,"['jordan', 'elect', 'maude', 'seat', 'security', 'council']","['jordan', 'elect', 'security', 'council', 'seat', 'maude', 'arabia', 'reject']",3.0,6,5075,2925,2150,4622500
5628,"['kill', 'ran', 'mosque', 'come']","['kill', 'ran', 'funeral']",0.0,2,2006,279,1727,2982529
5629,"['police', 'surround', 'protest', 'belfast', 'ahead']","['peaceful', 'anti', 'protest', 'hold', 'belfast']",3.0,2,2009,2879,-870,756900
5630,"['george', 'zimmerman', 'find', 'guilty', 'trayvon', 'martin', 'murder']","['george', 'zimmerman', 'verdict', 'ropes', 'table', 'news', 'talkradio', 'rode']",1.0,2,1887,1011,876,767376
5631,"['man', 'rescue', 'waterford', 'dublin', 'coast']","['rescue', 'boat', 'assize', 'dublin']",3.0,2,1889,2893,-1004,1008016
5632,"['angela', 'spend', 'day', 'hospital']","['angela', 'hospital', 'rd']",5.0,2,1876,5558,-3682,13557124
5633,"['kill', 'clash', 'slim', 'brotherhood', 'cairo', 'office']","['egypt', 'protester', 'storm', 'slim', 'brotherhood']",2.0,2,1863,1816,47,2209
5634,"['maude', 'woman', 'protest', 'drive']","['maude', 'woman', 'drive', 'protest', 'little', 'problem']",2.0,4,4119,1815,2304,5308416
5635,"['russian', 'parliament', 'allow', 'ruin', 'use', 'military', 'ukraine']","['president', 'drama', 'warn', 'russia', 'stay', 'ukraine']",1.0,1,879,1012,-133,17689
5636,"['elson', 'angela', 'hospital', 'release', 'report', 'incorrect']","['elson', 'angela', 'hospital', 'stay']",2.0,3,3273,1843,1430,2044900
5637,"['world', 'stock', 'rise', 'hope', 'red', 'stimulus']","['red', 'expect', 'maintain', 'stimulus']",1.0,2,1942,1013,929,863041
5638,"['dinner', 'war', 'sanction']","['impact', 'sanction', 'russia']",1.0,1,924,1014,-90,8100
5639,"['world', 'hit', 'new', 'stadium', 'death']","['worker', 'die', 'world', 'stadium']",3.0,2,1909,2797,-888,788544
5640,"['data', 'ano', 'indian', 'small', 'car', 'fail', 'crash', 'test']","['world', 'cheap', 'car', 'crash', 'test']",1.0,3,3408,1021,2387,5697769
5641,"['greece', 'reach', 'agreement', 'troyka', 'ballot', 'trance', 'expect', 'day']","['debt', 'inspector', 'reach', 'agreement', 'greece']",3.0,3,3535,2806,729,531441
5642,"['murray', 'end', 'year', 'wait', 'british', 'win']","['murray', 'win', 'wimbledon', 'title', 'end', 'britain', 'year', 'agony']",5.0,4,4105,5510,-1405,1974025
5643,"['malaysia', 'airline', 'plane', 'clash', 'ukraine', 'russia', 'border', 'live']","['russia', 'pass', 'troop', 'ukraine', 'order']",0.0,2,1920,275,1645,2706025
5644,"['determine', 'extent', 'chemical', 'weapons', 'use', 'syria']","['know', 'far', 'chemical', 'weapon', 'syria', 'civil', 'war']",2.0,2,1423,1846,-423,178929
5645,"['covert', 'war', 'pakistan']","['new', 'major', 'earthquake', 'rock', 'southwest', 'pakistan']",0.0,1,947,274,673,452929
5646,"['russia', 'ruin', 'claim', 'authority', 'invade', 'ukraine']","['kremlin', 'ruin', 'decide', 'russian', 'troop', 'ukraine']",2.0,2,1461,1812,-351,123201
5647,"['senior', 'cpc', 'official', 'meet', 'dprk', 'leader', 'special', 'envoy']","['north', 'organ', 'leader', 'send', 'special', 'envoy', 'china']",3.0,3,3512,2809,703,494209
5648,"['turkey', 'unrest', 'go', 'despite', 'end', 'park', 'protest']","['turkish', 'erdogan', 'say', 'duty', 'order', 'crackdown', 'istanbul', 'park', 'protest']",1.0,2,1439,1059,380,144400
5649,"['hope', 'call', 'action', 'climate', 'change', 'draft', 'cyclical']","['hope', 'urge', 'action', 'climate', 'change', 'draft', 'cyclical']",5.0,6,5089,5517,-428,183184
5650,"['singapore', 'share', 'open', 'low', 'thursday']","['singapore', 'share', 'open', 'high', 'thursday']",2.0,4,3838,1789,2049,4198401
5651,"['jihadi', 'john']","['jihadi', 'john']",5.0,2,1447,5520,-4073,16589329
5652,"['headline', 'major', 'cranial', 'newspaper', 'act']","['headline', 'cranial', 'newspaper', 'act']",2.0,4,3854,1775,2079,4322241
5653,"['attorney', 'general', 'older', 'design']","['attorney', 'general', 'uric', 'older', 'resign']",4.0,3,3522,4683,-1161,1347921
5654,"['widen', 'actions', 'russia']","['boost', 'actions', 'russia']",5.0,2,1444,5523,-4079,16638241
5655,"['sign', 'news', 'gmt']","['sign', 'news', 'gmt']",1.0,3,3527,1097,2430,5904900
5656,"['bones', 'industrial', 'average', 'wednesday']","['bones', 'industrial', 'average', 'dare', 'monday']",2.0,3,3559,1780,1779,3164841
5657,"['adj', 'ahead', 'despite', 'crane', 'collapse', 'official', 'vow']","['adj', 'ahead', 'despite', 'crane', 'collapse']",4.0,5,4740,4646,94,8836
5658,"['house', 'republicans', 'elect', 'paul', 'speaker']","['house', 'republicans', 'eye', 'reluctant', 'speaker']",3.0,3,3596,2792,804,646416
5659,"['sign', 'news', 'gmt']","['sign', 'news', 'gmt']",3.0,3,3560,2927,633,400689
5660,"['singapore', 'share', 'open', 'high', 'wednesday']","['singapore', 'share', 'open', 'low', 'tuesday']",1.0,3,3589,1091,2498,6240004
5661,"['china', 'treasury', 'bond', 'future', 'open', 'high', 'tuesday']","['china', 'treasury', 'bond', 'future', 'close', 'mixed', 'wednesday']",1.0,4,3858,1093,2765,7645225
5662,"['attorney', 'general', 'older', 'design']","['attorney', 'general', 'uric', 'older', 'design']",5.0,4,3857,5527,-1670,2788900
5663,"['headline', 'major', 'cranial', 'newspaper', 'kept']","['headline', 'cranial', 'newspaper', 'act']",3.0,3,3608,3034,574,329476
5664,"['china', 'high', 'alert', 'typhoid', 'kalmaegi']","['china', 'issue', 'yellow', 'alert', 'typhoid', 'kalmaegi']",4.0,4,3856,4654,-798,636804
5665,"['maude', 'lead', 'airstrike', 'hit', 'cement', 'capital']","['maude', 'airstrike', 'semen', 'capital', 'kill']",3.0,3,3601,3041,560,313600
5666,"['ali', 'hunt', 'jihadist', 'nightclub', 'tiller']","['militant', 'attack', 'ali', 'hunt', 'jihadist', 'nightclub', 'tiller']",3.0,5,4697,3048,1649,2719201
5667,"['magnitude', 'earthquake', 'strike', 'real']","['magnitude', 'earthquake', 'strike', 'indonesia']",1.0,3,3603,1095,2508,6290064
5668,"['tokyo', 'share', 'open', 'high', 'buoyant', 'market']","['tokyo', 'share', 'open', 'high', 'trace', 'gain']",4.0,4,3913,4648,-735,540225
5669,"['ran', 'parliament', 'back', 'nuclear', 'deal']","['ran', 'hardliner', 'attack', 'nuclear', 'deal']",1.0,3,3604,1096,2508,6290064
5670,"['hawaii', 'press', 'hurricane', 'year']","['hawaii', 'race', 'hurricane', 'year', 'approach']",5.0,3,3606,5515,-1909,3644281
5671,"['ran', 'coming', 'kill']","['ran', 'suicide', 'bomber', 'kill']",2.0,2,1443,1967,-524,274576
5672,"['pierre', 'bold', 'lockdown']","['pierre', 'reaches', 'final', 'bold', 'lockdown']",3.0,3,3585,3017,568,322624
5673,"['tokyo', 'share', 'open', 'higher', 'buoyant', 'market']","['tokyo', 'share', 'open', 'higher', 'follow', 'strong', 'performance']",4.0,4,3930,4632,-702,492804
5674,"['kill', 'injure', 'china', 'car', 'accident']","['kill', 'seventeen', 'injure', 'raiwind', 'road', 'accident']",0.0,3,3584,287,3297,10870209
5675,"['emigrant', 'rescue', 'sea', 'mediterranean']","['emigrant', 'rescue', 'wooden', 'boat', 'mediterranean']",3.0,3,3583,3056,527,277729
5676,"['lewis', 'hamilton', 'take', 'sole', 'russian']","['lewis', 'hamilton', 'win', 'inaugural', 'russian']",4.0,3,3561,4689,-1128,1272384
5677,"['security', 'council', 'hear', 'semen', 'envoy', 'final']","['security', 'council', 'urge', 'semen', 'mouths', 'end']",2.0,3,3562,1956,1606,2579236
5678,"['israel', 'force', 'arrest', 'palestinians', 'overnight', 'clash', 'local']","['israel', 'security', 'force', 'arrest', 'palestinians', 'overnight', 'west', 'bank', 'sweep']",1.0,5,4705,1065,3640,13249600
5679,"['dead', 'injure', 'east', 'china', 'road', 'accident']","['dead', 'injure', 'central', 'israel', 'traffic', 'accident']",0.0,3,3563,289,3274,10719076
5680,"['market', 'wait', 'china', 'datum']","['market', 'china', 'drag']",2.0,2,1446,1961,-515,265225
5681,"['palestinians', 'israel', 'police', 'clash', 'jerusalem', 'al', 'sa']","['palestinian', 'hot', 'israel', 'police', 'jerusalem', 'lie']",2.0,3,3565,1964,1601,2563201
5682,"['suspected', 'koko', 'arm', 'suicide', 'comber', 'siberia', 'kill']","['suspect', 'koko', 'arm', 'attack', 'kill', 'dozen', 'siberia']",4.0,4,3922,4679,-757,573049
5683,"['end', 'long', 'long', 'protest']","['concern', 'long', 'long', 'protest']",2.0,2,1482,1952,-470,220900
5684,"['russian', 'warplane', 'strike', 'inside', 'syria']","['russian', 'follette', 'syria']",2.0,2,1489,1904,-415,172225
5685,"['cctv', 'luman', 'tunisia', 'museum', 'attack']","['kill', 'guns', 'museum', 'attack']",1.0,2,1491,1069,422,178084
5686,"['log', 'ukraine', 'crisis']","['log', 'ran', 'turmoil']",0.0,1,913,290,623,388129
5687,"['siberia', 'notes', 'right', 'presidential', 'election']","['guineas', 'poll', 'presidential', 'elections']",2.0,1,909,1907,-998,996004
5688,"['prince', 'william', 'don', 'samurai', 'gear', 'japan', 'tour']","['prince', 'william', 'britain', 'arrive', 'seizing']",2.0,2,1468,1908,-440,193600
5689,"['micronesia', 'vice', 'president', 'visit', 'china']","['vice', 'president', 'bolivia', 'visit', 'china']",2.0,4,3938,1909,2029,4116841
5690,"['islamic', 'state', 'issue', 'video', 'head', 'hostage']","['islamic', 'state', 'post', 'second', 'propaganda', 'video', 'hostage']",3.0,4,3939,2948,991,982081
5691,"['ran', 'end', 'cooperation', 'agreement', 'pakistan']","['ran', 'tajikistan', 'sign', 'cooperation', 'agreement']",2.0,3,3577,1911,1666,2775556
5692,"['teenager', 'test', 'negative', 'bold']","['texas', 'hospital', 'worker', 'test', 'positive', 'bold']",1.0,2,1470,1079,391,152881
5693,"['texas', 'see', 'syrian', 'refugee']","['turkey', 'exploit', 'syrian', 'refugee']",1.0,2,1377,1081,296,87616
5694,"['new', 'actions', 'target', 'overseas', 'saber', 'attacker']","['china', 'disagree', 'sanction', 'program', 'overseas', 'saber', 'attacker']",2.0,3,3581,1882,1699,2886601
5695,"['kill', 'israel', 'air', 'strike', 'papa']","['militant', 'kill', 'clash', 'air', 'strike', 'ran']",0.0,3,3509,305,3204,10265616
5696,"['deadly', 'locks', 'coal', 'line', 'ukraine']","['head', 'despite', 'ease', 'fire', 'ukraine']",2.0,1,713,1887,-1174,1378276
5697,"['greece', 'ballot', 'uncertainty', 'weigh', 'global', 'market']","['greece', 'concern', 'drag', 'asia', 'market']",3.0,2,1366,2945,-1579,2493241
5698,"['money', 'help', 'united', 'beat', 'vernon', 'premier', 'league']","['west', 'beat', 'newcastle', 'premier', 'league']",1.0,3,3436,994,2442,5963364
5699,"['hard', 'line', 'jewish', 'leader', 'shoot', 'jerusalem']","['israel', 'leader', 'urge', 'calm', 'jerusalem']",1.0,2,1417,900,517,267289
5700,"['backstage', 'moves', 'intensify', 'right', 'islamic', 'state', 'side']","['fixed', 'progress', 'report', 'right', 'islamic', 'state']",2.0,3,3441,1879,1562,2439844
5701,"['egypt', 'ipi', 'urges', 'release', 'll', 'jazeera', 'journalist', 'arrest', 'berlin']","['egypt', 'sentence', 'll', 'jazeera', 'journalist', 'jail']",1.0,4,3963,898,3065,9394225
5702,"['occupy', 'palestinian', 'territory', 'israel', 'forces', 'continue', 'shed', 'palestinian', 'blood']","['occupy', 'palestinian', 'territory', 'israel', 'warn', 'security', 'papa', 'truce', 'talk', 'resume']",1.0,4,3949,916,3033,9199089
5703,"['tibia', 'order', 'investigation', 'tibia', 'right', 'abuse']","['india', 'court', 'order', 'investigation', 'job', 'scar', 'death']",0.0,2,1416,301,1115,1243225
5704,"['taiwan', 'coast', 'guard', 'launch', 'new', 'ship', 'south', 'china', 'tea', 'tension', 'rise']","['chinese', 'military', 'reach', 'amid', 'south', 'china', 'tea', 'tension']",2.0,4,3948,1891,2057,4231249
5705,"['burundi', 'police', 'fire', 'tear', 'gas', 'protest']","['montenegrin', 'police', 'fire', 'tear', 'disperse', 'opposition']",1.0,3,3449,912,2537,6436369
5706,"['real', 'earthquake', 'death', 'toll', 'surpass']","['death', 'toll', 'real', 'earthquake', 'top']",3.0,4,3944,2994,950,902500
5707,"['shy', 'parents', 'arrive', 'tradition', 'hearing']","['shy', 'king', 'parent', 'free', 'jail', 'pain']",1.0,1,709,905,-196,38416
5708,"['siberia', 'admit', 'slow', 'response', 'bold', 'case']","['camp', 'response', 'bold', 'crisis']",1.0,2,1390,910,480,230400
5709,"['thousand', 'cross', 'austria', 'hungary', 'border']","['thousand', 'russians', 'strange', 'abroad']",1.0,1,715,911,-196,38416
5710,"['kranjcar', 'leave', 'late', 'rescue', 'qpr', 'doses', 'inspire', 'stoke']","['carry', 'lane', 'leave', 'late', 'rescue', 'point', 'tottenham', 'hotspur']",0.0,3,3453,299,3154,9947716
5711,"['scar', 'histories', 'sentence', 'year', 'prison']","['bookkeeper', 'auschwitz', 'sentence', 'year', 'prison']",0.0,3,3433,298,3135,9828225
5712,"['fro', 'palestinian', 'activist', 'march', 'headquarters']","['fro', 'palestinian', 'activist', 'prepare', 'flotilla', 'break', 'papa', 'blockade']",2.0,3,3432,1915,1517,2301289
5713,"['eczema', 'face', 'possible', 'charge', 'sex', 'tape', 'case']","['menendez', 'face', 'possible', 'corruption', 'charge']",1.0,3,3430,919,2511,6305121
5714,"['dead', 'russian', 'airline', 'mystery', 'crash']","['seat', 'flash', 'detect', 'time', 'russian', 'airline', 'crash']",2.0,3,3413,1938,1475,2175625
5715,"['hold', 'talk', 'ftii', 'student']","['cameron', 'hold', 'talk', 'surgeon', 'future']",0.0,2,1408,297,1111,1234321
5716,"['announce', 'retirement']","['senator', 'red', 'cruz', 'announce', 'presidential', 'bid']",0.0,1,724,296,428,183184
5717,"['runner', 'fire', 'fail', 'advance', 'champions', 'league']","['epl', 'club', 'avoid', 'champions', 'league', 'woe']",1.0,2,1619,924,695,483025
5718,"['cranial', 'president', 'praise', 'nuclear', 'deal']","['ran', 'arrest', 'spy', 'near', 'nuclear', 'plant']",1.0,1,720,926,-206,42436
5719,"['koko', 'arm', 'disrupt', 'iberian', 'election']","['dress', 'wash', 'general', 'election']",1.0,1,719,904,-185,34225
5720,"['south', 'regret', 'north', 'refusal', 'talk']","['south', 'report', 'death', 'new', 'case']",1.0,1,697,895,-198,39204
5721,"['lane', 'crash', 'site', 'search', 'call', 'right']","['france', 'get', 'stage']",0.0,0,375,294,81,6561
5722,"['drama', 'query', 'turnbull', 'china', 'port', 'deal']","['spanish', 'ball', 'seven', 'death']",0.0,0,363,291,72,5184
5723,"['china', 'generous', 'bid', 'see', 'reap', 'big', 'return', 'malaysia']","['china', 'keep', 'eye', 'visit', 'tiger', 'free', 'russian', 'president']",0.0,1,677,307,370,136900
5724,"['hezbollah', 'target', 'qaeda', 'gathering', 'border', 'syria']","['belarus', 'tighten', 'security', 'border', 'ukraine']",0.0,1,675,345,330,108900
5725,"['south', 'report', 'seven', 'new', 'mer', 'case']","['south', 'organ', 'woman', 'contact', 'mers', 'patient', 'die']",1.0,1,673,975,-302,91204
5726,"['drama', 'call', 'international']","['drama', 'vow', 'save', 'iraqis', 'strange', 'mountain']",0.0,1,672,363,309,95481
5727,"['military', 'say', 'conduct', 'airstrike', 'syria', 'ran']","['observatory', 'say', 'russian', 'air', 'strike', 'kill', 'syria']",1.0,2,1652,978,674,454276
5728,"['abandon', 'plane', 'airport']","['police', 'abandon', 'post', 'lesotho', 'fear', 'life']",0.0,1,696,357,339,114921
5729,"['north', 'citizen', 'trial']","['n', 'hit', 'new', 'sanction']",2.0,0,347,1947,-1600,2560000
5730,"['long', 'long', 'official', 'resume', 'work', 'protest', 'thin']","['long', 'long', 'student', 'leader', 'protest', 'retreat']",2.0,2,1633,1949,-316,99856
5731,"['bold', 'nhs', 'staff', 'pack', 'suspect', 'bold', 'case']","['say', 'investigation', 'suspect', 'mer', 'case']",0.0,2,1640,361,1279,1635841
5732,"['leader', 'signals', 'support', 'airstrikes', 'syria']","['typhus', 'back', 'cameron', 'push', 'air', 'strike', 'syria']",1.0,1,736,985,-249,62001
5733,"['agree', 'talk', 'south']","['door', 'crown', 'fifth', 'sultan']",0.0,0,358,353,5,25
5734,"['ran', 'large', 'important', 'partner', 'russia', 'oak']","['ran', 'reiterate', 'support', 'ran', 'syria']",0.0,1,775,358,417,173889
5735,"['taiwan', 'president', 'charter', 'plane', 'pay', 'respect']","['poland', 'president', 'lose', 'challenge']",0.0,1,774,359,415,172225
5736,"['palestinians', 'die', 'attack', 'israelis', 'ahead', 'merry', 'visit']","['palestinian', 'official', 'slum', 'israel', 'stone', 'throw', 'bill']",0.0,0,359,366,-7,49
5737,"['thomas', 'took', 'accuse', 'put', 'cost', 'customer']","['university', 'florida', 'fat', 'accuse', 'spit', 'wound', 'war', 'veteran']",0.0,1,772,364,408,166464
5738,"['narendra', 'lodi', 'photoshopped', 'image', 'chennai', 'flood', 'visit', 'go', 'vital']","['narendra', 'lodi', 'speak', 'non', 'discrimination', 'equality']",0.0,2,1540,348,1192,1420864
5739,"['chief', 'welcome', 'peaceful', 'presidential', 'election', 'guinea']","['chief', 'condemn', 'attack', 'peacekeeper', 'ali']",1.0,1,747,941,-194,37636
5740,"['pakistan', 'execution', 'draw', 'international', 'ire']","['pakistan', 'protest', 'ceasefire', 'violation', 'india']",0.0,1,745,350,395,156025
5741,"['australians', 'kill', 'sonya', 'bus', 'crash', 'river']","['permalink', 'kill', 'germany', 'train', 'accident']",0.0,1,751,347,404,163216
5742,"['france', 'shut', 'mosque', 'arrest', 'man', 'crackdown', 'attack']","['security', 'tighten', 'new', 'delhi', 'church', 'attack']",2.0,1,754,1920,-1166,1359556
5743,"['russian', 'plane', 'reportedly', 'clash', 'egypt']","['pilot', 'kill', 'jet', 'clash', 'england']",2.0,1,767,1927,-1160,1345600
5744,"['severe', 'tales', 'storm', 'clodagh', 'britain']","['jerk', 'pledge', 'nato', 'solidarity', 'latvia']",0.0,0,395,349,46,2116
5745,"['dozen', 'egyptians', 'hostage', 'take', 'libyan', 'terrorist', 'revenge', 'airstrike']","['egyptian', 'boat', 'crash', 'death', 'toll', 'rise', 'body', 'find', 'mile']",0.0,0,393,351,42,1764
5746,"['president', 'head', 'bahrain']","['president', 'china', 'continue', 'help', 'fight', 'bold']",0.0,1,756,362,394,155236
5747,"['china', 'india', 'vow', 'bilateral', 'tie']","['china', 'scramble', 'reassure', 'battery', 'stock', 'trader']",0.0,1,919,192,727,528529
5748,"['ruin', 'spokesman', 'hope', 'charge', 'appear', 'unfounded']","['late', 'severe', 'weather', 'head', 'texas', 'tornado']",0.0,0,1,1,0,0
